6
:	6
rebeldía::	rebellion:
grito:	shout
soberbio:	superb
Prometeo:	Prometheus
inicial:	initial
recitativo:	recitative
metales:	metals
rematado:	finished
preludio:	prelude
composición:	composition
proyecto:	project
ligado:	connected
título:	title
libros:	books
prestamente:	quickly
apartó:	set aside
ahí:	there
tanto».:	both".
«llevo:	"he took
sumar:	summer
multiplicar:	multiply
podía:	could
usaba:	used
nunca:	never
encontrar:	find
volverme:	come back
vitrina:	showcase
ofrecían:	they offered
Americanas:	Americans
Comedias:	Comedies
esas:	those
policíacas:	police
novelas:	soap operas
últimas:	latest
Odisea:	Odyssey
Tenía:	Had
serlo.:	be.
acababan:	they finished
deseos:	wishes
indeciso:	undecided
conocidas:	known
desorientado:	disoriented
descanso:	rest
súbito:	sudden
enfermo:	sick
ocio.:	idle.
aprovechar:	leverage
cómo:	as
sabía:	knew
varios:	several
comprado:	purchased
empresa:	enterprise
tres:	three
liberado:	released
ritmo:	rhythm
desaforado:	unbridled
Roto:	Lake
pecho.:	chest.
militares:	military
medallas:	medals
muchas:	many
lisiado:	crippled
tizas:	chalks
trazaba:	traced
acera:	pavement
dibujos:	drawings
seguir:	follow
esquina:	corner
deteniéndome:	stopping me
posibilidades:	possibilities
tantas:	so many
aturdido:	stunned
tontamente:	foolishly
andar:	to walk
acabé:	I finished
tardaba:	it took
estudio.:	study.
decoración:	decoration
acerca:	about
Mouche:	Fly
sugerir:	suggest
repente:	suddenly
necesaria:	necessary
pareció:	it seemed
visita:	visit
cerca:	fence
paraba:	stopped
escalinata:	staircase
subir:	rise
barniz.:	varnish.
giraban:	they rotated
lazos:	ties
estrellas:	stars
hongos:	fungus
pértigas:	poles
colgados:	hung
móviles:	mobiles
anunciada:	announced
abstracto:	abstract
arte:	until
exposición:	exhibition
inauguraba:	inaugurated
detuve:	I stopped
ferrocarril:	railway
estación:	season
encaminaba:	directed
puro.:	pure
respirar:	breathe
bosques:	forests
bajarme:	get off
tren:	train
tomar:	take
ocurrió:	occurred
armarios:	wardrobes
aparecía:	appeared
baño:	bathroom
buscar:	look for
quedarme:	stay
ejercicio.:	exercise.
piscina:	pool
ir:	and
sugirió:	suggested
Esto:	This
cigarros.:	cigarettes.
colillas:	butts
periódicos:	newspapers
jirones:	tatters
metidos:	stuck up
pillos:	rascals
envidiar:	envy
castillos:	castles
ratos:	rats
Modelo:	Model
polvorientos:	dusty
abetos:	fir trees
jugaban:	they played
niños:	children
nuevamente:	again
Tomé:	Thomas
ablandaban.:	they softened
estas:	is
Decididamente:	Decidedly
juntas.:	together.
demasiadas:	too many
infancia:	childhood
evocar:	evoke
garganta:	throat
amargor:	bitterness
doloroso:	painful
Un:	And
viene.:	he comes.
Tarda:	Afternoon
suspende:	suspend
quién:	who
querido:	darling
¡Ay:	Yes
Esposo::	Husband:
elevada:	elevated
apasionadamente:	passionately
Latinae.:	Latin
totius:	of the whole
principalis:	principal
Virginis.:	Virgin
Rosae:	Roses
Sanctae:	Saints
enredaban:	entangled
prodigio:	prodigy
pelea:	fight
visitas:	visits
Recibe:	Receive
píos::	tweets:
títulos:	titles
encabezadas:	headed
páginas:	pages
unas:	nails
dar:	but
Carraciolo.:	Caracciolo.
decía:	said
colegio.:	school.
libraban:	they liberated
menores:	minors
enfermedades:	diseases
dichosas:	blessed
leído:	read
impreso:	printed
5
:	5
Busqué:	I searched
mí.:	my.
desconocido:	a stranger
Absolutamente:	Absolutely
gregorianos:	Gregorians
himnos:	hymns
antaño:	yesteryear
estudiara:	will study
vaticana:	Vatican
edición:	edition
—decía:	—he said
Carraciolo:	Caracciolo
junio.:	June.
honrábamos:	we honored
curiosidad:	curiosity
insólita:	unusual
Avemaria.:	Avemaria
martilleaba:	hammered
carillón:	carillon
tibieza:	tepidity
frescor:	freshness
vetas:	veins
desollado:	desolate
conejo:	rabbit
estiramientos:	stretching
remedaba:	remedial
jadeante:	panting
perro:	dog
desperdicios:	waste
olientes:	smelling
demoraba:	delayed
químicos:	chemicals
atravesado:	crossed
gasolina:	Gasoline
azuloso:	bluish
bochorno:	embarrassment
alzaba:	raised
asfalto:	asphalt
Del:	Of the
escaseaban.:	They were scarce.
conversación:	conversation
temas:	themes
iguales:	equal
hilera:	row
ornamento:	ornament
huérfana:	orphan
fachada:	facade
maternidad:	maternity
inmenso:	immense
medio—:	half-
conciertos:	concerts
—sinagoga:	-synagogue
réplica:	replica
parecía:	it seemed
corredores:	runners
infinitos:	infinite
funeraria:	mortuary
silenciosa:	silent
Maciza:	Solid
verticalidad.:	verticality.
dilatación:	dilatation
tino:	really
hubieran:	they would have
arquitectos:	architects
altura:	height
escorados:	propped up
clásicos:	classics
entablamentos:	entablatures
Blancas:	White
Eminencias:	Eminences
oficiaban:	they officiated
clínicas:	clinics
ortodoxa:	orthodox
cúpula:	dome
cristianos:	Christians
templos:	temples
pátina:	patina
agujas:	needles
cumbres:	summits
bruma:	Hoar
evanescencias:	evanescence
Arriba:	Above
edificios.:	buildings.
encima:	on
respondían:	they responded
sirenas:	mermaids
escoltado:	escorted
verano:	summer
llegado:	arrived
entrevistas:	interviews
grisallas:	gray
Tras:	After
acetona.:	acetone.
olor:	smell
persistente:	persistent
retroceder:	back
comenzaban:	they started
presente:	gift
víspera:	eve
calores:	heats
despertado:	woken up
habiendo:	having
cráneo:	skull
reflexionaba:	I was reflecting
aturdir:	stun
resuelto:	resolved
Apuré:	I hurried
descanso...:	rest...
Fantomas:	Fantômas
dormido:	asleep
darme:	give me
antifaz:	mask
poniendo:	putting
despertador:	alarm clock
derribara:	would knock down
holgado:	loose
holgaba:	was lazy
Bebía:	I drank
horas.:	hours.
hacían:	they did
placeres:	be placed
anochecida:	dusk
hallarme:	find me
buscaba:	I was looking for
aislantes:	insulators
materias:	materials
revestidas:	coated
metrónomos:	metronome
cronógrafos:	chronographs
técnica:	technique
Atado:	Tied
entrar.:	to enter.
apellido:	last name
pierde:	lose
secretos:	secrets
apartamientos:	apartments
llevaba:	wore
licor:	liqueur
encendido:	on
antojo:	whim
vicioso:	vicious
Constelaciones:	Constellations
Venusberg:	Venus mountain
día:	day
moradas:	purple
meandros:	intricacies
viajes:	trips
raros:	rare
emprendía:	undertook
ignoraba:	I ignored
mismo—;:	same-;
burla:	derision
—pensaba:	-thought
vendida:	sold
diurna:	daytime
excesos.:	excesses.
reiterados:	reiterated
entregarme:	give me
pretexto:	pretext
libertad:	freedom
dónde:	where
aquí:	here
lado:	side
—la:	-the
adolescencias:	adolescences
dos:	of the
vivir:	live
desarraigo:	uprooting
rebelarse:	rebel
vano:	vain
entender:	to understand
Cómitre.:	Comitre.
vendían:	they sold
Hombre-Ninguno:	Man-None
Avispa:	Wasp
Hombre-:	Man-
Habíamos:	we had
santidad.:	holiness.
heroísmo:	heroism
gestas:	a gesture
ciertas:	certain
tiempos:	time
estos:	these
revivir:	revive
tratar:	treat
imposible:	impossible
suerte:	luck
tocado:	touched
curso—.:	course-.
año:	year
calendario:	calendar
acaso:	chance
temprano:	early
cedería:	would give in
—impulso:	—impulse
paroxismos:	paroxysm
fuerza:	force
adquirido:	acquired
impulso:	impulse
sostenía:	held
hombro:	shoulder
bajando:	going down
Subiendo:	Going up
pasada.:	past.
idéntico:	identical
sabor:	flavor
aparición:	appearance
difería:	differed
4
:	4
invariablemente:	invariably
asaltaba:	assaulted
repetida:	repeated
canción:	song
caras:	guys
festejaba:	celebrated
Cuando:	When
pisapapel.:	pisapapple.
velero:	sailboat
historia:	history
contado:	counted
rincón:	corner
sentado:	sitting
haberme:	have me
—de:	-of
idénticas:	identical
circunstancias:	circumstances
haberlo:	have
obsesionante:	haunting
producía:	produced
duradera;:	durable;
emoción:	emotion
excepcional:	exceptional
huella:	fingerprint
válido:	valid
recuerdo:	memory
temporadas:	seasons
existir;:	exist;
crónica:	chronicle
lagunas:	gaps
Había:	There was
segundos.:	seconds.
unos:	some
transfigurada:	transfigured
pinos:	pins
cargados:	loaded
camiones:	trucks
llegada:	arrival
tiendas:	stores
vitrinas:	showcases
abrían:	they opened
papel:	paper
estaciones:	stations
información:	information
debíase:	it was due
veces:	times
castañas—.:	chestnuts—.
reaparición:	reappearance
ostras:	oysters
salvajes:	wild
patos:	ducks
nocturno:	night
restaurante:	restaurant
ofrecimientos:	offers
—sabiendo:	—knowing
vivirlos:	live them
blandos:	soft
asfaltos:	asphalts
pascuas:	easter
otoños:	autumns
transcurridos:	elapsed
últimos:	last
representaba:	represented
acostado:	lying down
Nuevamente:	Again
voz.:	voice.
hablándome:	talking to me
sorprendía:	surprised
conmigo:	with me
dialogar:	dialogue
desconcertado:	embarrassed
presentes:	gifts
desertado:	deserted
amenaza.:	threat.
vaga:	vacancy
objeto:	object
sentía:	felt
apuraba:	apurba
agigantadas.:	gigantic
voces:	you
ni:	in
mecánicas:	mechanical
músicas:	songs
roto:	inside
silencio:	silence
confusión:	confusion
aturdimiento:	daze
lugar.:	place.
temor:	fear
cumplir:	achieve
tarea:	task
sensaciónde:	feeling of
tremenda:	tremendous
escritorio.:	desk.
botella:	bottle
Besos.:	Kisses.
inesperado::	unexpected:
informaba:	informed
visto:	view
hoja:	move
Una:	A
derramada.:	spilled.
loción:	lotion
húmeda:	wet
encontraba:	found
mano:	thousand
capítulo.:	chapter.
abierto:	open
gotas:	drops
precipitado:	precipitate
velador:	pedestal table
almohada;:	pillow;
moldeado:	molded
peso:	weight
ausente.:	absent.
presencia:	presence
presurosa:	hasty
partida:	match
Regresé:	I came back
espesaría:	would thicken
trocado:	exchanged
sería:	I would be
sentí:	I felt
enanas...:	dwarfs...
sendero:	path
tomó:	took
despedida:	farewell
ademán:	gesture
Todavía:	Still
viejas.:	old
maderas:	woods
polvo:	dust
removiendo:	stirring
abrirse:	open
acababa:	ended
italiana:	Italian
encaminó:	on the way
excusa:	excuse
leve:	live
talle:	to him
prendió:	caught
protagonista;:	hero;
transformarse:	turn
quien:	who
tocaron:	they touched
significaba:	meant
recordándole:	reminding him
contarle:	tell him
víspera.:	eve.
presentada:	presented
película:	movie
distraídamente:	absently
preguntó:	asked
teatro.:	theater.
maletas:	suitcases
traído:	brought
país:	country
gira:	tour
emprender:	undertake
terminarse:	finish
explicaba:	explain
maquillaje::	make-up:
grasos:	fatty
rostro:	face
inquieto:	restless
ensuciaba:	dirty
mientras:	while
espejo:	mirror
hablaba:	spoke
seguridad:	security
buscando:	searching
destino:	destination
torcido:	crooked
entonces:	so
desafortunados:	unlucky
favorecer:	favor
abrazo.:	hug.
astrales—:	astral—
figuraciones:	figurations
adornaban:	they adorned
3
:	3
cuyas:	whose
—aquellas:	-those
arrojándome:	throwing me
dividido:	divided
hagiografías;:	hagiographies;
interponía:	interposed
fingimiento:	pretense
estúpido:	idiot
fogarada:	toothache
caoba.:	mahogany.
armario:	cupboard
cuado:	when
guardaba:	kept
retazos:	scraps
olía:	oil
vistió:	dressed
desnudez:	nakedness
caricia:	caress
acercaba:	approached
grato:	grateful
novedoso:	novel
hizo:	those
claro:	Of course
alfombra:	rug
abrió:	opened
arrojado:	thrown
desgastado:	worn out
repetirse:	repeat
tanto:	both
taconazo:	heel
Cerró:	Hill
corpiño.:	bodice.
broches:	pins
presurosamente:	hastily
zafando:	releasing
aplausos:	applause
seguida:	followed
inesperado.:	unexpected.
anunciaban:	they announced
partes:	parts
dejados:	left
frascos:	jars
rincones:	corners
tirados:	taken away
tubos:	tubes
cómoda:	comfortable
gavetas:	drawers
sacadas:	balconies
marchado:	left
advertí:	I warned
Mouche.:	Fly.
aconsejada:	advised
venda:	sale
venía:	permission
—que:	-what
conseguir:	get
madrugada:	dawn
tragado:	swallowed
somnífero:	sleeping pill
dominical:	Sunday
regla:	ruler
alterado:	changed
Día.:	Day.
Séptimo:	Seventh
Convivencia:	Coexistence
terminada:	finished
daba:	after
bambalinas:	backstage
falso:	false
caía:	fell
Sonaba:	It sounded
condena:	condemn
cumpliera:	fulfilled
cárcel:	jail
devolverla:	return it
dejar:	leave
encierro.:	confinement.
aproximaba:	approximated
cercano:	nearby
carrillón:	chime
recordaban:	they remembered
domésticas.:	domestic.
cuentas:	accounts
sacábamos:	we took out
lugar;:	place;
cuadro:	chart
cambiábamos:	we exchanged
olvidado:	forgotten
geranio:	geranium
Regábamos:	We watered
tiempos.:	time.
primeros:	first
corto:	short
intimidad:	privacy
restablecía:	restored
cuerpos:	bodies
calor:	heat
actividades.:	activities.
desemparejamiento:	unpairing
aflojados:	loosened
vínculos:	links
apretar:	squeeze
desabrido:	unopened
resultara:	it would turn out
abrazo:	hug
cierto:	TRUE
conciencia.:	awareness.
escrúpulos:	scruples
ciertos:	some
acallando:	silencing
satisfacer:	satisfy
dable:	gun
apremio:	pressure
ignorar:	ignore
noción:	notion
impulsado:	driven
actuaba:	acted
contrato:	contract
nuestro:	our
firma:	business
estampar:	stamp
instante:	instant
contraída:	contracted
obligación:	obligation
virtud:	virtue
física:	physical
práctica:	practice
brindarse:	toast
obligada:	obligatory
creyera:	believed
verdadero:	TRUE
respondía:	responded
acto:	act
realidad:	reality
si:	and
acertar:	to hit
esposo:	husband
deber:	duty
consideraba:	considered
cumpliendo:	fulfilling
lecho:	litter
momento:	moment
pasar:	market
lado.:	side.
cual:	which
dormir:	sleep
acabamos:	we're done
empleado—:	employee-
actriz:	actress
modo:	way
espejo.:	mirror.
frente:	forehead
declamados:	declaimed
monólogos:	monologues
tristeza:	sadness
vencida:	defeated
quedado:	left
renuevo;:	I renew;
vez.:	time.
interpretar:	interpret
aspiraba:	aspired
papeles:	papers
temperamento:	temperament
salvar:	save
Antes:	Before
oficio.:	job.
impuesto:	tax
profundo:	deep
pesar:	weigh
realmente:	really
lograr:	achieve
confiada:	confident
amargada:	bitter
Cada:	Each
daguerrotipo.:	daguerreotype.
sé:	see
luto:	cooked
ostentación:	ostentation
advertirlo—:	warn it—
—tal:	— of
siguiente:	following
cementerio:	cemetery
reunida:	gathered
caer:	fall
infarto:	heart attack
muerto:	dead
ellos:	they
uno:	a
2
:	2
inmutables:	immutable
público:	public
envejeciendo:	getting older
intérpretes:	interpreters
lentamente:	slowly
aniquilaba:	annihilated
estío:	state
giras:	tours
actuaciones:	performances
feriados:	holidays
sábados:	Saturdays
tardes:	afternoon
gestos:	gestures
edad:	age
texto:	text
decir:	say
comenzado:	started
desempleo:	unemployment
pagaban:	they paid
rebeldías:	rebellions
contrato.:	contract.
faltaban:	were missing
remedio.:	remedy.
prendida:	on
huésped:	guest
alimentaba:	fed
parásito:	parasite
deshacerse:	get rid
impar:	odd
trágica:	tragic
genio:	genius
menester:	need
Hubiera:	Had
tyrannis.:	of tyrants
frase::	phrase:
latín:	Latin
correctamente:	correctly
pronunciar:	pronounce
inteligente—:	intelligent-
portentosamente:	portentously
críticos:	critics
situación:	situation
—en:	-in
personaje:	character
aprendía:	I learned
acontraltadas:	acontralted
inflexiones:	inflections
hallaban:	they found
Antígona:	Antigone
quería:	wanted to
voz:	voice
rutinario:	routine
espectadores:	spectators
buscaban:	they were looking
alivio:	relief
escaso:	scarce
resultaban:	they turned out
Ifigenia:	Iphigenia
drapeados:	draping
Porcia:	Portion
peinado:	hairstyle
permitidas:	permitted
benéficas:	beneficial
funciones:	functions
fugas:	leaks
breves:	brief
Sus:	Their
evasión—:	evasion-
—un:	— and
vasto:	vast
abierta:	open
Así:	So
consorcio.:	consortium.
acogido:	welcomed
negocios:	business
juvenil:	youth
empeño:	endeavor
generoso:	generous
pasando:	passing
empresarios:	businesspeople
acción:	action
tuvieran:	had
prorrogables:	extendable
contratos:	contracts
atados:	tied
personajes:	characters
representaciones:	representations
quinientas:	five hundred
llegábamos:	we arrived
noches.:	nights.
veinte:	twenty
vislumbrábamos:	we glimpsed
recién:	newly
servido:	served
joven:	young
autor:	author
ayudar:	help
Secesión:	Secession
tragedia:	tragedy
estreno:	premiere
mentira.:	lie.
árboles:	trees
cordel:	string
telarañas:	cobwebs
volantes:	steering wheels
puentes:	bridges
artificio:	artifice
tablas:	tables
prisión:	prison
vuelto:	turned
pensando:	thinking
consternaba:	dismayed
diván:	divan
Sentado:	Sitting
disfraz.:	costume.
trasnochadas:	late nights
convivencia:	coexistence
larga:	long
huellas:	footprints
llevando:	carrying
tocadas:	played
habitación:	room
Hasta:	Until
secas.:	dry.
hojas:	leaves
revuelo:	stir
reverencia:	reverence
tiesura:	direct
engrisados;:	grayed;
desenlace:	outcome
deslucir:	tarnish
transcurrían:	were passing
pregonaban:	they proclaimed
camerino:	dressing room
molestar:	annoy
angosto:	narrow
estrechándole:	squeezing him
precisamente:	precisely
voló:	flew
bambalinas.:	backstage
cayó:	fell
cazador:	hunter
sonó:	rang
salí:	I went out
levitas.:	levitates.
resudado:	result
sudor:	sweat
viejos:	old
hediondas:	hideous
sombras:	shadows
esperando:	waiting
vendados:	blindfolded
harapientos:	Harapientos
heridos:	injured
soldados:	soldiers
brazo:	arm
enrolladas:	rolled up
faldas:	skirts
marcados:	marked
esclavos:	slaves
grupos:	groups
movían:	they moved
jardín:	garden
atravesé:	I went through
hueca:	hollow
resonancia:	resonance
oyendo:	hearing
soportal:	support
anduve:	I walked
Como:	As
Orleáns.:	Orleans.
estilo:	style
garabatos:	scrawl
enrevesada:	convoluted
verja:	defend
enanas:	dwarfs
Detrás:	Behind
taconazo.:	heel
hice:	I did
escamado:	flaky
tronco:	stem
junto:	together
común;:	common;
colaborábamos:	we collaborated
primero:	first
entusiasmo:	enthusiasm
1
:	1
ayudado:	helped
Más:	Further
vacía.:	empty.
jaula:	cage
rosal:	rose
trepaba:	climbed
farol:	lighthouse
Cerca:	Fence
revertido.:	reversed.
penosa:	painful
casi:	almost
colocados:	placed
trastos:	junk
muebles:	furniture
justicia:	justice
severidad:	severity
daban:	different
molduras:	frames
frontón:	fronton
blancas:	white
columnas:	columns
Hacía:	Toward
Deuteronomio:	Deuteronomy
oscuridad.:	darkness.
ciego:	blind
palpa:	palpate
palparás:	you will palpate
ti:	of
está:	this
serán:	will be
están:	are
cielos:	Heavens
tus:	the
PRIMERO:	FIRST
CAPITULO:	CHAPTER
Premio:	Award
concedió:	granted
consagración:	consecration
barroco:	baroque
Concierto:	Concert
método:	method
recurso:	resource
luces:	lights
acoso:	harassment
reino:	kingdom
destacan:	stand out
narrativa:	narrative
vasta:	only
desarrolló:	development
maravilloso»:	marvelous"
teoría:	theory
célebre:	celebrated
Postulador:	Postulator
París.:	Paris.
Embajada:	Embassy
agregado:	aggregate
muerte:	death
Desde:	From
país.:	country.
cubana:	Cuban
Revolución:	Revolution
triunfo:	triumph
tras:	after
residió:	resided
estableció:	established
regresó:	return
residiría:	would reside
trasladó:	transfer
políticos.:	politicians.
motivos:	reasons
encarcelado:	imprisoned
Avance:	Advance
Revista:	Magazine
fundación:	foundation
colaborar:	collaborate
después:	after
cubana.:	Cuban.
activamente:	actively
participar:	to participate
empezó:	started
Carteles:	Posters
revista:	magazine
nombrado:	named
Minorista:	Retail
Grupo:	Group
llamado:	called
Integrado:	Integrated
música.:	music.
periodismo:	journalism
dedicarse:	dedicate
abandonó:	abandonment
Arquitectura:	Architecture
inició:	start
Aunque:	Although
murió:	died
nació:	was born
perdidos:	lost
autobús:	bus
idioma:	language
calles:	streets
cuya:	whose
cuyos:	whose
asomé:	I showed up
imagen:	image
ventanas:	windows
relojes:	watches
olvidar:	forget
buen:	good
luego:	then
esto:	this
cumpleaños:	birthday
dejaban:	they left
durante:	during
también:	also
mirando:	looking
mismo.:	same.
mismo:	same
Nada:	Nothing
Estaba:	Was
algún:	some
correr:	run
tener:	have
libro:	book
bebido:	drunk
otro:	other
esperar:	wait
oliente:	smelly
gesto:	gesture
puso:	heart
vacaciones:	vacation
inmediato:	immediate
colores:	colors
través:	through
espaldas:	backs
preso:	taken 
mucho:	a lot
comienzos:	beginnings
ánimo:	cheer up
otra:	other
nuestra:	our
caído:	fallen
terciopelo:	velvet
él:	he
aquellos:	those
salir:	go out
viaje:	journey
despertar:	wake up
ojos:	eyes
poner:	put
impresión:	impression
función:	function
comienzo:	beginning
campanas:	bells
regreso:	return
volvía:	came back
ese:	that
ello:	it
parte:	part
deseo:	desire
solía:	used to
horas:	hours
vidas:	lives
hacer:	do
ilusión:	illusion
trataba:	tried
trabajo:	job
automatismo:	automatism
llevar:	carry
instinto:	instinct
amaba:	or
qué:	that
hecho:	made
mañana:	tomorrow
telón:	curtain
cierta:	true
éxito:	success
contar:	count
domingos:	Sundays
semana:	week
noches:	nights
palabras:	words
treinta:	thirty
ganas:	desire
cuerpo:	body
aquella:	that
sido:	been
repitiendo:	repeating
tenían:	they had
distinto:	distinct
traje:	lasts
eran:	were
lejos:	far
evadirse:	escape
Ahora:	Now
esta:	this
pasado:	past
lugares:	places
habían:	had
hiciera:	did
perdido:	lost
encajes:	lace
cosas:	things
coincidir:	coincide
fui:	I went
entrar:	to enter
tocara:	will touch
tercio:	third
segundo:	second
escena:	scene
pájaro:	bird
disparo:	shooting
fieltros:	felts
hora:	time
todos:	all
estaban:	were
sensación:	sensation
lugar:	place
siete:	seven
mediodía:	average
debajo:	below
siglo:	century
poco:	bit
vida:	life
estudios:	studies
París:	Paris
pasos:	steps
ALEJO:	GUEST
Contable:	Accountant
semanas:	weeks
fuera:	out
cuarto:	room
quedaba:	remained
todavía:	still
hacia:	toward
cuyo:	whose
Tuve:	Had
desorden:	disorder
sólo:	only
antes:	before
sueño:	dream
aunque:	although
nuestras:	our
hallar:	cases
pero:	but
Iba:	Different
ropas:	clothes
oficio:	job
propio:	own
aquel:	that
muy:	very
posibilidad:	possibility
teatro:	theater
maquillaje:	make-up
mismos:	themselves
raso:	satin
bien:	GOOD
fecha:	date
menos:	less
Por:	By
hallaba:	found
miriñaque:	crinoline
mismas:	themselves
llegar:	arrive
noche:	evening
primera:	first
allá:	there
meses:	months
cuatro:	four
mundo:	world
este:	it is
volvió:	came back
fue:	was
La:	The
demasiado:	too much
entre:	between
tarde:	afternoon
debía:	should
dejaba:	left
todo:	all
dentro:	within
todas:	all
veía:	saw
escenario:	scenery
medio:	half
grandes:	big
compañía:	company
ser:	to be
cada:	each
desde:	from
bajo:	low
misma:	same
tenía:	had
ahora:	now
cabeza:	head
hasta:	until
mí:	my
estaba:	was
siempre:	always
pues:	well
años:	years
tiempo:	time
obra:	work
Pero:	But
alguna:	some
ya:	of
esposa:	wife
días:	days
hubiera:	had
En:	In
vez:	time
más:	further
sus:	their
le:	the
cuando:	when
sobre:	on
El:	He
donde:	where
como:	as
había:	there was
para:	to
su:	are
una:	a
se:	with
del:	of the
por:	by
un:	and
el:	he
que:	what
en:	in
la:	the
de:	of
