74
:	74
relevaban:	relieved
insectos:	insects
zumbido:	tinnitus
envuelto:	wrapped
cantores:	singers
sapos:	frogs
junqueras:	reeds
llenaba:	filled
anochecer:	dusk
hecho.:	made.
castigarla:	punish her
menos—:	less-
—en:	-in
impulsos:	impulses
tenía:	had
enojado:	angry
sentía:	felt
siquiera:	even
común.:	common.
nuestra:	our
refería:	referred
gravísimo:	very serious
ocurrir:	occur
acababa:	ended
ignoraba:	I ignored
dicho:	saying
entendido:	understood
nada:	nothing
acostada:	lying down
Brabante.:	Brabant.
historia:	history
leer:	file
proa:	bow
fui:	I went
capuchino.:	cappuccino.
aunque:	although
austero:	austere
hombre:	man
enardecer:	inflame
bastaba:	it was enough
reinaba:	reigned
hongos:	fungus
olor:	smell
aspirar:	aspire
hecho:	made
timón—:	rudder-
—afirmaba:	—he stated
sucedido:	happened
fornicaciones:	fornications
Tantas:	So many
holgarse.:	relax
hallaban:	they found
parejas:	couples
albergaban:	they housed
franciscano:	Franciscan
antiguo:	ancient
ruinosas:	dilapidated
años:	years
hacía:	toward
risas:	laughter
carcajeó:	cackled
llamarla»:	call her"
debían:	they had to
Príapo:	Priapus
rubor.:	blush.
ligero:	light
abandonada.:	abandoned.
distraídamente:	absently
pregunté:	I asked
aclaración:	clarification
—dejada:	—left
fija:	fixed
latido:	beat
reavivaba:	revived
uno:	a
montañas.:	mountains.
despedazador:	breaker
fantástico:	fantastic
aquí:	here
dejados:	left
guijarros:	shingle
inconcebibles:	inconceivable
puñados:	handfuls
erráticos:	erratic
corriente:	current
Había:	There was
rotos.:	broken.
obeliscos:	obelisks
baldosas:	tiles
caminos:	roads
sí:	Yeah
unidas:	united
mixtas:	mixed
hacia:	toward
descendían:	they descended
derribadas:	knocked down
erguidas:	erected
lajas:	slabs
dispersión:	dispersion
intervenido:	intervened
geometría:	geometry
ciega:	blind
ignorados.:	ignored.
creada:	created
arquitectura:	architecture
vestigios:	vestiges
edades:	ages
perderse:	be lost
dejando:	leaving
florecido:	blossomed
conocidos:	acquaintances
distintos:	distinct
hombres:	men
extraña:	strange
civilización:	civilization
inmovilidad:	immobility
silencio:	silence
perdida:	lost
necrópolis:	necropolis
—restos:	-remains
dólmenes:	dolmens
menhires:	menhirs
arcaicos:	archaic
templos:	temples
ruinas:	ruins
parecían:	they seemed
esparcidos:	scattered
escasos:	scarce
derribados:	knocked down
monolitos:	monoliths
basálticos:	basaltic
árboles.:	trees.
huérfano:	orphan
respiraba:	I was breathing
Todo:	All
saltar.:	hop.
gigantesca:	gigantic
formación:	training
rematada:	finished
bárbaro:	barbarian
empaque:	packing
quietud:	stillness
erguía:	raised
cuerpos:	bodies
tres:	three
Una:	A
petrificados.:	petrified
animales:	animals
saurios:	saurians
forma:	shape
yacían:	lay
faldas:	skirts
tristeza.:	sadness.
sobrecogedora:	overwhelming
pizarrosas:	slate
negras:	black
colinas:	hills
veían:	they saw
izquierda:	left
orilla:	bank
sombrío.:	gloomy.
solemne:	solemn
mostraba:	showed
antesala:	anteroom
poniente.:	west.
reflejaban:	they reflected
mástil:	mast
desprendida:	detached
galera:	crowd
Sobre:	On
corriente.:	current.
poderoso:	powerful
empuje:	push
esquivar:	dodge
tanto:	both
bordeando:	bordering
avanzaba:	advanced
pértiga:	pole
salvar:	save
Luego:	Then
instalados:	installed
vimos:	we saw
conmigo:	with me
permanecer:	remain
cuidó:	cared
partir:	leave
aclaraciones:	clarifications
mayores:	older
pedirle:	ask
Iba:	Different
mano.:	thousand.
señalaba:	pointed out
abandonada:	abandoned
primitivo:	primitive
frondosa:	leafy
peñones:	rocks
crecían:	they grew
traídas:	betrayed
secreto:	secret
revela:	reveals
fronda:	frond
delante:	in front of
anduviera:	walked
Aprovechando:	Taking advantage
rebozo.:	shawl
hatillo:	bundle
Pero:	But
locura.:	craziness.
propósito:	purpose
afirmando:	stating
fregaderos:	sinks
cuartos:	quarters
protestas:	protests
armaron:	they armed
hermanas:	sisters
acto:	act
reunió:	meeting
73
:	73
aquiescencia:	acquiescence
encontrar:	find
voluntad.:	willpower.
espera:	wait
costurero:	sewing box
suspenso:	suspended
ojos:	eyes
hallé:	I found
miré:	Look
nosotros.:	us.
viniera:	would come
grato:	grateful
sumamente:	extremely
modos:	modes
todos:	all
partida.:	match.
abandonar:	abandon
Asunción:	Assumption
compañía:	company
asegurándose:	making sure
corta:	short
jornada:	day
riesgo:	risk
engorros:	hassle
cuanto:	how much
enterarse:	find out
quería:	wanted to
figuro:	figure
adelante.:	forward.
siguiéramos:	we would continue
regreso:	return
esperar:	wait
podría:	could
descansaríamos:	we would rest
Mañana:	Tomorrow
viaje.:	journey.
fácil:	easy
etapa:	stage
acompañara:	will accompany
rogándole:	begging
cuello:	neck
colgó:	hung up
alborozo.:	joy.
aceptó:	accepted
gemas—:	excited—
rutilante:	sparkling
gruta:	cave
visión:	vision
imagino:	I imagine
—deslumbrada:	—dazzled
hablar:	talk
oír:	hear
noche.:	evening.
misma:	same
aquella:	that
hermanos:	siblings
alcanzar:	reach
podríamos:	we could
aseguraba:	assured
comodidad.:	comfort.
boga:	have
adelantar:	pass
aprovechar:	leverage
debíamos:	we should
parecer:	opinion
impaciente.:	impatient.
gesto:	gesture
entendía—:	understood—
además:	besides
—
que:	—
what
discurso:	speech
tajó:	milk
decían:	they said
atención:	attention
prestaba:	lent
nunca:	never
gargantas:	throats
borde:	should
recogido:	collected
decía:	said
raras:	rare
unas:	nails
mostrando:	showing
espectáculo:	show
torno:	lathe
literatura:	literature
empezaba:	started
Ya:	Of
bramidos.:	roars.
llenos:	full
tragantes:	swallowers
atravesados:	crossed
troncos:	trunks
levantadas:	raised
espumosos:	sparkling
pavorosa:	terrifying
frente:	forehead
despecho:	spite
lloraran:	they will cry
descubridores:	discoverers
primeros:	first
importancia:	importance
navegación:	navigation
límite:	limit
contemplar:	contemplate
llevara:	will carry
minero:	miner
rogado:	begged
tiempo.:	time.
navegable:	navigable
caño:	spout
angosto:	narrow
raudal:	torrent
burlando:	mocking
pasar:	market
aprestaban:	they prepared
unos:	some
encontrado:	found
explicar:	explain
obligada:	obligatory
creyó:	believed
tiempo:	time
mismo:	same
observó:	noticed
coser:	sew
atareada:	such
desafiante:	challenging
maligna:	malignant
alegría:	happiness
suerte:	luck
expresión:	expression
expresada:	expressed
rabiosamente:	rabidly
regresar:	go back
voluntad:	willpower
olvidado:	forgotten
Parecía:	It seemed
griego.:	Greek.
seguida:	followed
eso:	that
entrada:	Prohibited
próxima:	next
concertaba:	arranged
dormidos:	asleep
perros:	dogs
lleno:	full
muerte—.:	death-.
percance:	mishap
viviendo:	living
seguir:	follow
costumbre:	habit
quehaceres:	chores
entregadas:	delivered
plácidamente:	placidly
estaban:	were
vestidas:	dressed
cotidiano.:	everyday.
ritmo:	rhythm
vuelto:	turned
despierta.:	wake up.
estuviera:	was
intensamente:	intensely
deseando:	wishing
encaminé:	I headed
disputa:	dispute
posible:	possible
librado:	delivered
verme:	don't give
Contento:	Happy
reaparecido.:	reappeared.
acabando:	running out
habitación:	room
encontraba:	found
horas:	hours
algunas:	some
desperté:	I woke up
almohada.:	pillow.
abrazada:	hugged
durmiendo:	sleeping
seguía:	continued
amanecido:	dawn
creyendo:	believing
albergue:	hostel
llevaron:	they carried
fatigas:	fatigue
posible.:	possible.
prolongaba:	prolonged
enervante:	annoying
acción:	action
tener:	have
comenzaba:	began
envolvía:	wrapped
rústica:	rustic
poco:	bit
demorado:	time-consuming
momentos:	moments
otros:	others
paganos.:	pagans
cabezas:	heads
ensangrentadas:	bloody
herraduras:	horseshoes
asentaban:	they settled
caballos:	horses
guerreros:	warriors
obispos:	bishops
cráneo:	skull
encajados:	embedded
alfanjes:	alphas
mártires:	martyrs
imágenes:	images
bizantina:	Byzantine
factura:	bill
capilla:	chapel
viejísima:	very old
cierta:	true
sobrecogido:	overcoected
tremebunda:	trembling
hagiografía:	hagiography
atmósfera:	atmosphere
hallaba:	found
desangrarse:	bleed out
venía.:	permission.
ciudades:	cities
vitalidad:	vitality
perdido:	lost
reciente:	recent
vitral:	stained glass
plásticos:	plastics
amaneramientos:	mannerisms
capillas:	chapels
áureas:	golden
leyendas:	legends
desteñimiento:	fading
divino:	divine
72
:	72
riendo—:	laughing-
contaba:	counted
—que:	-what
trato.:	deal.
prendía:	turned on
prostituta:	prostitute
descarte:	discard
invocaban:	they invoked
jugadores:	players
bestias.:	beasts.
extravíos:	misplacements
granizadas:	hailstorms
reumatismos:	rheumatism
problemas:	problems
sometían:	they subjected
interpelaba;:	interpelava;
grandes.:	big.
blasfemia:	blasphemy
perdón:	sorry
rogativas:	prayers
tantas:	so many
otras:	others
ser:	to be
solían:	they used to
presentes:	gifts
recibían:	they received
diario:	diary
Reclamaciones.:	Claims.
Ruegos:	Prayers
Ministerio:	Ministry
disponibles:	available
siempre:	always
celestiales:	heavenly
burócratas:	bureaucrats
destajo:	piecework
intercesores:	intercessors
divinos:	divine
funcionarios:	officials
categoría:	category
población:	population
cotidiana:	everyday
cobraban:	they charged
hora:	time
cualquier:	any
procesión:	procession
sacados:	taken out
exvotos:	votive offerings
moneda:	currency
pagados:	paid
exigencias:	demands
agobiados:	overwhelmed
atributivos:	attributive
poderes:	powers
Ricos:	Rich
llagas.:	sores.
parezcan:	seem
verdaderamente:	truly
verdadero:	TRUE
perro:	dog
pelos:	by the
pegado:	glued
Lázaro:	Lazarus
oído;:	ear;
hombro:	shoulder
tramo:	section
mide:	stomach
asido:	acid
Cristóbal:	Christopher
enemigo;:	enemy;
volando:	flying
tiene:	has
garrocha:	pole
parece:	it seems
saña:	fury
dragón:	dragon
alanceando:	reaching
llave;:	key;
cuelgan:	they hang
llavero:	key ring
lleva:	carry
maíz;:	corn;
cañas:	white hair
fresca:	fresh
vestido:	dress
verdad:	TRUE
labre:	labor
mano:	thousand
azada:	hoe
puesto:	position
templo:	temple
Oficios:	Offices
entregados:	delivered
viejos:	old
aleluya:	alleluia
figuras:	figures
personajes:	characters
hacen:	do
luminarias:	luminaries
rodeados:	surrounded
Así:	So
atraviesa:	goes through
mañaña:	tomorrow
pasada:	past
Dentro:	Within
románicas.:	Romanesque
primitivas:	primitive
evoca:	evokes
artesonadas:	coffered
ménsulas:	mensulas
descanso:	rest
vigas:	beams
techo:	ceiling
toscos;:	rough;
bajos:	bass
arcos:	bows
Sus:	Their
espolones:	dewclaws
parecen:	they seem
contrafuertes:	buttresses
tozudez:	stubbornness
hornacinas:	niches
acusados:	accused
volúmenes:	volumes
espesísimas:	very thick
chata:	cottage
Pasión.:	Passion.
instrumentos:	instruments
cincel:	chisel
enumerados:	enumerated
cuya:	whose
cortos:	shorts
brazos:	arms
espesa:	thick
zócalo:	plinth
embaldosado:	tiling
portón:	gate
sólo:	only
separado:	separate
dependencia:	dependence
prolongación:	extension
enterrado:	buried
dejamos:	we leave
cementerio:	cemetery
tapias:	walls
vencido:	won
maleza:	evil
invadido:	invaded
Medio:	Half
junio):	June)
(Sábado:	(Saturday
atrio:	lobby
vecinos:	neighbors
muerto:	dead
sido:	been
contaban:	they counted
semana:	week
ciudades.:	cities.
manadas:	herds
ratas:	wheel
Danubio:	Danube
Oscuros:	Dark
Años:	Years
cronistas:	chroniclers
narradas:	narrated
aquéllas:	those
semejantes:	similar
migraciones:	migrations
sabía:	knew
rincón:	corner
diurna:	daytime
pues:	well
haría:	would
entierro:	burial
viese:	see
difícil:	difficult
ocurrían:	occurred
región:	region
novedad:	novelty
pasos:	steps
historia.:	history.
testigos:	witnesses
tremendo:	tremendous
suceso:	event
cataclismo:	cataclysm
vertiginosa:	vertiginous
multiplicación:	multiplication
arrojadas:	thrown
espantadas:	scared
acaso:	chance
inmensa:	immense
detrás:	behind
continente:	continent
ignoto:	unknown
levantado:	up
violado:	broken
profundo:	deep
amaranto:	amaranth
pequeñas:	small
Eran:	Were
hombros.:	shoulders.
nuestros:	our
vasijas:	vessels
techos:	roofs
llover:	rain
comenzaron:	they started
estuvo:	was
nube:	cloud
abriéndose:	opening
subiera:	would rise
polen:	Poland
candentes:	hot
cenizas:	ashes
humo:	in it
medio:	half
islas:	islands
esas:	those
allí:	over there
rectangulares:	rectangular
amontonamientos:	pile-ups
casi:	almost
bloques:	blocks
humedad:	humidity
paisaje:	landscape
caucheros.:	nightmares.
instante:	instant
ese:	that
misión:	mission
asiento:	seat
punto:	point
De:	Of
caso:	case
ahora:	now
nuestro:	our
esta:	this
esperaba:	I expected
diamantes:	diamonds
salvajes:	wild
lirios:	lilies
hacer:	do
realidad:	reality
desde:	from
granito:	granite
atajo:	shortcut
Negras:	Black
arriba:	above
curiara:	court
junto:	together
ropas:	clothes
contrario::	contrary:
Por:	By
apareció:	appeared
luto:	cooked
mujeres:	women
Allí:	Over there
ya:	of
allá:	there
mí:	my
pero:	but
oreja:	ear
vez:	time
misterio:	mystery
toda:	all
Esto:	This
buen:	good
luces:	lights
especie:	species
vida:	life
cuyos:	whose
le:	the
así:	So
tal:	of
cada:	each
han:	he
quien:	who
fuese:	was
si:	and
éxodo:	Exodus
apenas:	just
aparecen:	appear
tosco:	Tuscan
algo:	something
enorme:	huge
hasta:	until
grandes:	big
mundo:	world
este:	it is
enrojecida:	flushed
cirios:	candles
eran:	were
esos:	those
El:	He
luego:	then
miríadas:	myriads
habían:	had
estriadas:	striated
nosotros:	us
Cuando:	When
rápidamente:	quickly
aquel:	that
trecho:	excerpt
muy:	very
parecía:	it seemed
les:	THE
La:	The
aún:	still
día:	day
cuando:	when
dijo:	said
ni:	in
lugar:	place
algún:	some
hubiera:	had
entre:	between
su:	are
donde:	where
noche:	evening
todo:	all
Adelantado:	Advanced
mariposas:	butterflies
Mouche:	Fly
para:	to
En:	In
sus:	their
más:	further
sobre:	on
había:	there was
como:	as
del:	of the
se:	with
un:	and
por:	by
una:	a
el:	he
la:	the
en:	in
que:	what
de:	of
