81
:	81
deseo:	desire
espera—:	wait-
crispación:	crispation
detenida:	detained
—más:	-further
impaciente:	impatient
entregado:	delivered
ansioso:	anxious
venas:	is coming
pálpito:	palpito
sintiendo:	feeling
cerca:	fence
yerbabuena.:	spearmint
albahaca:	basil
sembraba:	sowed
canteros:	stonemasons
niños:	children
éramos:	we were
estrechaba:	narrowed
mágicos:	magical
viajes:	trips
cesta:	way
olía:	oil
así—:	So-
—casi:	-almost
suspenso::	suspended:
resuello:	wheeze
repentina:	sudden
azafrán.:	saffron.
sándalo:	sandalwood
alcanfor:	camphor
recuerdan:	remember
envolviéndonos:	involving us
viene:	he comes
crujiente:	crunchy
espeso:	thick
heno:	tonight
hojas:	leaves
carnadas:	baits
entre:	between
secas:	dried
plantas:	plants
guarda:	guard
Herborizador:	Herbalizer
cestas:	baskets
derriba:	knock down
brusquedad:	suddenness
quieta:	still
tenerla:	have it
muñecas:	dolls
Agarro:	Grab
violencias.:	violence.
irrupción:	irruption
llego:	arrive
mañana:	tomorrow
riña:	fight
recordar:	remember
encienden:	turn on
Tanto:	Both
puta.:	out.
perra:	bitch
dudar:	dude
entrañas:	bowels
escupir:	spit
arrojar:	throw
insulto:	stroke
epíteto:	epithet
ofensa:	offense
inferido:	inflicted
imaginárselo:	it was imaginary
profundos.:	deep
instintos:	instincts
subleva:	revolt
intención:	intention
repentinamente:	suddenly
revela:	reveals
cariño:	dear
vientre:	belly
tersura:	smoothness
senos:	old
firmeza:	the firm
alabanzas:	praise
muestra:	sample
reto:	challenge
hábil:	skillful
insistencia:	insistence
Luego:	Then
pudor.:	modesty.
aldeano:	villager
conservado:	conserved
despoje:	dispossession
fingidas:	feigned
incita:	incites
probarlo:	try it
oportunidad:	chance
pierde:	lose
nunca:	never
belleza:	beauty
baño:	bathroom
sospecho.:	I suspect.
demasiado:	too much
cuenta:	account
oigo:	I hear
queda:	is left over
voz:	voice
Empezando:	Getting started
decidirla.:	decide it.
techo:	ceiling
despertando:	awakening
vuela:	fly
pájaro:	bird
espero:	expect
aproxima:	approaches
explicación:	explanation
Comprendo:	Understand
hablar.:	talk.
estera:	foreign
hombro::	shoulder:
posa:	put
garrasperas.:	claws
estertores:	death rales
parecen:	they seem
palabras:	words
febril:	febrile
respira:	breathe
suspira:	sigh
noche.:	evening.
primeras:	first
reunió:	meeting
muere:	die
Allá:	There
alzarse.:	rise.
abrazo.:	hug.
respondí:	I responded
irónicamente—.:	ironically-.
—concluyó:	—he concluded
blándula:	fool
vágula:	the vagus
andanzas.:	wanderings.
mujer:	women
imposible.:	impossible.
acceso:	access
después:	after
quedaría:	would remain
débil:	weak
adelante:	forward
seguir:	follow
forzarla:	force her
comodidad::	comfort:
aguardarme:	wait for me
hasta:	until
conduciría:	would drive
mañana.:	tomorrow.
llevarse:	take away
inconveniente:	inconvenient
tendría:	would have
dicendo:	saying
alivio:	relief
providencial:	providential
reflejarse:	reflect
tortura:	torture
causa:	cause
Adivinando:	Guessing
aborrecía.:	hated
escolta:	listen
función:	function
tonta:	old
cumplir:	achieve
preciosa:	lovely
cuya:	whose
avergonzado:	ashamed
vacías:	empty
volver:	return
obra:	work
única:	unique
equivalía:	was equivalent
mío;:	mine;
implicaba:	implied
palúdica:	malaria
derribada:	knocked down
griego.:	Greek.
compañía:	company
avisado:	warned
dignidad:	dignity
reconocerlo:	recognize it
evidente:	obvious
remoto:	remote
hormigas:	ants
comido:	eaten
daban:	different
quien:	who
esperó:	wait
zamba:	fraud
vergüenza:	shame
muerta:	dead
violada:	raped
esposa:	wife
historia:	history
trágica:	tragic
décimas:	tenths
cantaban:	they sang
ribereñas:	riparian
canciones:	songs
indigna.:	unworthy
digna:	worthy
Villano:	Villain
Fiel:	Fell
Amante:	Lover
Ejemplar:	Copy
Esposa:	Wife
Malo:	Place
pieza:	part
80
:	80
tallados:	carved
presente:	gift
personajes:	characters
teatros:	theaters
clásicos:	classics
Como:	As
fuese:	was
hombría:	manhood
perder:	lose
leyes:	laws
Faltar:	Lack
discusión.:	discussion.
excluían:	they excluded
insoslayables:	unavoidable
eternos:	eternal
constantes:	constants
valores:	values
honraban:	in honor
obligaciones:	obligations
obligaba:	forced
palabra:	word
proceder:	proceed
rectitud:	rectitude
padres:	parents
respeto:	I respect
varón:	male
convivían:	they lived together
Para:	To
otros.:	others.
época:	era
Su:	They are
sustituido:	replaced
sacado:	taken
absurdo:	absurd
personaje:	character
auténtico.:	authentic.
ejemplar:	copy
derrota:	defeat
rapidez:	speed
asombraba:	astonished
asestándole:	hitting him
quebrarla:	break it
afearla:	manure
cansarla:	tire her out
desarmarla:	disarm it
divertido:	fun
fuerte:	strong
naturaleza:	nature
días:	days
pocos:	few
enfermedad.:	disease.
soportar:	endure
eligiera:	choose
insecto:	insect
picada:	chopped
estúpidamente:	stupidly
caído:	fallen
tenía:	had
maravillas:	wonders
posibles:	possible
cercanía:	closeness
embellecía:	embellished
ambiente:	environment
desconocido:	a stranger
fronteras:	borders
hollábamos:	we found
término:	term
jornadas:	days
rezongando:	grumbling
quedé:	I stayed
enferma:	sick
quinina:	quinine
comprimidos:	pills
deslizaron:	they slipped
regiones—.:	regions.
estas:	is
importancia:	importance
concedía:	granted
demás:	others
—enfermedad:	-disease
paludismo:	malaria
diagnosticó:	diagnosis
andanzas:	wanderings
experiencia:	experience
larga:	long
autorizado:	authorized
temblores.:	tremors.
estremecida:	extremecidal
inconsciencia:	unconsciousness
hundirse:	sink
delirando:	delirious
incorporado:	incorporated
fiebre.:	fever.
tiritaba:	shivered
noticia::	news:
inesperada:	unexpected
espesarse:	thicken
comenzó:	began
concluyendo:	concluding
escuchando:	listening
pausado:	slow
hablaba:	spoke
palabras.:	words.
pocas:	few
formuladas:	formulated
reflexiones:	reflections
bíblico:	biblical
casi:	almost
sentencioso:	sententious
acaso:	chance
ello:	it
aptitud:	fitness
advertía:	warned
medida:	measure
mismo.:	same.
sí:	Yeah
encerró:	locked up
cuales:	which
calor:	heat
sofocante:	suffocating
varias:	several
Transcurrieron:	They passed
comportamiento:	behavior
insinuante:	insinuating
enardecida:	enraged
enamorada:	in love
despecho:	spite
atribuir:	assign
podían:	they could
ejemplo:	example
—algo:	-something
furia:	rage
agredido:	assaulted
confería:	conferred
reacción:	reaction
violenta:	violent
adivinaban:	they guessed
Mouche.:	Fly.
instinto:	instinct
repelían:	repelled
disturbios:	unrest
Aquí:	Here
solidaridad:	solidarity
tácita:	tacit
semillas.:	seeds.
cuentas:	accounts
desgranaba:	shelled
miraban.:	they looked
dientes:	teeth
enseñaba:	taught
caían:	they fell
jicaras:	jikaras
agraviado:	aggrieved
perro:	dog
carroña:	carrion
regodeado:	gloated
Gavilán:	Hawk
alpargatas:	espadrilles
remendaban:	they mended
falsete.:	falsetto.
sonaban:	they sounded
ajo:	SHE
ají:	chili
aceite:	oil
torno:	lathe
discusiones:	discussions
dándose:	giving
olla:	be
enorme:	huge
hervía:	boiled
pescados:	fish
nerviosidad:	nervousness
demasiada:	too much
ponían:	they put
cosa.:	What.
parecieran:	they seemed
ceño:	frown
fruncía:	puckered
malestar:	discomfort
suerte:	luck
chinchorro.:	chinchorro
atravesados:	crossed
brazos:	arms
silenciosa:	silent
calmada:	calm
regresé:	I came back
desamparo:	helplessness
gemir:	moan
Dejándola:	leaving her
ruegos.:	prayers
tenían:	they had
víspera:	eve
descubrimiento:	discovery
añadidos:	added
semanas:	weeks
mí:	my
sucedido:	happened
recapacitaciones:	retraining
cambios:	changes
retornos:	returns
ternura.:	tenderness.
amistosa:	friendly
vínculo:	bond
subsistir:	subsist
sentimiento—:	feeling-
ese:	that
acerca:	about
asaltaban:	assaulted
—hasta:	-until
tuviera:	had
79
:	79
Apagado:	Off
extraña.:	strange
serme:	laying
llegara:	will arrive
convivencia:	coexistence
prolongada:	prolonged
pensado:	thought
Nunca:	Never
ajena.:	foreign
firme:	firm
oportuna:	timely
alabo:	those
admira:	admire
acorazado:	battleship
frío:	cold
permanezco:	I remain
sentida:	felt
desesperación:	despair
sollozos:	sobs
sacudido:	shaken
viendo:	seeing
momento:	moment
mí.:	my.
inhabitual:	unusual
súplica:	appeal
todavía:	still
sé:	see
suplica:	appeal
Ahora:	Now
demencia.:	dementia.
borde:	should
agota:	exhausts
viaje:	journey
soporta:	supports
acto:	act
quiere:	wants
diciendo:	saying
llorar:	cry
rompe:	breaks
esto:	this
insistir:	insist
agresión;:	assault;
motivo:	reason
ignora:	ignore
responde:	respond
preguntas:	questions
Herborizador.:	Herbalizer.
hamaca:	hammock
gimotea:	gimme
esparadrapos:	adhesive plasters
rubricada:	initialed
farmacia:	pharmacy
Hedionda:	Hideous
choza.:	hut.
enfurecido.:	enraged.
cerrándole:	closing him
denegación:	denial
testarudez:	stubborn
exasperante:	infuriating
repitiendo:	repeating
gacha:	up to
cabeza:	head
sentada:	sitting
negándose:	refusing
obstinado:	obstinate
mutismo:	mutism
ocurrido.:	occurred.
qué:	that
tratamos:	we treat
rodeando:	surrounding
tanto:	both
Mientras:	While
curarla.:	cure it.
lleva:	carry
desollones.:	skinning
arañazos:	scratches
nariz.:	nose.
sangra:	bleed
dientes.:	teeth.
roto:	inside
tenerse:	have
puede:	can
levanto:	I lift
palabra.:	word.
encontrar:	find
bufidos:	snorts
roncos:	snoring
gruñidos:	grunts
traduce:	translate
sujetan:	hold
muerde:	bite
retuerce:	twists
Todavía:	Still
agarrarla.:	grab it.
corremos:	we run
ferocidad:	ferocity
estampa:	print
ofrece:	offers
pegando:	catching
insultos:	insults
escupiendo:	spitting
hombros:	shoulders
suelta:	loose
estaca.:	stake.
bárbaramente:	barbarously
golpea:	hits
empellón:	shove
suelo:	floor
alcanza:	reaches
grueso:	thick
dar:	but
Antes:	Before
huyendo:	fleeing
ayuda:	aid
pidiendo:	asking
empapada:	soaked
ropa:	clothes
aparece:	appears
villano.:	villain.
propósito:	purpose
afrentara:	will affront
sorprender:	surprise
alguien:	someone
pensamos:	we think
grita.:	shouts.
violencia:	violence
extrañado:	missed
vivienda:	dwelling
hacen:	do
acercarse:	approach
Voces:	You
voces.:	you.
oyen:	they hear
peligrosas.:	dangerous.
alimañas:	vermin
albergan:	they house
pocetas:	you will start
cuyas:	whose
cercano:	nearby
caño:	spout
están:	are
dicen:	they say
Pregunto:	Asked
cubre.:	covers.
fango:	mud
costra:	crust
desprenden:	detach
infructuosa:	fruitless
jornada:	day
pulso:	pulse
desacompasando:	out of step
cordilleras:	mountain ranges
selvas:	jungles
adivinado:	guessed
fulgor:	glow
reaviva:	revive
ilusión:	illusion
encuentro.:	meeting.
pobre:	poor
gema:	echo
descubridor:	discoverer
fatalidad:	fatality
desesperanzas:	despair
oficio:	job
miserias:	miseries
grandes:	big
habla:	speaks
diamantes:	diamonds
joven:	young
Riqueza.:	Wealth.
portentosa:	portentous
milímetros:	millimeters
margen:	margin
desvío:	detour
dejado:	left
primero:	first
hallazgo:	find
veces:	times
veinte:	twenty
regresando:	returning
abajo:	below
arriba:	above
profundidad:	depth
lateralmente:	laterally
interrogado:	interrogated
han:	he
lodazal:	mud
revuelto;:	scrambled;
escarbado:	scratched
cavado:	dug
torrente:	torrent
lecho:	litter
seguramente:	surely
esperaba:	I expected
Agamenón:	Agamemnon
gemas:	excited
rutilante:	sparkling
maravillosa:	wonderful
caverna:	cave
decepción:	disappointment
antemano:	beforehand
regocijo:	joy
Regreso:	Return
78
:	78
junio):	June)
acababa:	ended
serpiente:	snake
levantar:	lift
Moisés:	Moses
vara:	be
arrojó:	daring
ranas.:	frogs.
mugían:	go away
fría.:	cold.
tornaba:	returned
noche:	evening
alumbraba:	illuminated
pareció:	it seemed
volvieron:	they came back
pepitas:	nuggets
sabor.:	flavor.
conocer:	know
lengua:	language
tentó:	tempted
alquimista.:	alchemist.
sopesábamos:	we were weighing
crecer.:	grow.
hacerlo:	do it
Palpábamos:	We palpated
claridad:	clarity
nuestras:	our
amarillearon:	yellowed
oscuras:	dark
piedrecitas:	pebbles
lleno:	full
tubo:	profit
destapó:	uncovered
nombre.:	name.
conjuro:	incantation
marcharon:	marchon
primeros:	first
lluvias:	rains
Espesura:	Thickness
rumbos:	directions
tomaban:	they took
año:	year
mineros:	miners
pude:	could
Desconocido—.:	A stranger-.
decir::	say:
cercanías:	surroundings
moraban:	they dwelt
cuantos:	how many
imaginación:	imagination
vivía:	lived
ya:	of
planteada:	raised
nuevamente:	again
quedaba:	remained
existencia:	existence
edificaban:	they built
Parima.:	The best.
rebrillaban:	resplendent
prodigios.:	prodigies.
llegar:	arrive
andar:	to walk
echar:	throw
pararnos:	stop
ganas:	desire
tuvimos:	we had
infancia.:	childhood.
olvidada:	forgotten
devolvió:	returned
decía:	said
Formas»:	Shapes»
esas:	those
detrás:	behind
sabe:	he knows
«Nadie:	"Nobody
iba:	others
pintaban:	they painted
lejanas:	distant
mesetas:	plateaus
señalaba:	pointed out
hoguera:	bonfire
erguido:	erected
Ríos.:	Rivers.
orillas:	shores
misteriosos:	mysterious
signos:	signs
astrales:	astral
figuraciones:	figurations
animales:	animals
formas:	shapes
hablaban:	they spoke
petroglifos:	petroglyphs
millares:	thousands
descifrar:	decipher
nadie:	nobody
acantilados:	cliffs
remotos:	remote
pintaba:	painted
Emplumada:	feathered
Serpiente:	Snake
talladas:	carved
nuevas:	new
Cada:	Each
máxima.:	maximum.
alfabetos:	alphabets
invención:	invention
castigando:	punishing
nudos:	knots
escrito:	written
hubieran:	they would have
planeta:	planet
vistos:	visas
trazados:	traces
pasos:	steps
bajo:	low
presencia:	presence
transitado:	traveled
vastos:	vast
gigantescos:	gigantic
dibujos:	drawings
unos:	some
Pacífico:	Peaceful
Descubríanse:	They discovered each other
hombres.:	men.
negada:	denied
inmortalidad:	immortality
imagen:	image
hubiesen:	they would have
fenecidos:	deceased
derrocados:	overthrown
—dioses:	—gods
ignorados:	ignored
quedarían:	would remain
nombres:	names
cuyos:	whose
erguidos:	erected
Dioses:	Gods
Avenidas:	Avenues
largas:	long
parte:	part
Muerte.:	Death.
contemplación:	contemplation
fijas:	fixed
pupilas:	pupils
terribles:	terrible
caídos:	fallen
párpados:	eyelids
hallarla:	with cases
acababan:	they finished
mirando:	looking
derribados:	knocked down
árboles:	trees
tras:	after
cabezas:	heads
Unas:	Nails
sacerdotes-langostas.:	lobster-priests.
sacerdotes-peces:	fish-priests
ritos:	rites
representaban:	they represented
portentosas:	portentous
pinturas:	paintings
llenos:	full
templos:	temples
monumentos:	monuments
atracaderos:	berths
escalinatas:	stairs
surgían:	arose
Mayas:	Mayans
Maíz.:	Corn.
Imperio:	Empire
migración:	migration
misteriosa:	mysterious
caribes:	caribbeans
varones:	men
existido::	existed:
Urre.:	gold
contemplada:	contemplated
fantasmal:	ghostly
Mesetas:	Plateaus
ámbito:	scope
divisado:	spotted
afirmaba:	claimed
reputado:	reputed
geógrafo:	geographer
narración:	narration
científica:	scientific
Setenta:	Seventy
Luces.:	Lights.
Siglo:	Century
pleno:	full
busca:	search
fueron:	were
misioneros:	missionaries
aceptada:	accepted
Reino:	Kingdom
afirmando:	stating
Prodigios:	prodigies
Abogado:	Lawyer
entonces:	so
trataba.:	tried.
soldados:	soldiers
cuentos:	stories
embustes:	lies
difundir:	spread
afán:	eagerness
sonrisa:	smile
aquella:	that
nombre:	name
renunciar:	give up
marido:	husband
regreso:	return
escenario:	scenery
ajena:	alien
estimación:	estimate
fuera:	out
sueño:	dream
trajo:	brought
tiempo:	time
ciertas:	certain
durante:	during
horas:	hours
derecho:	right
sentía:	felt
estaba:	was
aunque:	although
dudas:	doubts
voluntad:	willpower
pudiera:	could
dureza:	hardness
parece:	it seems
poco:	bit
siente:	feel
vuelto:	turned
semblante:	countenance
herbarios:	herbal
choza:	hut
Está:	This
Le:	The
golpe:	blow
Un:	And
si:	and
apenas:	just
cabellera:	hair
refajo:	they're rehashing
cubierta:	deck
veo:	I see
podido:	could
orilla:	bank
desnudez:	nakedness
salir:	go out
bañando:	bathing
futuro:	future
endeudado:	indebted
regresar:	go back
hace:	does
lugar:	place
bastón:	cane
súbito:	sudden
acercábamos:	we were approaching
punto:	point
buscadores:	search engines
Adelantado:	Advanced
posibilidad:	possibility
nosotros:	us
Todos:	All
emoción:	emotion
profundo:	deep
logrado:	accomplished
otro:	other
ser:	to be
ellos:	they
siglos:	ages
luego:	then
frente:	forehead
aún:	still
aparecían:	appeared
enormes:	huge
De:	Of
habían:	had
Grandes:	Big
años:	years
realidad:	reality
hizo:	those
fidelidad:	fidelity
así:	So
silencio.:	silence.
hombres:	men
todo:	all
muy:	very
este:	it is
Cuando:	When
arroja:	throws
aquí:	here
cuerpo:	body
quienes:	who
encima:	on
mano:	thousand
griegos:	greeks
pensar:	think
La:	The
tono:	application
siempre:	always
En:	In
ojos:	eyes
hacia:	toward
mujeres:	women
cual:	which
debía:	should
le:	the
hubiera:	had
donde:	where
junto:	together
toda:	all
desde:	from
otra:	other
día:	day
antes:	before
sido:	been
gesto:	gesture
todos:	all
Una:	A
lado:	side
dos:	of the
eran:	were
algo:	something
Pero:	But
cuando:	when
tal:	of
cada:	each
ahora:	now
menos:	less
El:	He
peor:	worse
sobre:	on
sus:	their
vez:	time
como:	as
para:	to
había:	there was
Mouche:	Fly
más:	further
del:	of the
un:	and
su:	are
una:	a
por:	by
se:	with
el:	he
en:	in
que:	what
la:	the
de:	of
