151
:	151
Jenofonte.:	Xenophon.
Anábasis:	Anabasis
admiraba:	admired
solamente:	only
apuntar:	aim
faltó:	short
siquiera.:	even.
modificado:	modified
viajaba:	was traveling
preciosas.:	precious.
alientan:	encourage
Responden:	Respondent
viajero:	traveler
Hechicero.:	Sorcerer.
venezolano—:	Venezuelan-
archivos:	files
fonográficamente:	phonographically
grabó:	recorded
shirishanas:	srishanas
descritos:	described
Autana.:	Autoana.
piaroa:	pair
fisonomía:	physiognomy
descubrieron:	discovered
franceses:	French
famosos:	famous
geográfica—:	geographic—
ubicación:	location
—aún:	-still
poblaciones:	populations
tumultuoso:	tumultuous
Brasil:	Brazil
viniéndose:	coming
incipiente:	incipient
acceder:	access
Uarirén:	The Uariren
Capítulos:	Chapters
Sabana:	Sheet
trocado:	exchanged
gótica.:	gothic.
Muerto.:	Dead.
Raudal:	Torrent
paraje:	place
oculta.:	hidden
atracadero:	dock
exactamente:	exactly
América:	America
descrito:	described
fotografiados:	photographed
precisas:	accurate
visiones:	visions
ciñe:	cinema
comunes:	common
integran:	integrate
prototipos:	prototypes
provincianas;:	provincial;
latinoamericana:	latin american
ubicación::	location:
NOTA:	USE
150
:	150
enero:	January
Corteza:	Crust
aclara:	clarify
escamado:	flaky
próximas:	nearby
mueren:	they die
dulces:	sweets
algas:	started
rocosos:	rocky
erizan:	bristle
sumergidas:	submerged
Reaparecen:	They reappear
notablemente:	notably
descendido:	descended
Sísifo.:	Sisyphus.
vacaciones:	vacation
aguarda.:	wait.
Cómitre:	Committee
privado:	private
ensordecido:	deafened
seré:	I will be
Falta:	Lack
—oficio:	-job
sitúa:	situates
tangibles:	tangible
representado:	represented
adelantarse:	get ahead
desligarse:	disengage
impedida:	prevented
difíciles.:	difficult.
amores:	loves
Romanticismo:	Romance
umbrosas:	shady
mansiones:	mansions
transcurre.:	passes.
época.:	era.
mienten:	they lie
ignorarse:	ignore
ardidos:	burning
Navegaré:	I will sail
Manatí.:	Manatee.
embarcar:	embark
pasaje:	passage
fui.:	I went.
trunco—:	trunk
torcido:	crooked
enderezar:	straighten
neumas.:	I don't know.
ordenación:	ordering
lista:	list
contrapuntista:	contrapuntist
exigua:	little
realidades:	realities
Inventores:	Inventors
recóndita:	hidden
pasé:	happens
edades;:	ages;
viajado:	traveled
actuando:	acting
forjan:	forge
costumbres:	traditions
abrigar:	shelter
conversión:	conversion
zozobras:	anxiety
esfuerza:	strive
Apocalipsis.:	Apocalypse.
hacedores:	doers
Prefieren:	They prefer
otra.:	other.
llevadera:	bearable
intelectual;:	intellectual;
convicción:	conviction
explicados.:	explained.
vividos:	lived
mundos:	worlds
alguna.:	some.
febrilmente:	feverishly
Recuerdo:	Memory
Detenido.:	Arrested.
Tiempo:	Time
Visitador:	Visitor
prestado.:	provided.
Fui:	I went
creído:	believed
agobiadora:	overwhelming
varón...»:	male..."
Naturaleza:	Nature
149
:	149
marido.:	husband.
Mujer:	Women
compasión::	compassion:
implorante:	imploring
Sacado:	Taken
destruirlo.:	destroy it.
compareciendo:	appearing
apelación:	appeal
justificarse:	justify
externas:	external
razones:	reasons
adquiridos:	acquired
derechos:	rights
balbuciente.:	stammering
intenta:	try
lacerado:	lacerated
gime:	moans
ordenara.:	would order.
echaría:	would throw
movería:	would move
aliento:	breath
recupero:	recovery
desgarradas.:	torn.
toses:	you cough
derramo:	i spill
Lleno:	Full
quemadura.:	burn.
dentro.:	within.
alfileres:	pins
eriza:	hedgehog
ensordecido.:	deafened
Quedo:	I stay
recién...»:	newly..."
griego—.:	Greek-.
«Mujer:	"Women
hace.:	does.
diga:	say
hable:	speak
fusil.»:	gun."
matarme:	kill me
trabajar::	work:
sacan;:	they take out;
estúpida;:	stupid;
Gente:	People
idiota:	idiot
«Gente:	"People
viniendo:	coming
sospechado::	suspected:
recogió:	picked up
confidencias:	confidences
finge:	pretends
interesarme:	be interested
Adelantado;:	Advanced;
conocí:	I met
hermano:	brother
aparatosamente:	spectacularly
explotación.:	exploitation.
ofrezco:	I offer
buscarme:	look for me
dejará:	will leave
codicia—.:	greed-.
—cosa:	-What
aguardaré:	wait
dilación::	delay:
resigno:	I resign
Despechado:	Dismissed
escuchen.:	listen.
temiendo:	fearing
piensa:	think
dialogar:	dialogue
zarpar:	set sail
Manatí:	Manatee
avisa:	newspaper
salgamos:	let's go out
difiera:	differ
suplico:	I beg
responde—.:	responds.
«Sí:	"Yeah
preocupa.:	worries.
imponerle:	impose
interesa.:	interest
mapa.:	map.
encontrado.:	found.
tropiece:	tropie
denuncio:	complaint
descubrimiento;:	discovery;
desasosegado:	uneasy
buscados:	wanted
tesoros:	treasures
renuncian:	resign
sesos:	brains
trastornado:	deranged
kilates:	cheilitis
grandes.»:	big.”
ahogada—.:	drowned.
confía:	trust
catorce:	fourteen
«Diamantes:	«Diamonds
portentoso.:	portentous.
hundió:	sank
busca.:	search.
centinelas:	sentinels
ahumado.:	smoked.
148
:	148
vidrio:	glass
cristalitos:	crystallites
lámpara:	lamp
asegura:	assures
ruega:	beg
conspirador:	conspirator
hacía.:	toward.
vacila:	hesitate
atropella:	runs over
hilvanada.:	in the hilvana.
nervioso:	highly strung
nada.:	nothing.
desconfiados:	suspicious
inquietos:	restless
penetrante:	penetrating
griego::	Greek:
rasgos:	traits
cambiado:	changed
semanas.:	weeks.
incisión.:	incision.
penetramos:	we penetrate
anegado;:	waterlogged;
interesa::	interest:
afectuosa:	affectionate
tónica:	tonic
halagador:	flattering
avellanado.:	countersunk.
escapara:	will escape
temiera:	feared
agarro:	grab
camisa.:	shirt.
envolviéndome:	involving me
pegar.:	to take.
retuerzo:	twist
broma:	joke
necia:	foolish
exclamación:	exclamation
brutalidad:	brutality
doblándome:	bending
espinazo:	spine
rodilla:	knee
vigorosas:	vigorous
calleja:	quiet
reproducción.:	reproduction.
Alianza:	Alliance
resignadamente:	resignedly
importunar:	pester
escudillas:	bowls
lamen:	hand
escuchan:	they listen
taburetes:	stools
acuestan:	they lie down
inconfundible.:	unmistakable.
determinada:	determined
idéntico:	identical
Sur.:	On.
sobrecogiera:	would overwhelm
sistemáticas:	systematic
grabaciones:	recordings
Descubiertas:	Discovered
jaurías.:	packs
perro-chamán:	shaman-dog
más—:	further-
—nunca:	-never
invariablemente:	invariably
duración:	duration
rocas:	rocks
esucho:	Written by S.
cántico:	chant
entonan:	they intone
picado:	chopped
mandato:	mandate
apaga:	turn off
invertido:	invested
ruidos:	noises
relevo:	relief
espesuras:	thickets
posaran.:	they will put
manzana:	apple
acariciable:	caressable
mutación:	mutation
volumen:	volume
intermitencias:	intermittencies
adelgaza:	lose weight
hincha:	fan
conservando:	preserving
esculturas:	sculptures
aislado:	isolated
estremecidas:	trembling
viaje—.:	journey-.
proseguir:	pursue
—preocupado:	—concerned
esfuerzos:	efforts
aguzado:	sharpened
crítico:	critical
147
:	147
tediosa.:	tedious
seria:	he would be
lentitud:	slowness
transcurren:	pass
Simón.:	Simon.
invitaciones:	invitations
tentadoras:	tempting
desoyendo:	ignoring
urgido:	urgent
abrigo:	shelter
«También:	"Also
guía.:	guide.
regresará»:	will return"
regresará...:	will return...
promueve:	promotes
inmovilizado:	immobilized
Titán:	Titan
irregulares—:	irregular—
estrofas:	stanzas
ocupo:	I occupy
magníficamente:	magnificently
quitado:	taken
carácter:	character
arrumbado:	tidy
zumbantes:	buzzing
espesan:	thicken
llenando:	filling
angustia.:	distress.
semblante...:	countenance...
mudado:	changed
informadores:	informants
trastocados:	upset
serlo:	be
andado:	walked
desandar:	unravel
comete:	commit
demás—.:	others.
negado:	denied
—dueño:	-owner
proponga:	propose
hazaña:	feat
repetir:	repeat
privilegios:	privileges
envanecido:	conceited
repartido:	distributed
trillado:	trite
vivirlo::	live it:
inconscientemente:	unconsciously
excepcionales:	exceptional
Buscando:	Searching
aleja.:	move away
adormecida.:	asleep.
darían:	would give
advertida:	warned
misteriosamente:	mysteriously
secuestrado:	kidnapped
Neolítico:	Neolithic
vuelo.:	flight.
expresarme:	express myself
faltaban:	were missing
audífonos:	earphones
146
:	146
Mandatarios:	Representatives
regresar.:	go back.
tentación:	temptation
decisiva::	decisive:
sometido:	lost
terrores:	terrors
apelación.:	appeal.
poniéndome:	putting me
podamos:	we can
demorando:	delaying
creciente.:	growing.
respeto»:	I respect"
«por:	"by
Riendo:	Laughing
entender.:	to understand.
Digo:	I say
desbordado:	overflowed
momentos.:	moments.
algo.:	something.
descompuesto:	decomposed
machetazos.:	machetes
afincarse:	settle
encontrarla::	find it:
podremos:	we can
mojarse:	get wet
apoyo:	support
meterse:	get in
borda:	edge
caigo:	I fall
«Posible:	"Possible
posible»:	possible"
idénticos:	identical
mansedumbre.:	meekness.
considerando:	considering
contratiempo.:	setback.
últimamente:	lately
marchado:	left
augurio.:	best wishes.
parecería:	it would seem
inverso:	reverse
remando:	rowing
lleno.:	full.
comenzamos:	we start
marca.:	mark.
hoias.:	hoya
dintel:	lintel
estrecha.:	narrow
jambas:	jambs
fuerza.:	force.
advertirla:	warn her
valla:	municipality
seguimos:	we follow
troncos.:	trunks.
ironía:	irony
navegado.:	navigated.
virar:	to turn
recordaría:	I would remember
espolón:	spur
Navegamos:	We sail
encontrarlas.:	find them.
habremos:	we will have
borra:	drill
existen:	there are
superpuestas.:	overlapping.
aparecido:	appeared
mareo.:	dizziness.
iguales:	equal
afianzando:	strengthening
chistar.:	joke
indicaciones:	indications
segundos;:	seconds;
145
:	145
distraído:	distracted
cuenta;:	account;
darme:	give me
asaltan:	assault
tronco.:	stem.
fatigan:	exhausting
Seguimos:	We follow
interroga.:	question.
infinito.:	infinite.
alargarse:	lengthen
lenta:	level
acercamos:	we approach
señalo:	I point out
revueltas:	revolts
bochorno:	embarrassment
Culcán...:	Culcan...
emplumadas::	feathered:
triada:	triad
presididos:	chaired
lanzados:	launched
Guacamayos-
Bólidos:	Macaws-
Racing cars
Cóndores-Mensajeros:	Condors-Messengers
Pájaros-Soles:	Birds-Suns
Águila-Rocío:	Eagle-Dew
Pájaro-Trueno:	Thunder-Bird
majestades:	majesties
desfile:	parade
montañas—:	mountains-
mirarlos:	look at them
dibujados:	drawn
pintados:	painted
ornadas:	ornate
empinado:	prancing
graznar:	grazier
esquimales:	eskimos
Pájaro-Espíritu:	Spirit-Bird
Pájaro:	Bird
desempeñados:	performed
omnipresencia:	omnipresence
concierto.:	concert.
alborotar:	disturb
bandada:	flock
triángulo:	triangle
aplausos.:	applause.
abofetean:	in the palm of your hand
plomizas:	leaden
aletas:	fins
erizando:	erizing
atropellan:	run over
chocan:	they collide
saltan:	they jump
cardumen:	shoal
oscurecido:	darkened
azufre.:	sulfur.
sacarlo:	take it out
pegar:	to take
bastaría:	would be enough
moverse:	move
apretadas:	tight
revolotean:	they flutter
húmeda:	wet
estación:	season
llovido:	rained
caudalosa:	mighty
crecida:	spate
podrida:	rotten
abrieron:	opened
levantaron:	they lifted
literalmente:	literally
reventado:	busted
apoderarse:	seize
Han:	He
atracamos:	we dock
asomarse:	lean out
Acaba:	It's over
144
:	144
quiero.:	wanna.
afinco:	hard
servirlos—.:	serve them.
galeras:	guys
espaldero:	espalier
bogavante:	lobster
dilema::	dilemma:
plantea:	poses
Pruebas;:	Evidence;
consciente:	conscious
amanecidos.:	dawns.
albor:	dawn
macerar:	macerate
recogiendo:	picking
Rúbricas:	Rubrics
ostenta:	boasts
escapé:	exhaust
Sonrío:	I smile
dolorosos:	painful
embates:	clashes
corto:	short
sopesar:	balance
tiñe:	dyes
volverme:	come back
muslos;:	thighs;
cierne.:	hovers.
hablan:	they talk
Huyo:	That one
hago:	do
bolge.:	area.
Miedo:	Fear
miedo::	fear:
asalta:	assault
edición.:	edition.
imponga:	impose
buscar;:	look for;
canse:	get tired
alejarlo:	push it away
conjurarlo:	conjure it
superstición:	superstition
vaga:	vacancy
precaución:	caution
elección:	choice
laberinto.:	maze.
abrió:	opened
romántico:	romantic
acierto:	success
zanjado:	ditched
agüero.:	omen.
tejen:	save
alivio.:	relief.
deliciosa:	delicious
aldea...:	village...
siguiendo:	following
desprendo:	I detach
Llegado:	arrived
agarrara:	will grab
brújula:	compass
ramas.:	remaining.
identificación:	ID
incisa:	engraved
Buscaré:	I will search
cordel:	string
trazada:	traced
—aquella:	-that
guiarlo:	guide him
comprometo:	I commit
navegado:	navigated
seguiré:	I will continue
encontré:	I found
llevarme:	take me
143
:	143
mayores.:	older.
patronas:	cartridges
Inés:	Agnes
Otro:	Other
inexplorados:	unexplored
puestas.:	set.
así»:	So"
encontrara:	will find
dominios:	domains
hollar:	cases
pretendieron:	they intended
aviso:	Notice
tórax:	chest
respuestas:	answers
trueque.:	barter.
mercancías:	goods
navegados:	navigated
remontar:	reassemble
zapatero:	shoe
aindiado:	further
lento:	this
ataúdes:	coffins
medía:	average
carpintero:	carpenter
manatíes:	manatees
rato—.:	mouse-.
comensales:	diners
vasos:	vases
Pido:	I ask
cenizas.:	ashes
grisura:	torn
arrugada:	wrinkled
rescoldo:	ember
sabiduría:	wisdom
ardorosa:	ardent
lumbre:	fire
desconocidas.:	unknown.
bellotas:	acorns
pernil:	ham
chisporrotea:	sizzles
chimenea:	chimney
vainilla:	in vain
terrateniente.:	landowner.
poseedor:	holder
ello;:	it;
rezando:	praying
proclama:	proclamation
horcones:	forks
cobija:	blanket
tomarlo::	take it:
deslindes.:	demarcations.
cercados:	fenced
innato:	innate
mudar:	to change
estuario:	estuary
inmensas.:	immense.
transporte:	transport
precarios:	precarious
cultivado:	cultivated
enrolladas:	rolled up
echándose:	laying down
naturalidad:	naturalness
solteras:	single
compró:	bought
siglo.:	century.
medicinas:	medicines
aceites:	oils
pólvora:	gunpowder
latas:	cans
estantes:	bookshelves
rollos:	rolls
mixta:	mixed
comedor:	dining room
transformada:	transformed
catedral.:	cathedral.
matas;:	fed;
142
:	142
cromos:	trading cards
cándido:	candid
alejándose:	moving away
correas:	straps
reventarles:	burst them
pesaran:	retirement
empila:	stacked
maletas:	suitcases
importancia.:	importance.
acercado:	approached
mecidas:	measures
tejado:	roof
sorpresa::	surprise:
guiaba:	guided
muchacho:	young guy
retarla:	challenge her
mismo::	same:
otorgarse:	be granted
mejillas.:	cheeks.
nariz:	nose
desfiguro:	disfigure
detener:	arrest
invocando:	invoking
morían:	they died
muertes:	deaths
cuerpo.:	body.
impuestas:	imposed
mutilaciones:	mutilations
sangrientas:	bloody
ablaciones:	ablations
Puedo:	Can
desmenuzado:	crumbled
escuadrado:	squared
castrado;:	castrated;
viejísimo:	very old
arrancado:	torn off
pedernal:	flint
flacas:	skinny
costillas:	ribs
levantando:	lifting
flecharlo:	arrow it
desnudado:	stripped
aduanas:	customs
almacenes:	warehouses
caminando:	walking
seguí:	I continued
crucé:	crossing
amaneció:	it dawned
Incapaz:	Unable
dormidos.:	asleep
hospitales:	hospitals
funerarias:	funeral homes
desiertas:	deserted
lonjas:	markets
anduve:	I walked
regresaría:	I would return
huí:	I fled
vestí:	I dressed
advertencia.:	warning.
echada:	cast
artículo—:	article-
—decía:	—he said
Petroglifos.:	Petroglyphs.
emprendido:	undertaken
entrecana.:	grey-haired
lucía:	lucia
él.»:	he."
retrato:	portrait
conocimos;:	we met;
«Creo:	"Believe
barato:	AFFORDABLE
impreso:	printed
boletín:	bulletin
Abriendo:	Opening
verdadero.:	TRUE.
suscripción:	subscription
aceptado:	accepted
sorteando:	raffling
compartiera:	would share
monja:	only
religiosa:	religious
pequeña:	small
velador.:	pedestal table.
publicación:	publication
tomó:	took
141
:	141
favorables.:	favorable.
recobrado:	recovered
sintió:	felt
tomarse:	take
amenazadoramente:	threateningly
cerraba:	closed
asimilaba:	assimilated
cortada:	cut
espíritu::	spirit:
cobraba:	charged
tuviera—:	had—
personificándose:	personifying
conjunto:	set
Sagitario:	Sagittarius
consultas.:	consultations.
preferible:	preferable
pago:	pay
poseída:	possessed
Cualquier:	Any
desprecio.:	contempt.
volvía:	came back
triste:	sad
envuelve.:	wraps
une:	a
definitiva:	definitive
sorpresas:	surprises
abstinencia:	abstinence
quiso:	wanted
accedí:	I agreed
manejó:	management
hábilmente:	skillfully
comprometería:	would compromise
afirmó:	stated
consecuencia;:	consequence;
privarme:	deprive myself
necio:	foolish
trató:	deal
holgadas:	baggy
ponerse:	put on
permiso:	permission
llenó:	full
terminadas.:	finished.
astrológicas:	astrological
consultas:	queries
temprano:	early
alevosía:	treachery
entereza:	fortitude
socavar:	undermine
arreglarse:	get ready
moderación.:	moderation.
crédito:	credit
seducción:	seduction
intentos:	attempts
frustrar:	frustrate
decidido:	decided
margarina;:	Margarine;
hedor:	stench
alumbrada:	lighting
toleraba:	tolerated
abrazado:	embraced
verdaderos.:	true.
magnánimamente:	magnanimously
atribuyéndolo:	attributing it
enfermara:	nurse
echaba:	threw
rectamente—.:	uprightly-.
mentir:	lie
confianza:	trust
inocente:	innocent
Nicolás.:	Nicholas.
remozado:	renovated
lujuria.:	lust.
castigan:	punish
llagas:	sores
siguientes:	following
arrepentimiento:	repentance
plegaria:	prayer
unía:	united
juntos:	together
reñido:	close
desamparo.:	helplessness.
cedería:	would give in
tocador:	dresser
revueltos:	scrambled
afeites:	you leave
percibir:	perceive
calados:	silent
cubrecama:	bedspread
rezaba:	prayed
amenazaba:	threatened
agarrarse:	hold
aterrorizada:	terrified
sufrimientos::	sufferings:
indecibles:	unspeakable
desdoblamiento:	unfolding
140
:	140
impedirlo.:	prevent it.
luchaba:	fought
burdel:	brothel
condujera:	would drive
afirmada:	asserted
definido:	defined
escozor:	stinging
apesadumbra.:	sorrow
discutir.:	to discuss.
escucharla.:	listen to it.
hablarle.:	talk to him
fuera.:	out.
Siete:	Seven
haré:	I will
consulta:	consultation
«Si:	"And
libro.:	book.
cercano.:	nearby.
librarse.»:	get free."
circunstancias:	circumstances
vinculada:	linked
Psicoanálisis::	Psychoanalysis:
afecto.:	keen.
ningún:	none
desea:	want
perspectiva:	perspective
ocultas::	hidden:
Ciencias:	Sciences
posición.:	position.
Egipto::	Egypt:
«CÁRCEL.:	"JAIL.
sueños::	dreams:
hojear:	leaf through
librería:	bookshop
entro:	within
Carceri:	Prisons
di:	Of
Invenzioni:	Inventions
aguafuerte:	etching
colorido:	colorful
caballo.:	horse.
sonaba:	it sounded
frente.:	forehead.
desviación:	deviation
ligera:	light
lontananza:	distance
multiplicaban:	they multiplied
suplicio:	torture
pilares:	pillars
prisión:	prison
soñé:	I dreamed
Anoche:	Last night
augurios:	omens
Busco:	I'm looking
prensa.:	press.
horóscopos:	horoscopes
excelente.:	excellent.
vitrina;:	showcase;
expuesta:	exposed
agüero:	omen
araña:	spider
presagios:	omens
imposibilidad:	impossibility
Abetos:	Fir trees
resuello.:	wheeze.
asomaba:	appeared
fogatas:	campfires
mojadas:	wet
leñas:	firewood
tacto:	touch
Algunas:	Some
aplacamiento.:	appeasement.
procura:	search
adormilan:	sleepy
otoño:	autumn
herrumbrosos:	rusty
conducen:	drive
caminatas:	walks
interminables:	endless
emprendo:	I undertake
encaja:	fits
viene.:	he comes.
Tarda:	Afternoon
suspende:	suspend
¡Ay:	Yes
alusiones::	allusions:
lacerantes:	tearing
cargarse:	load
tierna:	tender
encontrarme:	find me
amargura:	bitterness
fortuitos—.:	fortuitous.
asombrosa:	amazing
trastocaron:	disrupted
—día:	-day
casualidad:	chance
abriera:	would open
estampan:	stamp
encuadernado:	bound
139
:	139
Servando:	Serving
maravilladas:	amazed
lecturas:	readings
anunciando:	advertising
moblaje:	furniture
paquete:	package
cazuela:	casserole
armarios.:	wardrobes.
cocinan:	they cook
fuman:	they smoke
suelas:	soles
nieve:	snow
camisa:	shirt
lavan:	stage
lanzado:	launched
masa:	time
cordeles:	twine
entretejen:	interweave
ir.:	and
semana.:	week.
cobrarlos:	charge them
desgana:	reluctance
ejecuto:	I execute
instrumentación:	instrumentation
encargos:	charges
cuantía:	amount
necesito:	need
divorciado:	divorced
aspirantes:	aspirants
infructuosamente:	vainly
buscado:	sought
estudios.:	studies.
asistente:	assistant
publicitaria:	advertising
perdona:	sorry
derramadas.:	spilled.
margarinas:	margarine
alfombras:	rugs
estudiantes:	students
experto:	expert
advirtiendo:	warning
recibe:	receive
luminosos.:	luminous.
anuncios:	advertisements
aceras:	sidewalks
encontrándome:	finding me
firmar:	sign
firmo:	the company
secretarios:	secretaries
interrogo:	I ask
aguardo:	I wait
viajo:	I travel
esquinas:	corners
doblo:	doublo
eliminada:	eliminated
embrollo:	imbroglio
negaba—.:	he denied.
procedimiento:	procedure
amoralidad:	amorality
tornear:	turn
plenamente:	fully
darse:	give
sacrificando:	sacrificing
vacilado:	hesitated
santuario:	sanctuary
impuesta:	imposed
cotidiano:	everyday
torturara:	will torture
Secesión:	Secession
vendimia.:	vintage.
viña:	came
edifica:	build
Escrituras:	Scriptures
despreciable:	negligible
gravidez.:	pregnancy.
indicio:	indication
explota:	explode
enredado:	tangled
simplificar:	simplify
alarma.:	alarm.
embarazo:	pregnancy
nación.:	nation.
jueces:	judges
representando:	representing
empeñada:	pawned
carmín:	carmine
encarnizada:	fierce
difuminar:	blur
internacional:	International
vil:	will
Tuve:	Had
abominación.:	abomination.
transgresor:	offender
considerarme:	consider me
Pastores:	Shepherds
perdonaba:	forgave
instancia:	instance
tembloroso.:	trembling.
dobló:	folded
reportaje:	reportage
devueltas:	returned
138
:	138
octubre):	October)
cómitre.:	comitre
mazo:	the little one
Hombre-Ninguno:	Man-None
Hombre-Avispa:	Wasp-Man
acepto:	I accept
intacto;:	intact;
nacido.:	born.
envejece:	gets old
cansa:	tired
contemplarlo;:	contemplate it;
futuro.:	future.
pretérito:	past tense
barajado:	shuffled
posibles—.:	possible—.
Icarias:	Ikarias
permitidas:	permitted
Utopías:	Utopias
porvenir:	future
acordándome:	remembering
lugar::	place:
componían:	they composed
limón:	lemon
recio:	tough
dividido.:	divided.
contado:	counted
laberinto:	maze
espacio.:	space.
lanzadas:	thrown
frases:	phrases
cornisas:	cornices
pregonados:	heralded
títulos:	titles
expuestas:	exposed
anuncia::	announces:
lugares—.:	places—.
muevan:	move
higos:	figs
caigan:	fall
Sello:	Seal
Sexto:	Sixth
apertura:	opening
devuelto:	returned
ocurrir.:	occur.
simiente:	seed
publicidad;:	advertising;
tensos:	tense
interpelaciones:	interpellations
servidumbres;:	easements;
colectividad:	community
reprimenda:	reprimand
atajado:	shortcut
impulso:	impulse
rebeldía:	rebellion
apetencia:	appetite
destinos.:	destinations.
forjarse:	forge
propuesta:	proposal
máxima:	maximum
biblioteca.:	library.
esencias:	essences
fortuitos:	fortuitous
resueltos:	resolved
Estas:	It is
creadores.:	creators.
imitando:	imitating
Occidente:	West
renovar:	renew
Querían:	they wanted
perseguida.:	persecuted.
cartesiano:	Cartesian
cogitante:	thinking
calificador:	qualifier
colocaban:	they placed
«bárbaras»:	«barbarians»
calificadas:	qualified
—
cosas:	—
things
bárbaras:	barbarians
barbarie:	barbarism
Buscaban:	They were looking
Método:	Method
Discurso:	Speech
137
:	137
fetiches:	fetishes
africanos:	Africans
blandían:	the mixture
risible:	laughable
razón.:	reason.
debieran:	should
fervores:	fervor
savias:	swordfish
rejuvenecerse:	rejuvenate
cansada:	tired
primitivos—.:	primitives—.
batería:	battery
instintivas:	instinctive
energías:	energies
interrogaban:	they interrogated
enigmáticos:	enigmatic
vaciados:	emptied
exhiben:	exhibit
pintura:	paint
vitrina:	showcase
plazas:	places
bosta:	they will be
zócalos:	sockets
magistralmente:	masterfully
cubriendo:	covering
soñando:	ringing
apisonar—.:	अपिसोनार—.
comunica:	communicate
seda:	this
contactos:	contacts
abrazos:	hugs
propiciando:	enabling
apagan:	turn off
rítmicos.:	rhythmic.
reducido:	reduced
movida:	moved
ingredientes:	ingredients
rodea.:	surrounds
Reconocido:	Recognized
filtraciones.:	leaks.
bóveda:	vault
remeda:	remedy
raso:	satin
burgués»—.:	bourgeois"-.
«espíritu:	"spirit
fiel:	fell
—aunque:	-although
rancios:	stale
locura:	craziness
nada—:	nothing-
—muniqueses:	—muniques
rococós:	rococo
castillos:	castles
panorámicas:	panoramic
vistas:	views
Hornig:	Horny
cochero:	coachman
Baviera:	Bavaria
agrandadas:	enlarged
intermitentemente:	intermittently
rozados:	rubbed
giratorio:	rotary
montados:	mounted
móvil:	mobile
hipocampos:	hippocampi
iluminadas:	illuminated
grutas:	caves
trozos:	pieces
estuco:	stucco
montado:	mounted
estrado:	platform
astrágalo.:	astragalus.
clepsidra:	hourglass
metrónomo:	metronome
costillar:	rib
exangüe:	bloodless
desollados:	skinned
desesperanza:	hopelessness
pétreos:	stony
falos:	will fall
muletas:	crutches
ciclistas:	cyclists
bicicletas:	bicycles
áridas:	arid
llanuras:	plains
escenografías:	scenery
sótano:	basement
divertirse:	enjoy
góticos.:	goths.
luminosa:	bright
veníamos:	we came
fatigados:	fatigued
desamparados:	helpless
fuguen:	the fugue
tampoco:	neither
fuerzas:	forces
repondrán:	will replenish
Vivieron:	They lived
nutricias.:	nutricies.
empresas:	companies
vendieron:	they sold
extenuados:	exhausted
ahogar:	drown
circundante:	surrounding
culturas:	cultures
retazos:	scraps
fachadas:	facades
136
:	136
encrespamiento:	inking
ocurrencia:	occurrence
estilo.:	style.
sustituirlos:	replace them
secarse:	dry up
Renacimiento:	Renaissance
acantos:	acanthus
ejecutados:	executed
entablamentos:	entablatures
agonizantes:	dying
edificios:	buildings
enfermas:	sick
tenidas:	had
coagulada:	coagulated
pringoso:	catch
trofeo:	trophy
ornamento:	ornament
aplicado:	applied
arquitecto:	architect
bucráneo:	bucranium
triglifos:	triglyphs
antiguo::	ancient:
asienta:	nods
implicaciones.:	implications.
luciferada:	luciferated
propiciatoria:	propitiatory
percusión:	percussion
alianza:	alliance
gaje:	grows
enmascarado:	masked
purificación:	purification
desconozca::	don't know:
inscripciones:	registrations
conservar:	keep
enjoyaron.:	they bejeweled
almendra:	almond
abeto:	fir
bautismo:	baptism
almendras:	almonds
Epifanía:	Epiphany
Buscan:	They search
gestos.:	gestures.
simbólica:	symbolic
arroz:	rice
reciben:	receive
anillos:	rings
intercambian:	they exchange
casan:	feet
hacen.:	do.
asisten:	assistant
advierto:	I warn
congregados:	congregants
percatarme:	notice
acompaña.:	accompanies
escucharse:	listen
hombres::	men:
mayoría:	most
ininteligibilidad:	unintelligibility
Dei:	Of the
atris:	black
—plantatus:	- planted
multiplicatur::	is multiplied:
Libani:	Lebanon
cedrus:	cedar
—
Sicut:	-
Like
florebit::	will bloom
gregoriano::	Gregorian:
muertas.:	dead
repleto:	full
foso:	pit
ensancha:	widens
fieles:	faithful
malentendido.:	misunderstanding.
escuelas:	schools
latín:	Latin
sacerdote.:	priest.
nocturno:	night
congregado:	congregated
cirios::	candles:
amarillor:	yellower
deambulatorio.:	ambulatory
resuenan:	resonate
invitan:	invite
ahumadas:	smoked
tiembla:	trembles
socavón:	sinkhole
comprada;:	purchased;
gabán:	overcoat
ladrillo:	brick
garita:	sentry box
avanzado:	advanced
hornacina:	niche
paradas.:	stops.
momias:	mummies
aturdidos:	stunned
soldadas:	welded
escaparates:	escapes
resguardados:	sheltered
espacios:	spaces
angostos:	narrow
Descubro:	I find out
prisa.:	hurry.
inválidos:	invalid
135
:	135
comercios:	shops
progresar:	to progress
ajustarme:	adjust
logro:	achievement
semáforo.:	traffic light.
semáforo:	traffic light
agitación:	agitation
restablece:	resets
reinante;:	reigning;
pulsación:	pulsation
constancia:	constancy
tranvía:	tram
permite:	allows
encenderse:	light
corresponde:	corresponds
orgánicas.:	organic.
voluntades:	wills
acera:	pavement
descubrir:	discover
adquirido:	acquired
tarde):	late)
(Más:	(Further
escaleras.:	stairs.
bajé:	I went down
Cansado:	Tired
sí.:	Yeah.
levantó:	rose
remoto;:	remote;
gemidos.:	moans.
adolorida:	sore
mirarme:	look at me
infantil:	children's
humilde:	humble
avilantez:	degrade
defenderla:	defend her
naciendo:	being born
doblándose:	bending
desolado:	bleak
Temis:	It was
embarazo.:	pregnancy.
Justicia.:	Justice.
encarnación:	incarnation
Poder:	Can
femenina:	feminine
majestuosa:	majestic
estatua:	the state
Átala.:	Atala.
ridiculizante:	ridiculous
designaba:	designated
embrolladas:	muddled
tramitaciones:	procedures
pérfidos:	perfidious
lazos:	ties
confundiría:	would confuse
sinuosos:	sinuous
atado:	tied
advirtió:	warned
modelarla:	with models
negrura:	blackness
atiesada:	Atisara
Helada:	Frost
fiscales.:	prosecutors.
abogados:	lawyers
registro:	record
bajó:	low
paroxismo...:	paroxysm...
ascendía:	ascended
monólogo:	monologue
lacerarse:	lacerate
aplazados:	postponed
dramáticas:	dramatic
inhibiciones:	inhibitions
Sospecho:	I suspect
justeza.:	fairness.
apoyando:	supporting
delgados:	thin
gestos::	gestures:
impresionó:	impressed
escenario.:	scenery.
alzó:	raised
inquebrantable.:	unwavering.
expone:	exposes
alterado:	changed
repetí:	I repeated
escuchar:	listen
colocó:	placed
amenazada:	threatened
distensión:	distension
serpiente.:	snake.
rastreada:	tracked
plantando:	planting
prestaban:	they lent
134
:	134
aumentar:	increase
divirtiendo:	having fun
aposento:	chamber
caballería.:	chivalry.
secretos:	secrets
callaban:	they were silent
callarse:	shut up
pruebas:	evidence
prestigios:	impressive
comunes;:	common;
asidero:	handle
llaves.:	keys.
requería:	required
incomprensible:	incomprehensible
imprevisto:	sudden
presentando:	presenting
saqué:	I took out
decisivo:	decisive
asestar:	deal
enfriar.:	cool.
puestos:	positions
vinos:	wines
departamento:	department
dispuesta:	willing
delicada:	delicate
conclusión:	conclusion
reconfortante:	comforting
faltaría:	would be missing
previsto:	predicted
anticipación:	anticipation
suyas:	his
colocadas:	placed
pantuflas:	slippers
velador:	pedestal table
mejores:	best
sábanas:	bed sheets
arreglada:	fixed
magnánimo.:	magnanimous.
sollozante:	sobbing
vendría:	would come
castigada:	punished
comprensión:	comprehension
endulzando:	sweetening
aceptar.:	accept.
generosa:	generous
compasión:	compassion
mejor.:	better.
verdad—.:	TRUE-.
moradas:	purple
devuelta:	returned
regresara:	will return
—desde:	-from
engañosas:	misleading
falacias:	fallacies
significaban:	they meant
desprecio:	contempt
vicios:	vices
desprendimiento:	detachment
Sigue.»:	Go on."
Sigue...:	Go on...
«Sigue...:	"Go on...
operación:	operation
gimiente:	moaning
estertor:	rattle
acertaba:	was right
jadeante:	panting
desplomada:	collapsed
físico.:	physical.
impudor:	impudence
juvenil:	youth
adornado:	decorated
hablé:	I spoke
injustificada.:	unjustified.
aparentemente:	apparently
ruptura:	rupture
acarrea:	carries
trastornos:	disorders
distante;:	distant;
detalle:	detail
hincada:	kneeling
revelado:	revealed
añadir:	add
vindicativa:	vindictive
séptimo:	seventh
fornicación:	fornication
reducida:	reduced
antepuesta:	anteposed
Culpé:	Culpe
dinero.:	money.
innegable:	undeniable
abyecta:	abject
asistiera:	would attend
largando:	letting go
precipité:	precipitate
contenerse:	contain
cólera:	anger
estallido:	pop
adelantarme:	get ahead
apretar:	squeeze
hundido:	sunken
crispadas:	tense
mucho—:	a lot-
defecto:	flaw
mueca:	grin
trágicas:	tragic
yesosa:	of sauce
palabras;:	words;
ridículo.:	ridiculous.
oportunidad.:	chance.
pérfida:	perfidious
evidenciado:	evidenced
equívoco:	misconception
querida.:	dear.
133
:	133
nación:	nation
ironía::	irony:
malvada:	evil
vislumbrar:	glimpse
impostura.:	imposture.
vengando:	avenging
entender::	to understand:
entiendan:	understand
interesados:	interested
basta:	it just is
derribara:	would knock down
voluntariamente:	voluntarily
Completa:	Complete
primitivos.:	primitives.
cosmogónicas:	cosmogonic
confiada:	confident
aprovecha:	take advantage
astrología:	astrology
estudiosa:	studious
relaciones.:	relations.
índole:	nature
justificar:	justify
erudición:	erudition
falsa:	false
despliegue:	deployment
evidentemente:	evidently
debidos:	due
Pitágoras:	Pythagoras
nombra:	name
indostánicos:	Hindustani
cita:	dream
movimientos;:	movements;
lluvia»:	rain"
especialista:	specialist
risibles:	laughable
errores:	errors
cometiendo:	committing
aterradora:	terrifying
intrepidez:	fearlessness
planetaria.:	planetary.
jerarquía:	hierarchy
relacionaron:	related
astrológico:	astrological
enfoque:	approach
organográfico:	organographic
estudiaba:	I studied
colaboradora:	collaborator
sorpresivo:	surprising
declaró:	declared
tenida:	had
relata:	reports
revelaciones:	revelations
despreciable—:	negligible-
tabloide:	tabloid
—tomado:	-taken
artículo:	article
escándalo.:	scandal.
explotación:	exploitation
coloquio:	colloquium
fotografía:	photograph
trozo:	piece
encendidos:	on
violento:	violent
decirle:	tell
temidos:	feared
retarda:	slows down
distracción:	distraction
alegro:	glad
deslizado:	slipped
vecino:	neighbor
recorte:	cutout
inclinado:	inclined
vez...:	time...
devuelve:	returns
maravillas.:	wonders.
falsas:	fake
arsenales:	arsenals
producido:	produced
sutil:	subtle
muerto.:	dead.
entrepaños:	shelves
alineados:	aligned
aquello.:	that.
Ninguno:	None
otro.:	other.
entrara:	will enter
potestad:	power
arrogarse:	assume
atreviera:	dared
indignado:	indignant
extrañamente:	strangely
reposo»:	repose"
«Tómese:	«Take
empresa::	enterprise:
candilejas.:	footlights.
apagar:	to switch off
telón:	curtain
Ayuntamiento:	City hall
vestido.:	dress.
modelado:	modeling
entendidos:	understood
guiños:	winks
tribulaciones:	tribulations
persuasivamente:	persuasively
Protagonista:	Hero
quitar:	remove
agotarse:	run out
presiente:	present
engrandecida:	enlarged
Griseldis:	in Griseld
hablarle:	talk to him
Penélope:	Penelope
bodas;:	white;
ración—:	ration-
desflo:	deflo
—esta:	-this
132
:	132
aplaudir.:	applaud.
dicha:	bliss
ofrecerse:	offer
artimañas:	tricks
admirar:	admire
diversa:	different
matizada:	nuanced
actuación:	performance
actualidades:	news
camarógrafo:	cameraman
esbelta:	slender
acompañará:	will accompany
declaración:	declaration
breve:	brief
citó:	cited
coloca:	put
sorprendido;:	surprised;
íntimo:	intimate
golosina:	candy
cartera;:	briefcase;
oblea:	wafer
importante:	important
jaqueca:	migraine
alivia:	relieve
acecha;:	stalks;
fotógrafo:	photographer
entona:	gas
inasible;:	ungraspable;
ubicua:	ubiquitous
resurgir:	resurface
desaparece:	disappears
desliza:	slide
partes;:	parts;
bailarina.:	ballerina.
movilidad:	mobility
ama:	or
usurpa:	usurp
iniciativa:	initiative
quitando:	removing
gravitación:	gravitation
eje:	axis
desenredando:	unraveling
enredando:	getting tangled up
vida::	life:
retratos:	portraits
Ayuntamiento.:	City hall.
encamino:	on the way
Escoltado:	Escorted
decían.:	they said.
desaparecen:	disappear
concurrencia:	concurrence
estrechamente:	tightly
olvidado::	forgotten:
surgir:	to emerge
envuelven:	they wrap
ya—.:	of—.
—completamente:	-completely
públicas:	public
comisionado:	commissioner
sincronización:	synchronization
finalmente:	finally
bailarina:	ballerina
cerámicas:	ceramics
pintor:	painter
municipalidad:	municipality
gobierno:	government
Facultades;:	Faculties;
Decanos:	Deans
encabezada:	headed
delegación:	delegation
emocionado;:	thrilled;
aeródromo.:	aerodrome.
rotos:	broken
cegado:	blind
hombro.:	shoulder.
prorrumpir:	break out
viste:	showed
tejido:	tissue
reconozco:	I recognize
flancos;:	flanks;
abrigos:	shelters
escalerilla:	ladder
señalen:	point out
librar:	librate
adversario:	adversary
repudio.:	repudiation.
acallan:	silence
desarman:	disarm
asistidos:	assisted
amada:	loved
ejercer:	exercise
tiranías::	tyrannies:
combatir:	combat
mí—.:	my-.
deserción:	desertion
brusca:	abrupt
explicaría:	would explain
—gravidez:	-pregnancy
agravarse:	get worse
remordimientos.:	regrets.
plantearé:	I will raise
treinta:	thirty
Cobraré:	I will charge
relato.:	report.
veracidad:	veracity
sucedidos:	successful
indígenas:	indigenous
suramericano:	south american
escritor:	writer
famosa:	famous
«misión»:	"mission"
llegué:	I arrived
hambriento:	hungry
kilómetros:	kilometers
131
:	131
atravesando:	passing through
fugarme:	run away
logré:	I managed
desconfiada:	suspicious
tribmás:	tribmore
venderé:	I will sell
inspiran:	inspire
plantado:	planted
apartado:	apart
«misión:	"mission
reportes:	reports
refirieron:	they referred
visitantes:	visitors
equivaldría:	would be equivalent
ahora—.:	now-.
—ya:	—of
innumerables:	countless
exclusividad:	exclusiveness
reservarle:	reserve
acepté:	I accepted
meses.:	months.
rutinario:	routine
acoplado:	coupled
desventura:	misfortune
emergido:	emerged
inteligible:	intelligible
parasitarios:	parasitic
despedida:	farewell
tomaría:	would take
permaneciera:	would remain
grité:	I screamed
incluían:	included
hispánicas:	hispanic
traería:	would bring
Aterrado:	Grounded
decirme.:	tell me
entendí:	understood
reía:	laughed
Lloraba:	I cried
teléfono.:	telephone.
hemisferio:	hemisphere
venida:	coming
Kappelmeister:	Bandmaster
embuste.:	scam.
arrumba:	rumba
embustero.:	liar.
aplaudir:	applaud
aplaudirme:	applaud me
disponen:	they have
pendientes:	earrings
orbe:	the world
ciernen:	hover
guerras:	wars
capaces:	capable
Millones:	Millions
cornadas.:	gored.
toreo:	bullfighting
albur:	dace
riesgos:	risks
elegido:	elected
libremente:	freely
desempeño:	performance
bárbaros:	barbarians
enternece:	internecially
hacinados:	overcrowded
fríamente:	coldly
sobrecoge:	overwhelms
holgada:	baggy
irritado.:	irritated.
enterando:	finding out
evoquen:	evoke
Ana:	Well
Crónica:	Chronicle
Pequeña:	Small
infringir:	infringe
talento:	talent
investigación:	investigation
mártir:	martyr
refieren:	refer
artículos:	articles
persistente:	persistent
temática:	thematic
ejemplar.:	copy.
lectores:	readers
presentarme:	introduce myself
empeña:	pawn
congraciarse:	ingratiate
aviadores:	aviators
premiar:	reward
generosamente:	generously
sobremanera::	exceedingly:
130
:	130
conyugal.:	conjugal.
cuadro:	chart
trazado:	having sex
mimetismo-mágico-rítmico:	magic-rhythmic mimicry
absurda:	absurd
á:	on
uniforme:	uniform
Jesús:	Jesus
regañadientes—:	reluctant—
incluso:	even
publicadas:	published
nacional.:	national.
desaparición:	disappearance
geográfica:	geographical
inexplorada:	unexplored
hallara:	to cases
exigiera:	demanded
luego—:	then-
sanguinarias:	bloodthirsty
tribus:	three
sabios:	wise
viajeros:	travelers
evocaron:	evoked
tarde—:	afternoon—
fuere:	was
—quien:	-who
comienzos:	beginnings
mías:	mine
redacción:	wording
réplica:	replica
sollozar:	sob
Rompió:	Broke
corazonada.:	hunch.
cuentan—:	count—
estando:	standing
mapa:	map
Organográfico:	Organographic
irguiendo:	erecting
periodistas:	journalists
recortes:	clippings
mostraron:	showed
envidiarme::	envy me:
atracción:	attraction
contrasentido:	contradiction
desarrollarse.:	develop.
tendrán:	they will have
humos:	fumes
papel::	paper:
interpretar:	interpret
clima.:	climate.
cronologías:	chronologies
escaparon:	they escaped
pasmosa:	astonishing
cálculo:	calculation
opresión:	oppression
angustiosa:	distressing
alegran:	they rejoice
ventanillas.:	windows.
paseando:	strolling
luminosas:	luminous
ubicar:	locate
divierten:	have fun
Algunos:	Some
encenderse.:	light.
humo—:	in it—
colosos:	colossi
carcomidos:	eaten away
truncos:	trunks
manso:	meek
Acabamos:	We're done
sueños:	dreams
viviendo.:	living.
SEXTO:	SIXTH
129
:	129
alcanzando.:	reaching.
altitud:	altitude
visibilidad:	visibility
volaremos:	we will fly
Avisado:	Warned
aisla:	isolate
niebla:	fog
ascendemos:	we ascend
bonanza:	see them
buitres.:	vultures.
revuelo:	stir
Lejos:	Far
viuda.:	widow.
olfato—:	smell—
—dividida:	—divided
advertir:	warn
alzar:	raise
camina:	walk
128
:	128
cogollo.:	heart.
sacude:	shake
molinetes:	pinwheels
vecinos.:	neighbors.
invadida:	invaded
giramos:	we turn
Meseta:	Plateau
rasando:	rage
abajo;:	below;
quedan:	remain
ruedas:	wheels
encajar:	fit
trepidante:	trembling
explanada;:	esplanade;
motores:	engines
metálica:	metallic
seña.:	sign.
cabina:	cabin
jubilosa.:	jubilant
prorrumpen:	they break out
avión.:	plane.
acariciado.:	caressed
abrazaban:	they hugged
zafa:	they died
beso:	kiss
mirarme.:	look at me
rencoroso:	rancorous
llevar»:	carry"
puedes:	can
valiosa:	valuable
entrego:	I deliver
despectiva.:	derogatory
encogiéndose:	shrinking
decidir.:	decide.
explico:	I explain
imperativo.:	imperative.
nombrando.:	naming.
mirara:	will look
mirara.:	would look
liberador.:	liberating.
mensaje:	message
sabía.:	knew.
aplauso—:	applause-
huera:	hula
envanecerme:	get puffed up
Aunque:	Although
torceduras.:	sprains.
curaran:	curan
creyera:	believed
respecto:	regard
curado:	cured
ejucutándola:	ejucutandola
entenderían:	they would understand
destinada:	intended
directores:	directors
correo:	mail
quedando:	staying
producida:	produced
estaría:	would be
obstaculizar:	hinder
comprendiera:	would understand
Aceptaría:	I would accept
malograda.:	ill-fated
ataba:	he won't be
rotura:	rip
cumplimiento:	compliance
exigía:	demanded
brusca;:	abrupt;
adaptación:	adaptation
lealmente:	loyally
explicarle:	explain
comunicado:	statement
enviado:	sent
requieren:	require
legítimo:	legitimate
gobierna:	governs
adoctrina:	doctrine
Caza:	Hunt
cumplen:	they comply
demás.:	others.
iré:	I will go
decisión::	decision:
aluminio.:	aluminum.
cabaña.:	cabin.
turbaban:	they were disturbing
presencias:	presences
librarán:	will free
127
:	127
deberían:	should
apremiarme.:	urge me
enérgicamente:	strongly
colocan.:	place.
Cuadernos:	Notebooks
hongos.:	fungus.
importa.:	matters.
demostrar:	demonstrate
altiva:	haughty
míos:	mine
evitan:	they avoid
expresa:	express
aquí...:	here...
botellas:	bottles
pomos:	snitches
expresadas:	expressed
tinta::	ink:
carecer:	lack
brasa.:	ember
asadas:	roasted
innecesario:	unnecessary
lastre:	plates
aficiones:	hobbies
tiempos::	time:
prescindir:	dispense with
resumen:	summary
carezco:	I lack
ánimo.:	cheer up.
desplaza:	move
jorth.:	Jorath.
poema::	poem:
piloto.:	pilot.
imperioso:	imperious
libros.:	books.
Recomienza:	Restart
poderosa:	powerful
denegación.:	denial.
arrancar:	start up
suelte:	release
marcharme:	leave
recoja:	pick up
encontrara.:	will find
dondequiera:	wherever
alcanzarme:	reach me
inaplazable:	unavoidable
convocatoria:	call
expresado:	voiced
suceder:	happen
emplea::	uses:
atronador.:	thunderous.
hablarme:	talk to me
ajenos;:	aliens;
telones:	curtains
frondosos.:	leafy.
espesarse;:	thicken;
habitado.:	inhabited.
deshabitado:	unoccupied
ablanda.:	softens
desconcierta:	baffles
ardiente:	burning
líquido:	liquid
miope—.:	short-sighted—.
lentes:	glasses
sanos:	healthy
coincidir:	coincide
aciertan:	they get it right
litografía:	lithography
tiro:	number
movidas:	moved
incómodamente:	uncomfortably
superponemos:	we overlap
estampa;:	print;
ajustarse:	conform
agitarse:	shake
Conservatorio.:	Conservatory.
hurtadillas:	sneaking
fumaba:	I smoked
126
:	126
cigarrillos:	cigarettes
renace:	reborn
cigarrillo:	cigarette
hielo.:	ice.
marisco:	seafood
apio:	celery
té:	has
apremiantes:	pressing
llamadas:	calls
paladar.:	palate.
celosa:	jealous
olvidadas.:	forgotten.
apetencias:	desires
lúcida:	lucid
sorbo:	sip
probado:	tried
beber.:	to drink.
desenrosca:	unscrew
aparta:	separate
vendas:	sales
conservas:	preserves
medicamentos:	medicines
entregan:	deliver
aterrizaje:	landing
habérseme:	have me
paracaídas:	parachute
impermeables:	waterproof
bulto:	bulk
sacan:	they take out
Romanticismo.:	Romance.
presente—:	present—
identifican:	identify
regresándose:	returning
ochenta:	eighty
cifra:	cipher
recta.:	straight.
línea:	line
fraguas:	forges
buscaban.:	they were looking for
agitar:	shake
pensaron:	they thought
huella:	fingerprint
suelos:	floors
otear:	otter
aglomeración:	agglomeration
divisar:	spot
asombraron:	they amazed
turbonada.:	turbo nada.
buscar.:	look for.
orientados:	oriented
rescate.:	rescue.
cuantioso:	large
reactualizando:	updating
publicados:	published
torturado.:	tortured.
insidiosa:	insidious
sanguinarios.:	bloodthirsty
quién—:	who-
buscando.:	searching.
aviones:	airplanes
aparato::	device:
impulso.:	impulse.
frena:	brake
oportuno:	timely
viraje:	turn
bajo.:	low.
vacilando:	hesitating
despejar:	clear
apartarlos:	separate them
alborotando:	rioting
contagioso:	contagious
explanada:	esplanade
señal.:	sign.
Advierto:	I warn
titubeo:	hesitation
paralelamente:	in parallel
hélice:	propeller
removido:	removed
explosión;:	burst;
un.:	and.
125
:	125
aferrada:	clinging
separan:	separate
nuevamente;:	again;
romperse:	break
prestas:	lend
gente.:	people.
«cosa:	"What
pasmados:	stunned
Neolítico.:	Neolithic.
aterrorizados:	terrified
huyen:	Huyen
gira:	tour
volteo.:	I turn.
precipitación:	precipitation
encima.:	on.
fusil.:	gun.
arreció:	escalated
mojada.:	wet
terminó:	term
derritiendo.:	melting.
cerosa:	waxy
escurría:	drained
desintegraba:	disintegrated
encarnada:	red
emborronando:	blurring
desdibujando:	blurring
mirar::	look:
forcé:	strength
estampido:	stamped
rebotando:	bouncing
confundieron:	confused
disparos:	shots
Sonaron:	They sounded
derecho.:	right.
perdigones:	shot
izquierdo:	left
cañón:	canon
habías:	had
atreven:	dare
arrancó:	started
colérico:	choleric
Ejecutor.:	Executor.
iniciaría:	would start
deslindes:	demarcations
levantan:	they lift
siempre.:	always.
cambiar:	change
gatillo:	trigger
apretara:	will squeeze
resistía:	resisted
rapiña.:	rapine.
anulado:	annulled
suprimido:	deleted
contaminándola:	contaminating it
destrozado:	destroyed
indignante:	outrageous
inmundo;:	unclean;
Apagar:	To switch off
apagarlos.:	turn them off.
dependía:	it depended
mirando.:	looking.
ahí::	there:
apuntar.:	aim.
Volví:	I returned
—apremió—.:	-pressure-.
«Dispara:	«Shoot
volví:	I returned
pedía:	asked
Bajé:	I went down
onjejión».:	objection".
onjejión...:	objection...
«onjejión...:	"objection...
como::	as:
ininteligible:	unintelligible
gatillo.:	trigger.
decidía:	decided
Levanté:	Levant
«Apunta:	«Aim
mirándonos:	looking at us
detuvo::	stopped:
rastreador:	tracker
Avanzamos:	We move forward
llovida.:	rained
trillo:	trill
concertábamos:	we arranged
leproso.:	leper.
oscurecer:	darken
Anduvimos:	We walked
huellas.:	footprints.
encorvado:	curved
pasas:	passes
violación:	rape
Llegamos:	we arrived
manatí.:	manatee.
124
:	124
arrastraban:	they dragged
fangosas:	muddy
turbulentas:	turbulent
echamos:	we cast
Envolvimos:	We get involved
seguirlo.:	follow him.
Poniendo:	putting
perdurar:	endure
armeros:	gunsmiths
troquel:	die
cañones:	cannons
fusiles:	rifles
brazo::	arm:
deslizó:	slipped
puños:	cuffs
apretaba:	squeezed
agresiva.:	aggressive
consentida:	consented
repugnante:	disgusting
culpables:	guilty
fuésemos:	we were
indecible::	unspeakable:
indignación:	indignation
sublimado.:	sublimate.
ungüento:	ointment
frota:	fleet
entrepiernas:	of the enterprises
tapón:	plug
latente.:	latent.
reproche:	reproach
encerrara:	closed
aquí»:	here"
alrededores.:	surroundings.
batida:	beat
garrotes:	clubs
armados:	armed
hilachas:	threads
hemorragia:	hemorrhage
restañando:	stagnating
desgarrándole:	tearing him
violarla:	rape her
supo:	knew
lograron:	they managed
horrorizado:	horrified
rodillas.:	knees.
ensangrentada:	bloody
atroz::	atrocious:
aguacero.:	downpour.
arropada:	clothed
Capitán.:	Captain.
corno:	horn
trompa:	trunk
imaginaciones:	imaginations
sorprendo:	I surprise
dedos...:	fingers...
ensalivarse:	ensalivate
antebrazo:	forearm
doblar:	fold
sopesarlo:	weigh it
Puse:	Party
oído.:	ear.
cobrar:	charge
volvimos:	we came back
calores:	heats
adueñó:	took over
oyó:	heard
respiro:	breath
terminado.:	finished.
creímos:	we believed
espárrago:	asparagus
nacen:	are born
estiércol:	manure
serosidades:	serosities
nacera:	had been born
orina:	urine
excreción:	excretion
engendrará:	will engender
engendrarse:	beget
podre:	rotten
Llegaron:	They arrived
amenas.:	pleasant.
venenosa.:	poisonous.
culebra:	snake
fundido:	cast
blandido:	brandished
cortarse:	cut
enormemente.:	enormously.
aburriéndose:	getting bored
tejiendo:	knitting
pasan:	pass
rastreado:	tracked
desaparecieron:	they disappeared
123
:	123
lluvia.:	rain.
cumpliendo:	fulfilling
estuvieran:	were
filtraciones:	leaks
farallones:	cliffs
podrida.:	rotten
criaturas:	creatures
cantaron:	sing
treparon:	they climbed
multiplicaron:	multiplied
malangas;:	oily;
regocija;:	rejoices;
traidoras.:	traitors
cieno:	silt
hundiéndome:	sinking
huele:	smells
fango.:	mud.
arrancadas:	sprints
diques:	discs
ahogados.:	drowned
balsas:	the voice
acarreando:	carrying
necesitada:	needy
mantiene:	maintains
difuminado:	blurred
interminables.:	endless
escuece:	stings
negativa:	negative
matrimonio:	marriage
mentar:	ment
primeros.:	first.
guiones:	scripts
enmendando:	amending
papel—:	paper-
consumo:	consumption
imaginativa:	imagination
están.:	are.
quedarán:	fall
llenadas:	filled
sesenta:	sixty
oportunas:	timely
siembras:	sowing
procederse:	proceed
reparar:	fix
pasarse:	go
quiera.:	want.
propone:	proposes
advirtiéndome:	warning me
compadecido:	pitied
volvería.:	I would go back.
mulata:	mulatto
casara:	married
Mulato:	Mulatto
cantar::	sing:
carabelas—:	caravels—
bordo:	edge
sonó:	rang
invito:	invitation
Horrorizado:	Horrified
sanciones.:	sanctions.
atrevía:	dared
venir:	come
olvidado.:	forgotten.
122
:	122
distante:	distant
andando.:	going.
arrastrándose:	crawling
alforja:	saddlebag
separarlo:	separate it
horquillada:	bracketed
suavemente:	gently
empuja:	push
enojo—.:	anger-.
«¡Vete:	«¡Yourself
pavor.:	dread.
muda:	time
arrodillada:	kneeling
gesticula:	gestures
pesadilla:	nightmare
ceniza.:	ash.
tráquea:	windpipe
desintegración:	disintegration
licuarse:	liquefy
disolverse:	dissolve
endurecido:	hard
sujeta:	subject
escoria:	slag
piltrafa:	piltraf
residuo:	residue
selvas.:	jungles.
depositarios:	depositories
Levítico:	Leviticus
clásica:	classic
lepra;:	leprosy;
falta...:	lack...
legalizado:	legalized
firmado:	signed
reunida.:	reunited.
indiada:	Indian
fórmula:	formula
pronunciar:	pronounce
aspira:	aspire
casarse;:	marry;
obligarla:	force her
inferioridad:	inferiority
humillado:	humiliated
réplica.:	replica.
campesina:	peasant
Confieso:	I confess
cuidado».:	Careful".
dé:	god
depende:	it depends
sentenciosa—:	judgmental—
unión:	union
Casarse:	Marry
desórdenes:	disorders
entronizado:	enthroned
abandona:	abandon
guardias:	guards
mandar:	to send
alguno.:	some.
valer:	worth
abandonarlo:	abandon it
facultad:	faculty
descarría:	astray
asiste:	attend
defenderse:	fend
recurso:	resource
temen::	friend:
recóndito:	recondite
argumentación:	argumentation
dolido:	hurt
celoso:	jealous
matrimonio.:	marriage.
catecúmenos:	catechumens
protagonista:	hero
casemos.:	let's get married
deseable:	desirable
preguntarle:	ask him
decido:	a decision
hable.:	speak.
observar:	notice
podrá:	will be able
121
:	121
exigencia.:	requirement.
recuesto:	reclining
calmado:	calm
hacérselo:	do it
totalmente:	fully
escribiré:	I will write
escribirlo:	write it
Debo:	I must
nunca.:	never.
ejecute:	run
trombón.:	thrombo.
cornos:	horns
fagot:	bassoon
clarinetes:	clarinets
órgano::	organ:
libreta::	notebook:
quedará:	will remain
jurarme:	swear to me
risible.:	laughable.
insentato:	senseless
escuchada:	heard
esperado:	expected
audiencias.:	hearings.
especialmente:	especially
ejecutada.:	executed.
cartas:	cards
escribiendo:	writing
exasperado:	exasperated
estúpido:	idiot
escollo:	stumbling block
toparse:	bump
menguado:	diminished
maniatado:	tied up
cohibe:	control
generosidad:	generosity
contraria:	contradicts
avara:	spacious
papel;:	paper;
milímetro:	millimeter
pendolista:	commuter
astucias:	cunning
Aprieto:	Fix
llueve:	it's raining
envolturas:	wrappers
yutas:	Yuta
tejidos:	fabrics
pródiga:	prodigal
Alguna:	Some
problema.:	problem.
urgencia:	urgency
cuaderno.:	notebook.
voces...:	you...
—episodio:	-episode
lírico:	lyrical
introduciendo:	introducing
esfuerzo.:	effort.
lográndolo:	achieving it
concentrarme:	concentrate
cavilación:	rumination
acoso:	harassment
huir:	flee
inquebrantable:	unwavering
propuesto:	proposed
echará:	will cast
acepto—:	I accept—
plácida:	placid
falseándose:	falsifying
digo—:	I say—
mentir.:	lie.
dilema:	dilemma
disparadero.:	shooting
coloque:	put
actuará:	will act
tácticas:	tactics
probables:	probable
canalladas.:	scoundrels
Dios».:	God".
«marido:	"husband
posible—.:	possible-.
viviente:	living
albergar:	harbor
120
:	120
engañarla:	cheat on her
estimo:	esteem
atañe:	concerns
lealtad:	loyalty
mentira;:	lie;
sentirme:	feel
estafas.:	scams.
contentos.:	happy
pedida:	requested
prestarme:	lend me
delito:	crime
bigamia:	bigamy
importaría:	would matter
ya.:	of.
molesta::	bothers:
literarios:	literary
reacciones:	reactions
fáciles:	easy
confesarme:	confess to me
tamborileo.:	patter.
malangas:	oily
anchas:	wide
temporalmente:	temporarily
calafateada:	the caulking
rajaduras:	cracks
salgo:	I'm on my way out
carcajada:	laugh
estampa.:	print.
consentido:	spoiled
asperjar:	asparagus
tracen:	trace
gozarse:	enjoy
samaritano.:	Samaritan.
sayal:	skirts
escondidas:	hidden
ataduras:	restraints
relucir:	shine
decirle::	tell him:
guardando:	watching
encojo:	I shrink
Sorprendido:	Surprised
oyeran:	they would hear
recogerse:	pick up
rebaño:	herd
ovejas:	sheep
frase:	phrase
justificando:	justifying
legitimidad:	legitimacy
tolera:	tolerate
improperios:	expletives
profiere:	utters
insulta:	stroke
iracundo:	wrathful
tiempo;:	time;
hincharse:	swell
ministerio.:	ministry.
diciéndole:	telling him
aplomo:	aplomb
Repentinamente:	suddenly
instaurarse:	establish
santificadas:	sanctified
uniones:	unions
casarme:	get married
Afirma:	states
evangelización:	evangelism
entorpecer:	hinder
sensatas:	sensible
cultas:	cultured
cuestión.:	question.
balbuceo:	babbling
concubinato:	concubinage
Casamientos.:	Marriages.
Registro:	Record
Entierros:	Burials
Bautizo:	Christening
quejarme:	complain
Enojado:	Angry
pautados.:	ruled.
partituras:	sheet music
necesitan:	need
carabelas:	caravels
siendo:	being
tocadores:	players
arpistas:	harpists
músicas:	songs
relación:	relationship
establece:	establishes
Según:	According to
calmar:	calm
músicas.:	songs.
despilfarrarse:	waste
utilidad:	utility
consignar:	record
actas:	minutes
destinaban:	they destined
explicándome:	explaining
último»:	last"
expliqué:	explain
tragaba.:	swallowed
preguntó:	asked
pedir:	ask
Acabo:	Just
119
:	119
estados:	states
duerma:	sleep
descifrar.:	decipher.
taquigrafía:	shorthand
reduciendo:	reducing
brote:	outbreak
impulsado:	driven
jubilosa:	jubilant
escribo:	I write
ceñir.:	gird.
criticar:	criticize
tachar:	cross out
atrepellándose:	running over
llenaran:	will fill
bajadas:	descents
asombra:	amazes
invento:	invention
polémicas:	controversies
aburrimiento:	boredom
manifiestos:	manifestos
conciertos:	concerts
levantarse.:	get up.
pugnara:	fight
acallando:	silencing
asepsia:	asepsis
orden»:	order"
«regreso:	"return
impresionar:	impress
inventarse.:	invent
sonante:	resounding
disimulada:	disguised
pobreza:	poverty
ricercare:	search
trepidaban:	trembled
contrarios:	opposites
martillados:	hammered
desencuadrados:	out of frame
redondas—:	round—
existido:	existed
corcheas:	eighth notes
movimientos:	movements
Concerti:	Concerts
autores:	authors
aquejado:	afflicted
locomotriz:	locomotive
lentos:	boards
enjundia:	substance
olvidarlos:	forget them
olvidaban:	they forgot
actualizado:	updated
«desarrollar»—:	"develop"-
—
la:	—
the
calco:	cast
perdurabilidad:	perdurability
rispidos:	harsh
registros:	records
adrede:	ready
asperezas:	roughness
disonancias:	dissonances
espíritu.:	spirit.
contrapuntísticas:	contrapuntal
cantada:	sung
miércoles:	Wednesday
artesanal:	artisanal
Encadenado»:	Chained»
«Prometeo:	"Prometheus
«Preludio»:	"Prelude"
desventurado:	hapless
mañosa:	crafty
asemejaba:	resembled
invocación:	invocation
homofónico:	homophonic
inscriben:	enroll
convergentes:	convergent
toscos:	rough
termino:	TERMS
apuntado:	pointed
imperiosa:	imperious
detengo.:	I stop.
anunciará:	will announce
edificio:	building
vosotros.»:	you."
remaba:	of father
despojos:	remains
desgracia.:	misfortune.
quémame:	burn me
funerales;:	funeral;
abandones:	abandon
imploración::	entreaty:
preludio:	prelude
interpretaré:	I will interpret
gemido:	moan
118
:	118
caminos».:	paths.
«su:	"are
llora:	cry
colocar:	to place
lanzas.:	spears.
enlutadas:	mourners
imperceptiblemente:	imperceptibly
enternezca:	international
estructura:	structure
concibo:	I conceive
requerida:	required
sobras:	leftovers
derramado:	spilled
degollado:	beheaded
rebaños...:	flocks...
carnero:	SHEEP
daré:	I will give
sacrificaré:	I will sacrifice
Itaca:	Ithaca
prometo:	I promise
harina:	flour
Derramo:	I spill
libación:	libation
miel.:	Honey.
libaciones.:	libations.
«Hago:	"Do
solemne::	solemn:
evocación:	evocation
deseada.:	desired.
simplicidad:	simplicity
homérico:	Homeric
aligerar:	lighten
sencilla::	simple:
bambú.:	bamboo.
retoño:	shoot
garrapatas:	ticks
limpiar:	clean
sienta:	feel
molestar:	annoy
ceño.:	frown.
malos»:	bad»
«días:	"days
nervioso;:	highly strung;
alarma:	alarm
irritado:	irritated
Salgo:	I'm on my way out
peripecias.:	adventures
releo:	reread
necesito.:	need.
género:	gender
resultaría:	would result
astucias».:	cunning."
vástago:	stem
Laerte:	Laertes
majestad»:	majesty"
Cronos:	Chronos
invocatorias:	invocatory
usar:	to use
niego:	him
descorazonarme:	dishearten me
vacilación:	hesitation
empastadas:	pasted
—Estos:	-These
Gramática:	Grammar
Epítome:	Epitome
francés;:	French;
secundarios;:	secondary;
estudios:	studies
alemán:	German
Sabía:	Knew
¿cuál:	which
profunda.:	deep
desierta:	deserted
poeta:	poet
resabios.:	aftertaste
sorprenderme:	surprise me
ejecutado».:	executed".
«verme:	«don't give
enoja:	angry
artístico.:	artistic.
ejecución:	execution
obstáculo:	obstacle
constituiría:	would constitute
alejaría:	would distance
cristiana:	Christian
pareciéndose:	resembling
excelentes:	excellent
óperas:	operas
despoja:	strips
descubro:	I discover
Hojeando:	Browsing
Usualis:	Usual
Líber:	Bast
libros::	books:
117
:	117
tendré:	I will have
caldearse:	get hot
lije:	pours
furia.:	rage
ménade:	maenad
irrumpen:	break in
infierno»:	hell"
«perras:	«bitches
reinan:	reign
arcilla:	clay
siento.:	I feel.
tormentas::	storms:
coros:	choirs
directas::	direct:
admirablemente:	admirably
correspondido:	reciprocated
conforme:	according to
resurrección:	Resurrection
implícito:	implicit
asocio:	association
encadenado:	chained
liberación:	release
Segundo:	Second
Desencadenado:	Unchained
proyecto:	project
regla:	ruler
sirviéndome:	serving me
trazo:	I bring
libretas;:	notebooks;
transcurrida...:	elapsed...
transcurrida:	elapsed
Cobraba:	He charged
faltaba.:	was missing.
intuía:	I intuited
resto::	rest:
músico:	musician
gruñir:	snarl
maneras:	ways
alternación:	alternation
reclamada:	defendant
nota:	use
necesitar:	need
transformaba:	transformed
exorcismo:	exorcism
palabra-célula:	word-cell
renació:	reborn
auténtico:	authentic
roían:	gnawed
babeantes:	drooling
creían:	they believed
superioridad:	superiority
ufanarme:	weapon
hombres;:	men;
lección:	lesson
orines.:	urine.
excrementos:	excrement
postrados:	prostrate
ponzoña:	poison
escuché:	listen
monstruos:	monsters
Paleolítico:	Paleolithic
resembrada:	reseeded
asombro::	astonishment:
reflexión.:	reflection.
sorprende:	surprise
momento...:	moment...
aprovechados:	taken advantage of
empezaban:	they started
inexplotados:	unexploited
eclesiásticos:	ecclesiastics
habilidoso:	skillful
trombón:	trombone
contrabajo:	double bass
flautín:	piccolo
diálogos:	dialogues
sorprendentes:	surprising
116
:	116
citaba:	cited
especulando:	speculating
defenderme:	defend myself
incitaciones.:	incitements.
riesgosas:	risky
entrañaba:	entailed
reinvención:	reinvention
engendrados:	begotten
estilos:	styles
musicales.:	musicals.
implicaciones:	implications
palabra-
célula:	word-
cell
indiscutible:	indisputable
intrincada:	intricate
resultado:	result
presentada:	presented
simultaneidad:	simultaneity
percepción:	perception
oyente:	listener
prepararía:	would prepare
expresiva:	expressive
intensidad:	intensity
aumento:	increase
sinfónica:	symphonic
machihembradas:	mb lada s to town
concertadas:	concerted
armónico:	harmonic
polifónica:	polyphonic
coexistencia:	coexistence
contrapuntístico.:	contrapuntal.
enriquecimiento:	enrichment
entregarse:	surrender
compactado:	compressed
oposiciones:	oppositions
armónica:	harmonica
variación:	variation
coloreaba.:	colored
diversificaba:	diversified
sonoros:	sound
creaba:	created
compostelano.:	compost it
femenino—:	female-
masculino:	masculine
—elemento:	-element
ordenaban:	they ordered
primicial:	first time
sucesivas:	successive
ondulante.:	wavy.
añadía:	added
guirnalda:	wreath
salvaguardada::	safeguarded:
litúrgico:	liturgical
agregar:	add
decente:	decent
adornarla:	decorate it
firmus:	firm
cantus:	song
situada:	located
Catholici—:	Catholics
—Congaudeant:	- Let them rejoice
compostelano:	compost it
lejanos:	distant
impresionado:	impressed
posibles.:	possible.
aleaciones:	alloys
tenso:	tense
parche:	patch
cuerda:	rope
hecho::	made:
vibrante:	vibrant
intervenciones:	interventions
afirmándose:	asserting
recitado:	recited
normales:	normal
períodos:	periods
delimitar:	delimit
puntuación:	score
discretamente:	discreetly
entrarían:	they would enter
Transformado:	Transformed
conditor—:	founder
rerum:	of things
—Aeterne:	-Eternally
ambrosiano:	ambrosian
himno:	hymn
centrado:	centered
afirmarse:	assert
empezaría:	would start
estribillo:	chorus
medidas:	measures
sucesiones:	successions
irían:	they would go
verbo-génesis.:	verb-genesis.
adjetivo.:	adjective.
necesitaran:	they will need
sustantivos:	nouns
auditorio:	auditorium
adelantara:	will advance
latín.:	latin.
Illa:	Ill
Irae:	of anger
ocurrió:	occurred
prosodia:	prosody
escansión:	scansion
hablado:	spoken
pasara:	passed
impresionista—:	impressionistic-
estilización:	stylization
exageración:	exaggeration
115
:	115
surgiera:	arose
interesaba.:	was interested
vienesa:	viennese
escuela:	school
logros:	achievements
modernos:	modern
armónico;:	harmonic;
liberarla:	free her
acompañamiento:	accompaniment
enredar:	entangle
cantando:	singing
recitar:	recite
profanas.:	profane.
litúrgicas:	liturgical
repasado:	reviewed
enfocar:	focus
acoplar:	couple
meditado:	meditation
mismo—:	same-
flaqueza:	frailty
alejado:	away
actividades:	activities
estúpidas:	stupid
sueño.:	dream.
impuesto:	tax
pensamiento::	thought:
concretar:	specify
subraya.:	underlines.
delimita:	delimit
enmienda:	amendment
tacha:	blemish
conciencia;:	awareness;
nutre:	nourishes
lucubración;:	lucubration;
delirante:	delusional
inició:	start
goteras:	leaks
lámpara.:	lamp.
sublimado:	sublimate
trabajadas:	worked
gotas:	drops
estéticas:	aesthetic
transferencias:	transfers
descabelladas:	crazy
invenciones:	inventions
adocenadas:	cobbled
fumado:	smoking
mortificante:	mortifying
lúcido:	lucid
adoptar.:	adopt.
incertidumbre:	uncertainty
proyectaba:	projected
Concierto:	Concert
vacilaciones:	hesitations
nacería:	would be born
pautado:	lined
droga:	drug
saliera:	came out
atormentaban.:	they tormented
intelectual:	intellectual
produjo:	produced
cuarta:	quarter
opio::	youth:
fumar:	smoke
Muchos:	Many
entendieran.:	they would understand
leyeran:	they would read
palparan:	squander
inscrita:	registered
ordenación.:	ordering
asombrándose:	amazed
«cosa»:	"What"
espíritu;:	spirit;
construido:	built
preciso.:	necessary.
ordenarse:	order
dispersos:	scattered
disgregados:	disintegrated
compactación:	compaction
maduración:	maturation
trabajo::	job:
realizarse:	be realized
todavía—:	still-
—lejos:	-far
noches...:	nights...
arduas:	arduous
doquiera:	everywhere
odioso.:	hateful.
pareciendo:	seeming
huraña:	swearing
114
:	114
atardecer.:	sunset.
emergencia.:	emergency.
terminar:	finish
ayudado:	helped
invectivas:	invectives
pésimo:	appalling
apuntalable:	propable
apuntalar:	shore
anudado:	knotted
fraguado:	setting
llorar.:	cry.
llenaron:	they filled
fuegos:	fires
lodo.:	official
desconcertados:	bewildered
cobija.:	blanket.
colgarlos:	hang them
colectados:	collected
goteras.:	leaks.
mudando:	changing
resecas:	parched
retumbando:	rumbling
oquedades:	cavities
colándose:	sneaking in
parecieron:	they seemed
truenos:	thunder
obertura:	opening
poema.:	poem.
sabrá:	will know
pardos:	brown
alfabeto:	alphabet
descubrirán:	they will discover
consistirán:	they will consist
estética:	aesthetics
preguntarme:	ask me
euritmia:	eurythmy
coreografía:	choreography
Ninguna:	None
brisa.:	breeze.
torbellino:	whirlwind
alborozan:	exult
vencimientos:	expirations
respiros:	breaths
pausas:	pauses
ascendente:	ascending
frondas;:	fronds;
estremecido.:	shuddered
retoños:	shoots
ligeras:	light
rondas:	rounds
organizan:	organize
poseen:	possess
Arboles.:	Trees.
fulgurante:	dazzling
acude.:	come
recobrada.:	recovered.
flecha:	arrow
disparar:	shoot
entesado:	entangled
incontenible:	irrepressible
brota:	break
bien.:	GOOD.
desaparecido.:	missing.
plexo:	plexus
latidos:	beats
aprensiones:	apprehensions
presentimientos:	hunches
inmotivadas:	unmotivated
angustias:	anguish
flaccida:	flaccid
traía:	brought
malas:	lazy
estructura.:	structure.
ceñidos:	tight
músculos:	muscles
escueto:	short
esqueleto::	skeleton:
apretando:	squeezing
adelgazado:	slimmed down
pescado:	fish
mañoco:	mancoco
alimentación:	feeding
parca:	park
ruda:	brown
escrita—:	writing—
113
:	113
épico:	epic
gesta:	guests
jirones:	tatters
ritualmente:	ritually
emborracha:	drunk
alianzas:	alliances
memorables:	memorable
duelos:	duels
ardides:	ploys
inventos:	inventions
princesas:	princesses
raptos:	abducted
intervinieron:	they intervened
desviados:	diverted
héroes:	heroes
victoriosa.:	victorious.
prodigios:	prodigies
arrasa:	rock
caribe:	Caribbean
fragmentos.:	fragments.
reconstruyendo:	rebuilding
epopeya:	epic
descubrí:	I discovered
anotarlo:	write it down
comprenderlo:	understand it
historiador:	historian
geólogo:	geologist
naturalista:	naturalist
ansioso.:	anxious.
paladar:	palate
habituarme:	get used to
pescar:	fish
holgarme:	relax
quemarme:	burn me
comparten:	share
reflexión:	reflection
destino—.:	destination-.
creerán:	will believe
—«por:	-"by
volverá:	will return
Estado::	State:
Razón:	Reason
reticencias:	reticence
aceptan:	accept
adivino:	soothsayer
hijo;:	son;
fronterizo.:	frontier.
remacharon:	riveted
marcas:	brands
explicaciones:	explanations
descubierto.:	uncovered.
odio:	hatred
dócil:	docile
amistoso:	friendly
humillaciones:	humiliations
maltratos:	abuse
rencor:	rancor
acota:	abound
gente»:	people"
sitio:	place
responde.:	responds.
marcharse»:	leave"
daría:	would give
manchan:	stain
víbora.:	snake.
echado:	lying
parricida:	parricide
condenaban:	they condemned
espectacular:	spectacular
impresionante:	awesome
castigo:	punishment
instituya:	institute
hambre:	hunger
expulsado:	expelled
condenar:	condemn
vacilará:	will hesitate
vedada:	to carry
castigar:	punish
solemnemente:	solemnly
apoyarse:	lean
sospecharlo:	suspect it
Hombre.:	Man.
jactanciosos:	boastful
escritos:	writings
cientos:	hundreds
instructivos:	instructions
poesía:	poetry
meditación:	meditation
solicitación:	solicitation
raudales—.:	torrents.
arrostrados:	faced
Pobre:	Poor
remanso.:	backwater.
traidora:	traitor
podrido:	rotten
disfrazado:	disguised
artero:	cunning
rugido:	roar
viajando:	traveling
fulminante:	fulminant
mordida:	bite
vampiros:	vampires
112
:	112
cartógrafos:	cartographers
Incógnitas:	Unknowns
Terras:	Lands
planteados:	raised
mayores.»:	older."
necesitarán:	will need
seamos:	let's be
reprobación:	reprobation
dirigirle:	direct you
castiga:	win
responde—:	respond—
instituir:	institute
horroroso:	horrible
inquieta:	restless
castigada»:	punished"
«será:	"it will be
infracción:	infraction
inmediatas:	immediate
realizar:	perform
reunión:	meeting
remontando:	reassembling
vigilar:	watch
apostar:	bet
acarreo:	haulage
tala:	story
anotadas:	noted
cuestiones:	issues
examen:	exam
conservación:	conservation
tajante:	cutting
urgencia.:	urgency.
debería:	ought
terminada:	finished
dónde.:	where.
invasión:	invasion
cargando:	charging
movilizándose:	mobilizing
ejecutar:	execute
conveniencia:	convenience
unanimidad:	unanimity
reconoce:	recognize
conjurado:	conjured
vertiente.:	slope.
narigón:	nose
trazando:	tracing
lograrse:	be achieved
terrenos:	land
cebolla:	onion
cultivo:	crop
realizado:	carried out
demanda:	demand
batey:	more
inundándose:	flooding
canalizar:	channel
tendrá:	will have
discutida:	discussed
orientación:	orientation
dirección:	address
Cabildo:	Council
Actas:	Minutes
Libro:	Book
acatarla:	abide by it
juran:	legal
justificándose:	justifying
mermado:	depleted
inconsiderada:	inconsiderate
emigración:	emigration
presentes.:	gifts.
criterio:	criterion
emergencia:	emergency
levantamiento:	lifting
cervatillo:	fawn
hembra»:	female"
absoluta:	absolute
prohibición:	prohibition
instituye:	institutes
ciervas:	deer
cazado:	hunted
comprobado:	checked
Habiendo:	Having
escrito.:	written.
consignados:	consigned
dejarlos:	leave them
provecho:	advantage
número:	number
traseras.:	rear.
guardado:	saved
legislando:	legislating
acentuado:	accentuated
Pertenecientes:	Belonging
colegial:	schoolgirl
tendida:	lying
Sentado:	Sitting
111
:	111
mismas.:	themselves.
empañado:	tarnished
miraban:	they looked
crónica:	chronicle
conjuntivitis:	conjunctivitis
pertenecerle:	belong to him
pintadas:	painted
enmarañada:	tangled
motivos:	reasons
causado:	caused
resignada:	resigned
intensa:	intense
fijaron:	they fixed
inmensamente:	immensely
parajes.:	places.
aventurarse:	venture
consideración:	consideration
burlona:	mocking
permití:	I allowed
Ningún:	No
regiones»:	regions»
sanguinarios:	bloodthirsty
perversos:	wicked
únicos:	unique
«Allí:	"Over there
nudoso::	nude:
hostil:	hostile
sombría:	gloomy
quebrados:	broken
pizarrosos:	slaty
descenso.:	descent.
iniciará:	will start
rúbricas:	rubrics
frías.:	cold
veamos:	let's see
desciendan:	descend
cumbre:	summit
sorprenda:	surprise
Tenemos:	Have
acortan:	shorten
alucinada:	hallucinated
hombres...:	men...
cobraron:	they charged
nombrados:	named
inhábiles:	unskilled
—obra:	-work
recreadas:	recreated
nombradas:	named
desaparecerán:	will disappear
arrojarme:	throw me
acabaría:	would end
existía:	existed
fascinar:	fascinate
dejara:	will leave
abismos;:	abysses;
demoníaco:	demonic
caldero:	cauldron
Inclinado:	Leaning
diabólica:	diabolical
parar:	to stop
germinan:	germinate
hulla:	corpse
petrificado:	petrified
duerme:	sleep
fósil:	fossil
Prehistoria.»:	Prehistory.”
desiertos:	deserts
saltaron:	they jumped
escalaron:	they climbed
atravesaron:	they crossed
servirle:	serve you
negadas:	denied
rebeldes:	rebels
fraile—.:	friar-.
huido:	fled
«Estas:	"It is
formas.:	shapes.
orgiástico:	orgiastic
mostruoso:	monstrous
acoplamiento:	coupling
anuda:	knot
enmaraña:	entangles
enrevesa:	convoluted
tallo.:	three.
desgarre:	tear
erupción:	rash
sanguinolentos:	bloody
pistilos:	pistils
faroles:	lanterns
bulbosas:	bulbous
madrépora:	madrepora
texturas:	textures
submarina:	underwater
tentáculo.:	tentacle.
mórbida:	morbid
membranosas:	membranous
110
:	110
pavorosas:	dreadful
medran:	they grow
cráter:	crater
Signos:	Signs
está...:	this...
dejándolo:	leaving it
herramientas:	tools
talladores:	carvers
ejército:	army
levantara:	will lift
gigantesco:	gigantic
erigir:	erect
explicarnos.:	explain to us.
acertamos:	we got it right
mediante:	through
ciclópeo:	cyclopean
lunas:	remedy
arribo.:	arrival.
fijada:	fixed
rúbrica:	rubric
egipcios:	egyptians
retirarse:	withdraw
encalló:	ran aground
habitantes:	inhabitants
repoblador:	repopulator
cavados:	dug
alzo:	I get up
aniquilan:	annihilate
sublevados:	uprisings
enrabecidos:	enraged
atruenan:	I'm sorry
apocalipsis:	apocalypse
pavoroso:	dreadful
moler:	grind
platos:	dishes
comales:	eat you
muerte;:	death;
rebelan:	they rebel
inventados:	invented
inicial:	initial
endurecer:	harden
suyo:	his
estudioso:	scholar
sorprendiéndome:	surprising me
Brujo.»:	Sorcerer."
Aprendiz:	Apprentice
presentido:	sensed
cosmogonía:	cosmogony
aún::	still:
adivinación:	guessing
fraile—:	friar-
quitchés:	quitches
sagrado:	sacred
desconocido.:	a stranger.
nuestros.:	our.
coincidente:	coincident
cosmogonías:	cosmogonies
emito:	young ones
Admirado:	Admired
rituales:	rituals
festivas:	festive
vestimentas:	garments
Tenochtitlán:	Tenochtitlan
emperadores:	emperors
plumas.:	feathers.
toro:	visiting
caballo:	horse
marcadas:	marked
armaduras.:	armor.
girasoles»:	sunflowers»
«indianos:	«Indians
pincel:	brush
catalnicas:	catalan
pericos:	parakeets
comadreos:	gossips
asustados:	scared
alborotoso:	rowdy
listados:	listed
carpinteros:	carpenters
laboriosidad:	industriousness
noche;:	evening;
paujíes:	paulie's
fosforescente:	phosphorescence
suspensión:	suspension
colibríes:	hummingbirds
Vimos:	We saw
solicitan:	request
¡Dios:	God
gritado::	yelled:
teológico:	theological
luciendo:	showing off
tucán:	toucan
rosadas:	pink
cotorras:	parrots
fastuosos:	lavish
escoltaron:	escorted
109
:	109
florecidos—:	flowered—
ricos:	rich
aventada:	suggested
paletadas:	paddles
recogidos:	collected
desprendido:	detached
bizantinos:	Byzantines
mosaicos:	mosaics
molidas:	ground
erosión:	erosion
aridez:	aridity
teratología:	teratology
sacrilego—:	sacrilegious-
intruso:	intruder
vagamente:	vaguely
nieblas.:	fogs.
helada:	frost
surca:	furrow
fieltro:	felt
recortadas:	cropped
accidentado:	hilly
esquistos:	shales
descansamos:	we rest
llaves:	keys
pagado:	paid
pongan:	put
bultos:	lumps
torturarme:	torture me
hacerles:	make them
suya:	to the water
encargará:	will order
uso.:	use.
enser:	alike
reponer:	replenish
indispensables:	essential
proveerse:	provide
acostumbrado:	used to
enviaré:	I will send
desarrugar:	unwrinkle
comprender.:	grasp.
dolida:	hurt
brusco:	abrupt
aparto:	apart
bramido:	bellow
botija:	cylinder
sopla:	blows
resquemores.:	resquemores
desconfianza:	distrust
desertado:	deserted
enterrar:	bury
romperlos:	break them
sacar:	withdraw
Debería:	Ought
vitrinas.:	showcases.
fichas:	chips
reclamo:	claim
perpetuo:	perpetually
piezas:	parts
hallaran:	cases
usurarios.:	usurers
préstamos:	loans
sacrificios:	sacrifices
entregaron:	they delivered
defección:	defection
responsabilidad:	responsibility
aceptará:	will accept
fiador.:	guarantor.
evadirme:	evade
solté:	I blurted out
castigados:	punished
arrinconarlos:	corner them
sirvió:	served
objetos-acreedores:	creditor-objects
echando:	of winter
atiesaron:	migraines
hinchadas:	swollen
protectoras:	protective
sujetaban:	they held
desaté:	let go
dolorosa.:	painful
acompañó:	accompanied
tambor-bastón-de-ritmo:	drum-rhythm-stick
sugerida:	suggested
ideado:	devised
sonará:	will sound
campanas:	bells
espadaña:	bulrush
ahuecado:	hollow
Colgamos:	We hang up
premonición:	premonition
curvas:	curves
repetido:	repeated
tuviesen:	had
108
:	108
viguetería:	joists
amplia:	wide
reunirme:	meet
intelectual.:	intellectual.
quedarme:	stay
cavilaciones.:	overthinking.
pentáfonas...:	pentagons...
gamas:	ranges
generalizada:	widespread
destructoras:	destroyers
bellos:	beautiful
librescas.:	bookish.
aferrados:	clinging
observaciones:	observations
levantarían:	they would lift
polvareda:	dust cloud
falaces:	fallacious
teorías:	theories
sonoro:	sonorous
interpretado:	interpreted
brotan:	sprout
fugas:	leaks
chapuzones:	dips
ronquidos:	snoring
rumores:	rumors
musical-estético:	musical-aesthetic
trino:	triune
gorjeo:	goryeo
imitar:	mock
sostener:	hold
dichas:	said
tonterías:	foolishness
originarse:	originate
alternar:	toggle
fingida:	feigned
cierto;:	TRUE;
originaba:	originated
monosílabo:	monosyllable
emprendía:	undertook
remota.:	remote.
hechicería:	sorcery
derivadas:	derivatives
pervivencia:	survival
arriesgadas:	risky
construyendo:	building
psicología:	psychology
razonamiento:	reasoning
mágico.:	magical.
ultratumba.:	beyond the grave
sierpes:	wyrms
mordeduras:	bites
faraón.:	Pharaoh.
preservar:	preserve
detienen:	stop
persas;:	Persians;
emperador:	emperor
resucita:	resurrect
Esquilo:	Squirrel
Pude:	Could
asistí:	I attended
trote:	trot
fijación:	fixation
otorga:	grants
primitiva:	primitive
hermanar:	twin
nuestro.:	our.
contemporáneo:	contemporary
religiosas:	religious
curativas:	bandages
instituciones:	institutions
albores:	dawn
pretenden:	intend
cuan:	how
absurda.:	absurd.
orígenes:	origins
cestería.:	basketry
trabajan:	they work
primogénito:	firstborn
cálida:	warm
padecidos:	sufferers
vigilancias:	surveillance
prohibiciones:	prohibitions
fealdades:	ugliness
sustraerse:	subtract
privilegio:	privilege
disfrute:	enjoyment
causan:	cause
servirlo.:	serve him.
ofrecerles:	offer them
felicidad:	happiness
compañeros:	companions
crueldad:	cruelty
molestado:	bothered
Siempre:	Always
naves.»:	ships.”
encadenarlos:	chain them
héroe—:	hero-
sollozantes:	sobbing
traerlos:	bring them
«Tuve:	"Had
olvidan:	they forget
107
:	107
fruta:	fruit
lotófagos:	lotus eaters
despacha:	dispatch
sonreír::	smile:
párrafo:	paragraph
tropezando:	tripping
cabellos:	hair
desgaire:	disabled
Recostado:	lying down
torceduras:	sprains
hundiré:	interior
repetirme:	repeat myself
hago.:	do.
mujer.:	women.
apegar:	attach
establecer:	establish
intelectuales:	intellectuals
acomodos:	accommodations
habituarse:	get used to
hacinamiento:	overcrowding
vastedad:	vastness
prefiera:	prefer
determinación:	determination
varón.:	male.
reciba:	receive
recibirá:	will receive
docilidad:	docility
pregonero.:	crier.
menesteres:	necessities
encanallando:	plumbing
empuñar:	wield
Prefiero:	Prefer
inútil.:	useless.
agobiarse:	get overwhelmed
cargaba:	loaded
dejarán:	they will leave
alambre:	wire
ardilla:	squirrel
profesiones:	professions
impuso:	imposed
Sísifo:	Sisyphus
enseñan:	they teach
practican:	they practice
Trataré:	I will try
desierto...:	desert...
predicando:	preaching
enjuto:	lean
canas:	reeds
bañarán:	will bathe
vendrán:	they will come
gruesa:	gross
desembocan:	flow
matriz.:	headquarters.
integrarme:	integrate
caladas:	quiet
pulsaciones:	pulsations
seminales:	seminal
conductos:	ducts
endurecen:	harden
nuca:	nut
axilas:	armpits
oscurece:	darkens
pectorales:	pectorals
revienta:	burst
trepa:	climb
testículos:	testicles
calienta:	heats
bañado:	bathed
nanadores:	nandores
muslo:	thigh
ennegrece:	blacken
expuesto:	exposed
asombrados:	amazed
travesura:	mischief
liberamos:	we release
vence:	wins
jadea:	gasp
edénico:	edenic
alarde:	parade
ocre.:	ocher.
tiñen:	dye
tanino:	tannin
cauces:	channels
derramarse:	spill
encendidas:	lit
106
:	106
brotando:	sprouting
Pareja:	Couple
desnudos:	nudes
bañamos:	we bathe
pátina:	patina
debiera:	should
complejo:	complex
minúscula:	lower case
pigmentos:	pigments
oquedad:	cavity
Asomado:	Leaning
esmalta.:	enamel
cierzo:	north wind
sacuden:	shake
diluirse:	dilute
paredones:	walls
recostadas.:	lying down
acantilado:	cliff
aclaran:	clarify
adelgazan:	lose weight
tendiendo:	tending
Amanece:	dawn
excusa.:	excuse.
cebollas»:	onions»
sembrar:	sow
«Además:	"Besides
Henoch.:	Enoch.
erigirse:	stand up
comenzará:	will begin
rabioso:	rabid
«Alguien:	"Someone
Redención::	Redemption:
agresivo:	aggressive
abruptamente:	abruptly
ramo:	branch
ajustado:	tight
objetar:	object
religiones:	religions
aprendí:	I learned
aprendan:	learn
contarán:	count
distinguir:	distinguish
curas:	cures
viajaban:	they were traveling
naciente:	nascent
variante:	variant
hijos;:	children;
enseñar:	teach
despachó:	dispatch
cesado:	ceased
llovió:	it rained
salvó:	except
hinchara:	will swell
contemplábamos:	we contemplated
Fundador—:	Founder-
escrúpulos::	scruples:
astrales.:	astral
escorpiones:	scorpions
dibujan:	they draw
izados:	hoisted
—artesanos:	—artisans
desconocidos:	unknown
artesanos:	artisans
105
:	105
desembarcar.:	disembark.
asaltaron:	assaulted
Henoch»:	Enoch»
vivirse:	live
llegada.:	arrival.
sencillos:	simple
sucesos:	events
promovidos:	promoted
colectiva:	collective
explosiones:	explosions
sequía:	drought
abundante:	abundant
tibieza:	tepidity
contentan:	happy
residencia:	residence
acompañan:	accompany
escama:	scale
veneno:	poison
trajes:	suits
unidades:	units
asignado:	assigned
admiten:	admit
rigores.:	rigors.
Orden:	Order
antemano::	beforehand:
aceptados:	accepted
padecimientos:	ailments
renovadas:	renewed
frías:	cold
crueldades:	cruelties
tratable:	tractable
fuesen:	were
menosprecio:	disparagement
allá.»:	there."
regresan:	they return
Adelantado—:	Advanced-
«El:	"He
existir.:	exist.
sucumbe:	succumbs
atavismo:	atavism
gangrena.:	gangrene.
impotencia:	impotence
levantados;:	raised;
trabajosamente:	laboriously
venenosos:	poisonous
azotes:	spanking
cartógrafos.:	cartographers.
propia.:	own.
legislar:	legislate
búsqueda:	search
afana:	they are similar
orden.:	order.
Señala:	Point out
lápida:	stone
entierra:	buries
Firma:	Business
Gobierno.:	Government.
Levanta:	Get up
traza:	trace
arcadas.:	arcades.
puentes:	bridges
llegue:	I arrived
Puesto:	Position
hablarse:	talk
«fundar»:	"meetings"
verbo:	verb
Siente:	feel
tortugas.:	turtles.
huevos:	eggs
embalsamados:	embalmed
ostensiblemente:	ostensibly
comercia:	trade
suspicacias:	suspicions
apetencias.:	desires.
excesos:	excesses
trastornarlo:	upset it
ignorado:	ignored
invadiendo:	invading
rastro:	trail
seguirle:	follow him
tardarán:	will take
bolsillos:	pockets
Piensa:	Think
arrojan:	they throw
mozas:	girls
tardes:	afternoon
baña:	but
prospera.:	prosper.
interesando:	interesting
destetado:	weaned
becerro:	calf
cabra:	goat
atados:	tied
104
:	104
carpintería.:	carpentry.
apero:	conference
posturas:	postures
cambiarlo:	change it
estaño.:	tin.
Encuentra:	Finds
penurias:	hardships
convalecencia:	convalescence
extinción.:	extinction.
numerosa:	numerous
endeble:	flimsy
vástagos:	scions
piensan:	they think
hierbas.:	herbs.
curan:	cure
funeraria—:	mortuary-
factores:	factors
—gente:	-people
pierna:	leg
engusanada:	to swallow
desemboca:	flows
hambruna.:	famine.
saltamontes:	grasshopper
noventa:	ninety
Camina:	walk
asoma:	appears
favorecido:	favored
buscadores.:	search engines.
afortunadas:	lucky
insistencias:	insistences
desengaños:	disappointments
comparte:	share
llevado.:	carried.
izan:	be
poblaciones.:	populations.
coloreadas:	colored
zonas:	zones
incansablemente:	untiringly
Cunucunuma:	Conuconuma
obsesionado:	obsessed
libros;:	books;
bañar:	bathe
azahar:	noon
encargan:	they order
nuevos::	new:
aprende:	learn
recetarios:	recipe books
Andando:	Going
lejana.:	distant
domingos:	Sundays
carcomido:	rotten
púlpito:	pulpit
oído:	ear
edad:	age
envidia:	nvidia
parten:	the party
buba:	happen
aliviados:	relieved
curados:	cured
muestras:	samples
preguntan:	they ask
barrunto:	around
enfebrecidos:	feverish
hartarán:	will be fed up
mirífica:	myrific
arrancaron:	they started
vencidos:	defeated
Llegan:	They arrive
ignorado.:	ignored.
cortinas:	curtains
pasante:	intern
descorriendo:	slipping away
contraído:	contracted
abandonadas:	abandoned
leprosos:	lepers
sarnas:	similarly
rascan:	they scratch
palúdicos:	malaria
tembladeras:	scrapies
añagazas:	tricks
desconfiaran:	they will distrust
andén:	platform
tablas:	tables
bastones:	walking sticks
tientan:	tentan
desembarcadero:	disembarkation
bajan:	they go down
barcos:	boats
despacioso:	slow
moletas:	knuckles
linaza:	flax
transita:	transit
emético.:	emetic.
tártaro:	Tartarus
raíz:	root
vómica:	vomic
nuez:	nut
casera:	homemade
prescripción:	prescription
confían:	trust
maceraciones:	macerations
albergue.:	hostel.
botica:	drugstore
Vencido:	Overdue
cloacas.:	sewers.
carboneras:	charcoal pits
sótanos:	basements
suben:	they go up
jornadas;:	days;
103
:	103
nublada.:	cloudy
Santísimas:	Most Holy
Marías:	Marias
monjas;:	nuns;
hojaldres:	puff pastries
maitines:	meals
Hacia:	Toward
bolas:	balls
rebelde:	rebel
caduceo:	caduceus
emblema:	emblem
batea:	Bataa
adelantaba:	advanced
diré:	I will say
llamarse:	call
apellido:	last name
«Pues:	"Well
rumbos.:	directions.
escucharé:	I will listen
recojan:	pick up
duerman:	sleep
hartado:	treasuredo
beben:	tremble
resina:	resin
burbujeante:	bubbly
articulaciones:	joints
ablando:	softening
intereso:	interest
Ayudo:	Ayuso
invadir:	invade
preguntas.:	questions.
vencidos.:	defeated.
preferentemente:	preferably
sólida:	solid
alienta:	encourages
teniéndose:	having
intransigencias:	intransigence
aspiraciones:	aspirations
interdictos:	interdicts
cánones:	canons
estorbo:	hindrance
fundar:	meeting
inmediato.:	immediate.
formular:	formulate
asados:	roasted
preparativos:	preparations
empero:	however
aquiescente:	acquiescing
Losada:	slab
fundaron:	founded
Ni:	In
eso.:	that.
raro.:	down.
imponente:	imposing
sugerido:	suggested
confieso:	I confess
hijos.»:	children."
criado:	created
Agustín:	Augustine
parió:	gave birth
fundador::	founder:
acompañado:	accompanied
Gobernador:	Governor
alcalde:	mayor
mestizas:	mixed race
esposas:	wives
bienvenida:	welcome
desborda:	overflows
penalidades:	penalties
increíbles:	incredible
chivatos:	snitches
verracos:	voircos
cría:	creates
sembrados:	sown
señalarme:	point me out
Catedral.»:	Cathedral."
levantaremos:	we will lift
«Frente:	"Forehead
volviéndose:	turning
indios...»:	Indians..."
bestias...:	beasts...
hijas...:	daughters...
Gobierno...:	Government...
temblor:	shaking
blanquecino.:	whitish.
hogueras:	bonfires
establo.:	barn.
situadas:	situated
ventanas.:	windows.
divisa:	split
doscientos:	two hundred
102
:	102
desconcertado.:	embarrassed.
amarra:	tie
revestido:	coated
recibirlo:	receive it
mansas:	meek
pasándose:	passing
bordeándose:	bordering
calma:	calm
Transcurren:	They pass
exasperantes:	exasperating
respirando:	breathing
fragancias:	fragrances
recobran:	recover
vivas:	lives
somnolencia:	sleepiness
arrulla:	coos
hombre;:	man;
invencida:	invincible
fundarse:	establish
territorios:	territories
Recuesto:	Reclining
órgano...:	organ...
tañedor:	keeper
edificada:	built
horrores:	horrors
sustraiga:	subtract
gobernar:	govern
Crear:	Create
verbo.:	verb.
conjugar:	combine
fundo:	bottom
Fundar:	Meetings
codiciadas.:	coveted.
repetírmelo:	repeat it
canso:	tired
secreto::	secret:
partido:	party
muelle:	dock
conducirnos:	drive us
bendice:	bless
desengañarla:	undeceive her
suerte.:	luck.
Alborozada:	Exhilarated
hacernos:	make us
Quiere:	Wants
aventureros.:	adventurers.
codicia:	greed
guía:	guide
apegado:	attached
Homero:	Homer
acaieno:	acaien
huellas:	footprints
mentiroso:	liar
manejos:	handling
avaro:	miserly
hallazgo;:	find;
Solitario:	Lonely
alzado:	raised
estatutos.:	statutes.
Cánticos:	Chants
101
:	101
abismo.:	abyss.
vacía:	empty
desordenada:	messy
sideral:	sidereal
Creador:	Creator
llegaríamos:	we would arrive
retrocediéramos:	we would go back
Creación.:	Creation.
Día:	Day
Cuarto:	Room
señorear:	lord
100
:	100
lumbreras:	luminaries
prueban:	they test
aparecidas:	appeared
vivientes.:	living.
trabaje:	work
abeja:	bee
arborescentes:	tree-like
huya:	come on
Terciario.:	Tertiary.
dragonadas:	dragonades
prehistóricos:	prehistoric
lepidosirenas:	lepidosirens
gimnotos:	Gymnotos
escualos:	sharks
cabezones:	big heads
laulaus:	tables
monstruosos:	monstrous
quedaron:	were left
Abajo:	Below
vedado.:	prohibited.
dominio:	domain
explanadas.:	esplanades.
inmensidad:	immensity
magnas:	big
fausto:	auspicious
sobrecogidos:	overcoected
sentimos:	we feel
hablamos.:	talk later.
planeta.:	planet.
—meteoritas:	— meteorite
coágulos:	clots
rugosos:	rough
peñascos:	boulders
nieblas;:	fogs;
respiran:	they breathe
hendeduras:	crevices
escarchas:	frosts
guardan:	they keep
lunares:	polka dots
planicies:	plains
cumbres:	summits
adivina:	guess
derraman:	spill
estanques:	ponds
dividirse:	be divided
atronadores:	thunderous
acrecidos:	accreted
petrificada.:	petrified
jalonada:	drawn
arcoiris:	rainbow
deshace:	undo
cimera.:	summit
almenaje:	at least
inconmovible.:	immovable.
confabula:	conspires
fantasía:	fancy
severidad:	severity
rompiendo:	breaking
procesión.:	procession.
semejan:	they resemble
corona:	crown
afila:	affiliate
biseles:	bezels
recorta:	crop
flanqueante:	flanking
basalto:	basalt
obelisco:	obelisk
quebrados.:	broken.
rectos:	straight
bruscos:	abrupt
aristas:	edges
morfología:	morphology
cabezas.:	heads.
túneles:	tunnels
conducir:	drive
Puertas:	Doors
madréporas.:	madreporas.
gigantescas:	gigantic
alvéolos:	alveoli
agrietados:	cracked
pirámides:	pyramids
cilindros:	cylinders
majestad.:	majesty.
aplastante:	overwhelming
confiere:	confers
abolengo:	lineage
contemplarlos:	contemplate them
terrestre:	land
alzaron:	raised
telúrica.:	telluric.
tuvieron—:	had—
—cuando:	-when
vestidura:	clothing
Lavadas:	Washed
alzan:	rise
salomas:	Salom
izar:	star
obligados:	obligated
quietos:	quiet
tramos:	sections
navegando:	browsing
subiendo:	going up
Lentamente:	Slowly
crónicas.:	chronicles.
armazón:	warehouse
andamos:	we walk
99
:	99
Música.:	Music.
Nacimiento:	Birth
asistir:	watch
deslumhrado:	dazzled
treno—:	train-
convulsivamente:	convulsively
órfico:	Orphic
descorazona.:	disheartens
ablanda:	softens
niega:	denies
terquedad:	obstinacy
mí...:	my...
ejerce:	exercises
ceremonia:	ceremony
fascinación:	fascination
distancias.:	distances.
mantenerme:	keep me
Trato:	Deal
cálculos:	calculations
atraviesan:	go through
aniquilamiento:	annihilation
—intento:	-tried
imprecatorio:	imprecatory
talones:	heels
vocifera:	vociferous
mudos.:	mute.
prolongarse:	extend
contratiempo:	setback
vibrar:	vibrate
melodía.:	melody.
cortados:	cut
trinos:	trills
ritmo;:	rhythm;
aullidos;:	howls;
prolongados:	prolonged
guturales:	guttural
portamentos:	behaviors
apremiar.:	press.
sarcasmo:	sarcasm
gime;:	moans;
responden.:	respondents.
alternan.:	they alternate.
destemplada.:	untemplated.
colérica:	choleric
mediano:	medium
vientre.:	belly.
ensalmador;:	salting agent;
cadáver.:	corpse.
imita:	imitate
Palabra.:	Word.
colmo.:	full.
esperan:	wait
preparador:	preparer
ahuyentar:	drive away
—único:	-single
gravilla:	gravel
calabaza:	pumpkin
sacudir:	shake
mordido:	bitten
colgadas:	hanging
amasijo:	I knead
correr.:	run.
echan:	they cast
Dioses...:	Gods...
vasija:	vessel
reverencia:	reverence
torpe:	clumsy
esbozo:	outline
trepadores:	climbers
Viendo:	Seeing
pronunciara:	will pronounce
tiempo»:	time"
«solitaria:	«lonely
Mayores.:	Seniors.
divinidad:	divinity
cobrando:	charging
dados:	data
Niños:	Children
Objeto.:	Object.
naciera:	was born
modelaron:	model kit
abultado:	bulky
prólogo:	prologue
genésico:	genetic
religiones.:	religions.
Dios::	God:
blanda.:	mix.
apoyado:	supported
convexa:	convex
98
:	98
ombligo:	belly button
asas:	basic
endurecida:	hardened
yacen:	lie
bien—:	GOOD-
—cunas:	—cribs
rodean...:	surround...
lamedores:	lickers
tragadores:	swallowers
Nada.:	Nothing.
entes:	loved ones
bestia.:	beast.
carroñas:	carrion
disputen:	they dispute
autorizada:	authorized
predilecta:	favorite
erigidos:	erected
existir:	exist
eréctil:	erectile
escalafones:	ladders
dueña:	owner
sarcástico—:	sarcastic-
«Cautivos:	«Captives
espanto.:	amazement.
repulsión:	repulsion
producen:	produce
colmillos.:	fangs.
metiéndose:	getting into
servil:	servile
temeroso:	fearful
sonríen:	they smile
arrugados:	wrinkled
enanos:	dwarves
nacido;:	born;
vagido:	loved ones
vivientes:	living
fetos:	fetuses
conocido::	acquaintance:
erguirse:	straighten
roídos:	gnawed
hedionda:	hideous
fangoso:	muddy
gesticulación.:	gesticulation.
comprendiendo:	understanding
zorros:	foxes
misma.:	same.
amasar:	knead
lombrices:	worms
escarban:	dig
liendres:	nits
avispa:	wasp
pelado:	naked
entremos:	let's enter
aislan:	isolate
colgándose:	hanging around
simios:	apes
disputar:	dispute
corazones:	hearts
sembrar;:	sow;
semilla;:	seed;
valerse:	valese
saberlo:	know it
pudor:	modesty
felinos;:	felines;
ovillan:	at the door
estiran:	they stretch
hinchados;:	swollen;
flaccidas:	flabby
mí;:	my;
individuos:	individuals
edades.:	ages.
tenebroso:	dark
edades—:	ages—
más»:	further"
líticos:	lithics
industrias:	industries
paleolítico:	paleolithic
convivimos:	we coexist
compases:	compasses
retrocediendo:	going back
revés:	reverse
cabe:	fits
elaboración:	elaboration
mañanas:	mornings
97
:	97
lapsos:	lapses
percibo:	I perceive
llevadas:	carried
andantes:	walking
—tiempos:	-time
sucedieran:	would happen
breves:	brief
considerablemente:	considerably
ensanchar:	widen
asombroso.:	amazing.
arrastrar:	drag
poseer:	possess
importancia—.:	importance-.
suponer:	suppose
dejarme:	leave me
delicado:	delicate
defiende:	defend
etapas:	stages
marcaron:	they marked
vivió:	lived
pasado.:	past.
desmemoriada:	forgetful
Agarra:	Grab
Labán.:	Laban.
Raquel:	Rachel
invocadas:	invoked
«costumbres:	"traditions
pudorosas:	shame
inequívocas:	unequivocal
emplea:	employs
intimidades:	intimacies
alude:	alludes
definidora:	defining
proféticos.:	prophetic.
restando:	staying
sustituyen:	replace
Biblia:	The Bible
traductores:	translators
Tiene:	Has
contrato:	contract
afirmación:	affirmation
diera:	give
situaciones:	situations
definición:	definition
solidez:	solidity
posesivo:	posesive
buscaba»...:	I was looking for...
durmiendo;:	sleeping;
malo:	place
capacidad:	ability
rebasan:	exceed
mecanismo:	mechanism
grandes»:	big»
«cosas:	"things
regido:	governed
analizando:	analyzing
cuerpo»:	body"
molde:	mould
ande:	Spirit
alumbra:	lights up
pensó:	thought
'el:	'he
cruzado:	crossed
plenitud:	fullness
propicio:	propitious
prestigioso:	prestigious
remotas.:	remote.
cercanas:	nearby
inquietarse:	worry
adónde:	where to
consentimiento.:	consent.
animoso:	game
desaliento:	discouragement
proseguiremos:	we will continue
estambres:	stamens
crujido:	crunch
colgadizo:	hanging
dormirme:	fall asleep
generación.:	generation.
ello—:	it-
—estoy:	-I'm
imaginada:	imagined
vislumbre:	glimpse
revelada:	revealed
solitarios:	lonely
selvático:	wild
esclavos;:	slaves;
cimarrones:	maroons
hallazgos:	findings
Hablan:	They talk
pudiese:	could
Conozco:	Know
96
:	96
(Jueves:	(Thursday
diligencia:	diligence
encenderlo:	turn it on
incapaces:	incapable
seríamos:	we would be
apagara:	will turn off
abanican:	fan
Historia.:	History.
estadía—:	stay-
—metecos:	—metics
dardo:	dart
espina:	thorn
anzuelo:	hook
rascador:	scraper
usan:	they use
inventan:	invent
alimentos:	food
dictan:	dictate
Paleolítica.:	Paleolithic.
bramar:	bellow
lloró:	cry
hueca:	hollow
caña:	cane
soplar:	blow
aldeas:	villages
agricultura:	agriculture
errar:	err
cansado:	tired
—fechas:	—dates
tornaron:	they returned
regresó:	return
Natividad:	Nativity
borróse:	blurry
Graal:	Grail
Perdió:	lost
números.:	numbers.
lunas.:	remedy.
rellenando:	filling
borraban:	they erased
destranscurrían:	they passed away
vaciaban:	they emptied
guarismos.:	figures.
Medioevo.:	Middle Ages.
concluido:	concluded
Grafías.:	Graphics.
Dómino:	Lord
Benedicamos:	Let us bless
est:	East
líe:	place
espacio...:	space...
estupefaciente:	narcotic
vislumbro:	glimpse
aspiro.:	I aspire.
presente.:	present.
recuperación:	recovery
testimonio:	testimony
aliviaban:	relieved
emplastos:	plasters
calles;:	streets;
baldados:	waste
asado.:	roast.
borracheras:	drunkenness
armar:	arms
gallos:	roosters
preferir:	prefer
cinturón:	belt
prendido:	on
hábitos:	habits
claveteados.:	nailed
portones:	gates
cocinas:	kitchens
cuadros:	paintings
especias:	spices
desmedida:	excessive
compartido:	shared
chamuscadas:	singed
lechoncillos:	piglets
trinchado:	carved
museos;:	museums;
jocunda:	funny
servicio:	service
moza:	girl
catar:	Qatar
trago:	I bring
burgueses:	bourgeois
convivido:	lived together
bendición:	blessing
piden:	they ask
orgullosos:	proud
patriarcas:	patriarchs
prostitutas:	prostitutes
—medievales:	—medieval
medievales:	medieval
reverenciar:	bow
Perro:	Dog
trascendentales:	transcendental
alargamiento:	elongation
prenda:	garment
calendario:	calendar
pertenecer:	belong
Puede:	Can
temprana:	early
asombrosa::	amazing:
percato:	notice
recientemente.:	recently.
perduran:	they endure
fielmente:	faithfully
Francia:	France
paseos:	walks
diablos:	devils
95
:	95
Medievales:	Medieval
sacrificios.:	sacrifices.
holocausto:	holocaust
parecidos:	similar
usaban:	they used
elegida:	chosen
lanzas:	spears
románica:	Romanesque
basamento:	base
sangrante:	bleeding
edificar:	build
románico:	Romanesque
tomadas:	sockets
enlistados:	listed
Descubrimiento:	Discovery
realiza:	perform
renacentista:	Renaissance
entrado:	entered
esfuman:	vanish
diluyen:	dilute
restan:	remain
cierto.:	TRUE.
bonanza.:	see them.
reprendió:	rebuked
levantándose:	getting up
teméis:	topical
¿Por:	By
perecemos;:	we perish;
sálvanos:	scarfed
diciendo::	saying:
despertaron:	they woke up
discípulos:	disciples
dormía:	I slept
mas:	but
ondas;:	waves;
cubría:	covered
monje:	monk
azotadas:	spanked
tiempo—.:	time-.
Entrada:	Prohibited
miserere:	to pity
Dómine:	Lord
nostri:	our
Miserere:	To pity
savias.:	swordfish.
entres:	come in
morrión:	morion
donadores:	donors
orando:	praying
fiebres:	fevers
curtidos:	likes
rancio:	rancid
Contratación:	Hiring
algebrista:	algebraist
labriego:	laborer
renegridos:	blackened
flacos:	skinny
arrodillados:	kneeling
Hombres:	Men
Oeste:	West
plantan:	the plant
arribados:	arrived
Descubridores:	Discoverers
retrocedido:	regressed
lejanías.:	distances.
escucharon:	they listened
diferencia:	difference
deslumhra:	dazzles
figurarme:	figure
follajes:	foliage
pesaban:	they weighed
Troncos:	Trunks
Sanctus:	Saint
triunfantes:	triumphant
entonados:	toned
himnos:	hymns
heroica:	heroic
talados:	felled
hermandades:	brotherhoods
cristiandad:	Christendom
brotadas:	sprouted
seculares:	secular
inmutables:	immutable
Aquellas:	Those
garganta.:	throat.
sequedad:	dryness
Amén.:	Amen.
Sancti.:	Saints
Spiritus:	Spirit
Filie:	daughter
Patris:	Father's
nomine:	by name
Luego::	Then:
miedo.»:	fear."
tuviste:	you had
estabas:	you were
«Recuerda:	"Remember
áspero::	rough:
añadió:	he added
apelando:	appealing
mí.»:	my."
hazlo:	do it
quieres:	want
indiferente.:	indifferent.
vieran:	they would see
bautismo;:	baptism;
rehusan:	they refuse
crios.:	belt
chillidos:	shrieking
acallaban:	they silenced
colmillos—.:	fangs.
collares:	necklaces
—todo:	—all
respetuosa:	respectful
observaba:	observed
Aldea:	Village
mascullando:	masculando
iconos:	icons
94
:	94
prometida:	betrothed
religión:	religion
tratara:	will try
interrogué:	questioned
Sabiendo:	knowing
sobrecogedor.:	startling.
rituales.:	rituals.
Purificador:	Purifier
Ara;:	We buy;
Hostia:	Guests
disponerlos:	arrange them
mangas:	sleeves
frotaba:	rubbed
mellados—:	dented—
—algunos:	-some
sacó:	sack
maletín:	briefcase
plantó:	planted
amarillas.:	yellow.
rebosantes:	overflowing
grosores:	thicknesses
remendado:	patched
dispuesto:	willing
gorjeaban.:	gurgle
corro:	I run
danzante:	dancing
ligereza:	lightness
movía:	moved
aldea.:	village.
faenas:	chores
observé:	observed
majestad:	majesty
manifestándose:	manifesting
enormemente:	enormously
madurado:	matured
durmiente:	sleeping
desperezo:	I stretch
transcurso:	course
liberó:	released
Permanecí:	I stayed
sopesando:	weighing
separaba:	separated
aboliendo:	abolished
ligado:	connected
inscrito:	enrolled
magnífica—:	magnificent—
—pieza:	-part
cumplido.:	compliment.
trofeos:	trophies
palpaba:	Pulp
orgulloso:	proud
justos:	fair
cumplida.:	fulfilled.
ciclo:	cycle
entraba:	came in
creadas:	created
concluir:	conclude
primera.:	first.
describiera:	describe
representada:	represented
costados:	sides
encajadas:	fitted
sepultura:	grave
siniestro:	sinister
reviste:	magazines
dotada:	gifted
antepasados:	forefathers
pantanos.:	swamps.
pescadores:	fishermen
botuto:	boot
adornos:	ornaments
atravesada:	crossed
tambores.:	drums.
empuñadura:	handle
recorrido:	route
reliquia:	relic
peregrino:	pilgrim
encomendada:	ordered
anafre:	ref
misión.:	mission.
Acababa:	it was over
exclamaciones.:	exclamations.
jubilosas:	jubilant
93
:	93
desempeñado:	performed
eficientes.:	efficient.
tobillos.:	ankles.
sólidos:	solids
ásperos;:	rough;
asir:	captive
utilidad.:	utility.
cabelleras.:	hair
narices:	nose
aguileño:	aquiline
nobleza:	nobility
alzado.:	raised.
enmarcaban:	they framed
maternidad:	maternity
remos;:	oars;
esculpidos:	carved
dorsales:	dorsal
potentes:	potent
movían:	they moved
manejo:	management
disciplina:	discipline
ejercitaban:	they exercised
autoridad:	authority
propiciados:	propitiated
totalidad:	whole
revelaban:	they revealed
maderamen:	wood
recubriendo:	covering
grupo:	group
técnica:	technique
embocaba:	holed
coreógrafo:	choreographer
flechaba:	arrowed
precisión:	precision
soberana:	sovereign
primitivismo.:	primitivism.
vestirlos:	dress them
esenciales:	essential
desconocían:	they did not know
evidencia:	evidence
salvaje.:	wild.
cultura.:	culture.
resultaban:	they turned out
considerándolos:	considering them
fantasiosos:	fanciful
primordiales.:	primordial.
conocidos.:	acquaintances.
emanación:	emanation
tez.:	quickly.
generaciones:	generations
contribuido:	contributed
recobraba:	recovered
restregar:	scrub
arrodillarse:	kneel
lavaba:	washed
lechosos:	milky
tubérculos:	tubers
machacaban:	they crushed
píe:	foot
tejían.:	they wove
crios:	belt
agallas.:	guts.
ensartados:	skewered
trayendo:	bringing
aparecieron:	appeared
anaranjado:	orange
peonías.:	peonies.
pulsera:	bracelet
mostrándome:	showing me
inseguras:	insecure
parado:	stopped
orillaban:	they bordered
Varias:	Several
estatura.:	stature.
resigné:	resigned
rebotes:	rebounds
descolgaban:	they picked up
divisaban:	they saw
ensombramiento:	shadowing
definían:	they defined
evanescencias:	evanescence
encajado:	fitted
reflejos:	highlights
razonar:	reason
pasmado:	stunned
celebración:	celebration
graderíos:	grades
tronos:	thrones
—morada:	-household
tuberías:	pipes
flanqueadas:	flanked
terrazas:	terraces
vertiginosas:	vertiginous
proporciones:	proportions
granito.:	granite.
hulla.:	corpse.
irisaciones:	iridescence
92
:	92
sombrías:	gloomy
cónico:	conical
peñón:	crag
montada:	mounted
arbotantes:	arbutants
ábside:	apse
Formas::	Shapes:
cirros:	cirrhosis
almenas:	battlements
obsidiana:	obsidian
fortalezas:	strengths
dominadas:	dominated
explanadas:	esplanades
mausoleos:	mausoleums
ciclópeas:	cyclopean
escaleras:	stairs
espaciadas—:	spaced—
múltiples:	multiple
edificaciones:	buildings
titánica:	titanic
proporciones.:	proportions.
analogía:	analogy
contemplando.:	contemplating.
tentaciones:	temptations
ilustradores:	illustrators
alucinados:	hallucinated
imaginarias:	imaginary
fabulosos.:	fabulous
plomada:	plumb
tiradas:	shots
verticales:	vertical
flaneos:	flannels
macizas:	solid
asombro.:	astonishment.
librarme:	free me
exclamaciones:	exclamations
estupefacto:	thunderstruck
adolorido:	sore
recordaron:	they remembered
secar:	dry
puestas:	set
rojiviolados:	red-violet
aspadas:	swords
pájaros.:	birds.
canutos:	canutes
aspiraban:	they aspired
dispensadora:	dispenser
sabría:	would know
servían:	served
paletas:	pallets
taparas:	tapar
envenenados:	poisoned
dardos:	darts
carcajes:	quivers
cerbatanas:	blowguns
nalgas.:	buttocks.
cordón:	cord
sujeto:	subject
oculto:	hidden
amasando:	kneading
probaba:	tried
estómago:	stomach
sorbos:	sips
resfrío:	cold
agotamiento:	exhaustion
indios;:	Indians;
caminata:	hike
desembarco:	landing
Recordé:	I remembered
leña.:	firewood.
Olía:	Oil
delgada.:	slim.
paja:	straw
acostado:	lying down
largamente:	widely
bebí:	I drank
cántaro:	pitcher
agarré:	grip
Después:	After
(Miércoles:	(Wednesday
Segunda:	Second
un::	and:
saberme:	know me
varadero:	slipway
descansa:	rest
Agotado:	Exhausted
Desarrugando:	Unwrinkling
orillas.:	shores.
prolongado:	prolonged
bordas.:	edges.
afincando:	settling
pararse:	stop
91
:	91
inacabable.:	unending
Prosigue:	Continue
remos.:	oars.
defendiéndonos:	defending ourselves
arroje:	throw
cinturones:	belts
entereza.:	fortitude.
resguarda:	protects
reguardando:	looking at
dirige:	directs
Acrece:	increases
llover.:	rain.
quilla.:	keel.
chillan:	they scream
torturadas:	tortured
vuelco:	overturn
sesgándonos:	biasing us
redondas:	round
montando:	riding
picando:	stinging
embarcaciones:	boats
equilibrio:	balance
Dominando:	Dominating
olvidarlo:	forget it
circunda.:	surrounds.
sobreponerme:	get over
Perdida:	Lost
zarandea:	you are
tumulto:	riot
salvación:	salvation
corrientes:	currents
mostrarme:	show me
repentino:	sudden
aerolitos:	Aerosol
bullentes:	bubbling
marañas:	tangles
tenebrosa:	dark
deslindada:	delimited
parpadeante:	flickering
reaparecidos.:	reappeared.
hunden:	the dog
desprende:	detaches
alumbrar:	light
seguimiento:	follow-up
enciende:	turn on
tormenta.:	storm.
bramante:	longing
torbellinos:	whirlwinds
sueltan:	they release
turbamulta:	a lot of trouble
bastón.:	cane.
arrumbando:	breaking in
afianzado:	entrenched
Tomando:	Taking
peligrosamente:	dangerously
llevándole:	taking him
prenderse:	catch
remolinos:	swirls
atormentado:	tormented
distintos.:	distinct.
minero.:	miner.
reanudarse:	resume
bastonazos:	caning
reaparece:	reappears
huida.:	flight.
arrieros:	muleteers
misionera:	missionary
digo.:	I say.
fechas»:	dates»
revés.:	reverse.
andarse:	walk away
refiere:	refers
ángeles:	angels
asustando:	scaring
estática:	static
Doctora:	Doctor
pirata:	pirate
90
:	90
degollados:	beheaded
paraguayas:	paraguayan
saetas:	arrows
Lizardi:	Lizard
torturado:	tortured
beato:	blessed
Marañón;:	Cashew;
despedazados:	torn to pieces
desconocida;:	unknown;
contarme:	tell me
otros.»:	others."
«Para:	"To
abrupto::	abrupt:
templo.:	temple.
indignos:	unworthy
sacerdotes:	priests
apoyar:	support
serle:	be him
apostolado:	apostleship
ermitaño:	hermit
tarado:	crazy
ocioso:	idle
urbano:	urban
clero:	clergy
—pienso:	-I think
exclama:	exclaims
caballería»:	chivalry"
infantería:	infantry
rivalidad:	rivalry
eterna:	eternal
pulpito.:	pulpit.
tenores:	tenors
nunciaturas:	announcements
rumiantes:	ruminants
indulgencias:	indulgences
vendedores:	sellers
califica:	qualify
mundanos:	worldly
párrocos:	parish priests
acremente:	add
ara:	We buy
creó.»:	believe."
honrar:	honor
sirvan:	serve
materias:	materials
hermosas:	beautiful
—responde:	—replies
justo:	fair
«Porque:	"Why
custodias:	the guards
pedrería:	rhinestones
relumbran:	they shine
enmarañadas:	tangled
cejas:	eyebrows
ofenderse.:	be offended.
fabuloso:	fabulous
Oigo:	I hear
precioso.:	precious.
cegar:	blind
llamamos:	we call
diamantes.:	diamonds.
acaudalar:	affluent
alejó:	moved away
desentumecer:	loosen up
boscosa:	wooded
Aprovechándose:	Taking advantage
martes):	mars)
confluencias.:	confluences
presidieran:	in the presidency
inmemoriales:	immemorial
edificadas:	built
enlazadas:	linked
Esas:	Those
alfarero.:	potter.
redondearse:	round off
monumentales:	monumental
desgastado:	worn out
Génesis;:	Genesis;
ricas:	rich
amasan:	goals
olvidadas:	forgotten
nubes::	clouds:
descubría:	discovered
asombroso:	amazing
indecencias:	indecencies
travesuras:	antics
escandalizaban:	scandalized
monos:	monkeys
alegres:	happy
proliferación:	proliferation
barroca:	baroque
simulacros:	drills
barajarse:	shuffle
milagro.:	miracle.
colibrí:	hummingbird
vibración:	vibration
universo:	universe
frágil:	fragile
pescador:	fisherman
blancas.:	white.
levantaban:	they raised
interrogación:	question
inventaban:	invented
89
:	89
plumajes.:	plumages.
identidad:	identity
celestemente:	heavenly
azogue:	quicksilver
invirtiendo:	investing
ardiente.:	burning.
zarza:	bramble
amarillos:	yellow
macizos:	solid
jalonaban:	jalonando
edelweis:	edelweiss
inalcanzable:	unattainable
irreal:	unreal
orquídea:	orchid
aparecía:	appeared
esperma:	sperm
tulipán:	tulip
cactáceas:	cacti
almíbares:	syrups
rociados:	sprinkled
insectívoras:	insectivorous
vulvas:	vulva
hediondos:	hideous
sudorosos:	sweaty
bulbos:	bulbs
mentidas:	lies
frutos;:	fruits;
decrepitud.:	decrepit
grado:	degree
mentidos:	lies
insectos.:	insects.
transformara:	will transform
segundos:	seconds
Bastaba:	It was enough
frescor:	freshness
vaharadas:	Vahardas
logradas:	achieved
linazas.:	linseeds.
poso:	the post office
fulminaba:	fulminated
eléctrico:	electric
zanahoria:	carrot
crisálida-ciempiés:	chrysalis-centipede
castaña-erizo:	chestnut-hedgehog
lagarto-cohombro:	cucumber-lizard
metamorfosis.:	metamorphosis.
estratagema:	stratagem
disfraz:	costume
semblante;:	countenance;
entero.:	whole.
salpicaduras:	splashes
simulación:	simulation
intenso:	intense
estriado:	fluted
lapizlázuli:	lapis lazuli
camaleón:	chameleon
falsedad:	falsehood
espolvoreos:	sprinkles
salmuera:	brine
firme::	firm:
fingiéndose:	pretending
corría:	ran
escondiendo:	hiding
apretaban:	they squeezed
acuáticas:	aquatic
anillas:	rings
ananá:	pineapple
escamas:	scales
preciosas:	precious
nervaduras:	ribbing
pieles:	skins
escaramujos;:	rose hips;
podridos:	rotten
acechaban:	stalked
caimanes:	alligators
entredicho.:	interdicted
verdades:	truths
creándose:	being created
mimetismo:	mimicry
hormigas.:	ants.
melosa:	honeyed
acudían:	they came
cráteres:	craters
abriendo:	opening
nidos:	nida
destrozando:	destroying
salían:	they went out
arados:	plows
extracción:	extraction
ajenos:	alien
intrincadas:	intricate
sacando:	taking out
arcos.:	bows.
disparaban:	they shot
reventar:	burst
tirando:	taking
desgajados:	torn apart
aplastados:	crushed
Cien:	Hundred
quemar:	burn
carbón:	coal
rajado:	riven
astillas:	splinters
desplomarse:	collapse
prehistoria:	prehistory
coloso:	colossus
deleznable:	despicable
derribarlo:	knock it down
permanecía:	remained
tempestades:	storms
Chorreado:	dripped
88
:	88
cristalizaciones.:	crystallizations.
equilibrios:	balances
simetrías:	symmetries
encanecían:	small
orquídeas.:	orchids.
apagaba:	turned off
secaba:	dried
lacerados.:	lacerated
suspendidos:	suspended
irreales:	unreal
aéreos:	aerial
boscajes:	forests
despejado:	clear
espigadas:	spiked
rastreante:	tracker
Arboles:	Trees
jamás.:	never.
señeramente:	sensibly
batalla:	battle
diversas:	miscellaneous
fases:	phases
savia:	sap
asomar:	show
lograban:	they achieved
despunte:	blunt
escuálidas:	scrawny
estiramiento:	stretch
desmedido:	excessive
ascender:	ascend
treparse:	climb up
empeñadas:	pawned
violentas:	violent
pinceladas:	brush strokes
graznante:	beautifying
alborozo:	joy
empinada:	steep
malhumorado:	moody
giba:	movement
redondeaba:	rounded
estiraban:	they stretched
hundiendo:	sinking
empinadas:	steep
Centenares:	Hundreds
trompa.:	trunk.
refrescar:	refresh
rompía:	broke
matapalos:	lazy
enredaderas:	vines
matas:	fed
entretejida:	Entretejida
feraz:	ferocious
sarmientos:	shoots
anónimos:	anonymous
identificables:	identifiable
sujetos:	subjects
abismada.:	astonished.
emergían:	emerged
blanquecinos:	whitish
antiquísimas:	ancient
alargaban:	they lengthened
ancladas:	anchored
hundidas:	sunken
retorcidos:	twisted
porciones:	portions
verdadera.:	true.
anunció:	advertisement
internaba:	interned
imponía:	imposed
alusiones:	allusions
maliciosas:	malicious
coplas:	couplets
remediar.:	remedy.
poderlo:	power it
lloraba:	I cried
canturreando:	humming
fase:	phase
excusarme:	excuse me
malévolo.:	malicious.
deslinde:	unravel
despeje:	pour
rugidos:	roars
madrugada:	dawn
ancestros:	ancestors
atávico:	atavistic
entrañado:	entangled
renueva:	renew
arboledas.:	groves.
infinitas:	infinite
liberado:	released
despejado.:	clear.
augurar:	augur
grisallas:	gray
insinúa:	hints
neblinas:	mists
exhala:	exhale
creación.:	creation.
usufructuario:	usufructuary
—belleza:	-beauty
87
:	87
gozada:	cumshot
percibida:	perceived
físicamente:	physically
Ríos:	Rivers
cabeceras:	headers
vivían:	they lived
compartía:	shared
desayuno:	breakfast
limpiaba:	cleaned
lavarme:	wash
víspera.:	eve.
temores:	fears
bían:	bian
Primera:	First
miedo—:	fear-
clamar:	cry
rodeaban:	surrounded
venció:	expired
extenuado.:	exhausted.
febril.:	febrile.
asustado:	scared
hoyo.:	hole.
cencerros:	cowbells
agitaban:	they agitated
relinchaban:	Ralinchaban
aullaban:	lobby
crujían:	creaked
martillaban:	they hammered
zambullían:	dived
pegadas:	footprints
pasaban:	they passed
bajaban:	they went down
subían:	they went up
silbidos:	whistles
errantes:	wanderers
borborigmos:	borborygmi
pavo:	of them
tremulantes:	trembling
harmónicas:	harmonics
lengüetas:	reeds
mordían:	they bit
peines:	combs
frondas.:	fronds.
respondieron:	they responded
distintamente:	distinctly
grotesco:	grotesque
embocadura:	mouthpiece
deslizamientos.:	slides.
estremecían:	they shuddered
invadió:	invaded
croar:	croak
aisló:	isolated
somero:	summer
campamento:	camp
organizado:	organized
hubimos:	we had
prematuro:	premature
Huí:	I fled
gimiera:	moaned
vez—:	time-
afinación:	tuning
metían:	they put
putrefactas:	rotten
horrenda::	horrible:
atracado:	moored
llamó:	called
amarilla:	yellow
moría:	died
inverno:	winter
asoleamiento:	sunning
ceroso:	waxy
savias;:	swordfish?
resinas:	resins
escupitajos:	spit
recibido:	received
ensombrecidas:	overshadowed
camisas:	shirts
chupar.:	to suck.
antenas:	antennas
élitros:	elytra
llenaban:	they filled
bajas.:	lows.
desprendían:	they shed
frialdad.:	coldness.
aliviarme:	relieve me
frescor.:	freshness.
sobresalto:	shock
llegarían:	would arrive
anofeles:	helpless
zancudos:	mosquitoes
continua:	continues
pegajosa:	sticky
cabellos;:	hair;
86
:	86
prendida:	on
desagrado:	dislike
agravaba:	aggravated
suficiente.:	enough.
respirar:	breathe
trasmundos:	transworlds
indefinible:	indefinable
tranquilos:	calm
amenazaba.:	threatened.
Empezaba:	It started
esloras.:	lengths.
conservaban:	they kept
preguntaba:	I asked
secreta.:	secret
situarme:	situate myself
atolondrarme:	offer me
angustiosa.:	distressing
indeciblemente:	unspeakably
extravío:	loss
trastorno:	disorder
inexistentes.:	non-existent.
corredores:	runners
ilusorios:	illusory
conseguidos:	achieved
luminosos:	luminous
pozos:	wells
venía:	permission
reflejo.:	reflection.
mareo:	dizziness
desorientación:	disorientation
verticalidad:	verticality
nieves::	snow:
montañeses:	mountaineers
fenómeno:	freak
plantas.:	plants.
pantanos:	swamps
musgo:	moss
teñía:	had
vibrátil:	it vibrates
cínifes:	cynics
diminutos:	tiny
pulgas:	fleas
líquido::	liquid:
creados:	created
caminaban:	they walked
superficie:	surface
aceitosa:	oily
amasado:	kneading
agriamente:	agrily
olían:	the oil
fermentación:	fermentation
rampante:	rampant
adivinaba:	guessed
liendres—.:	nits.
levantados:	raised
—remolinos:	—swirls
podredumbres:	rotten
turbias:	cloudy
estela:	wake
invisibles:	invisible
denunciaban:	denounced
bofetadas:	slaps
ondulaciones:	ripples
súbitas:	sudden
inesperados:	unexpected
Chasquidos:	Clicks
culebras:	snakes
enrevesamiento:	entanglement
cochambroso:	dumpy
—allí:	-over there
libraba:	liberated
sorda:	deaf
gasas:	gauze
holoturia.:	holothuria.
estancamiento:	stagnation
tragante:	swallow
alejarse:	move away
aletazo:	flap
endurecidas:	hardened
burbujas:	bubbles
racimos:	clusters
Flotaban:	They floated
encubrimiento.:	concealment.
parda.:	curtain
comejenes:	termites
desplome:	collapse
promovió:	promoted
enroñaba:	enroñado
fetidez:	smelly
velludas:	hairy
frutos:	fruits
hebras:	strands
descenso:	descent
—pesado:	-heavy
errante:	wandering
hollín:	soot
garrotazo:	clubbing
madero:	log
anegada.:	flooded
apartar:	set aside
retorcidas.:	twisted
duramente:	hard
rasparon:	scraped
deslizarse:	slide
túnel:	tunnel
introdujo:	introduced
85
:	85
ahí.:	there.
estrecho:	narrow
Junto:	Together
multiplicaba:	multiplied
repetirse:	repeat
diseño:	design
escamoso.:	scaly.
demás::	others:
igual:	equal
«¡Ahí:	"There
Adelantado::	Advanced:
párpados.:	eyelids.
cierro:	I close
Adormecido:	Asleep
erizado:	bristly
estemos:	we are
acuciosa:	diligent
examinar:	examine
hosca:	Hoske
aproximando:	approaching
plomada.:	plumb.
teodolito:	theodolite
prolonga:	prolong
difumina:	blur
grieta.:	crack.
aparente:	apparent
empalizada:	palisade
inabordable:	unaffordable
manchas:	stains
cedido:	ceded
bambusales:	bamboo
fraguando.:	forging
decorado:	decorated
autenticidad:	authenticity
visos:	all
reparo:	repair
rige:	rich
bautizo:	christening
indios.»:	Indians."
«Eramos:	«We were
naturalmente::	naturally:
narrar:	narrate
malicia:	malice
condiciones:	conditions
distinción:	distinction
saqueo:	pillage
trompeta:	trumpet
cargos:	charges
otorgo:	I grant
astrólogo.:	astrologer.
Codro:	Cod
Micer:	mic
entrada.:	Prohibited.
quedamos:	we stay
pediremos:	we will ask
maravillosas:	wonderful
divierto:	I have fun
monotonía:	monotony
—
sustituye:	—
replaces
ondulación:	undulation
—tiesura:	—judiciary
mediana:	median
asombrarnos:	amaze us
diversidad:	diversity
conjugan:	conjugate
promontorios:	headlands
lunes):	Monday)
guardianes.:	guardians.
CUARTO:	ROOM
84
:	84
iluminarán:	will illuminate
únicas:	unique
rayo—:	ray-
ignoraremos:	we will ignore
proa.:	bow.
mascarón:	mask
hocico:	snout
olfatea:	sniff
sentarse:	feel
«¡Vamos:	«¡Come on
despedimos:	we say goodbye
embarcaciones.:	boats.
verano.:	summer.
contrariada:	upset
nuevos.:	new.
creemos:	we believe
asomamos:	we peek
saciada:	satiated
compartida:	shared
creada.:	created.
acabara:	it was over
oírla:	hear it
ensalmado:	salted
modeladas:	modeled
tornar:	become
tuvieran:	had
repitiéndolo:	repeating it
daremos:	we will give
imprevisibles—:	unpredictable—
apodos:	nicknames
imaginados:	imagined
sexos:	sexes
desinencias:	endings
términos:	terms
noches.:	nights.
prohibidas:	prohibited
íntimas:	intimate
surgiendo:	arising
secreto.:	secret.
fragua:	forge
aprendizaje:	learning
mutuo:	mutual
acoplamientos.:	couplings.
determinar:	determine
actitudes:	attitudes
tanteos:	scores
maravillosos:	wonderful
fijando:	fixing
eligiendo:	choosing
acomodo.:	arrangement.
ajuste;:	adjustment;
miembros:	members
cuerpos.:	bodies.
sintaxis:	syntax
haciéndonos:	making us
premuras:	haste
enmendamos:	we amend
exhaladoras:	exhalers
ordenar:	order
hatos:	six
juntar:	to bring together
conducidas:	driven
descienden:	they descend
vaciados—:	emptied—
—dos:	-of the
alborotosamente.:	rowdily.
trancos:	jerks
Eumeo...:	Eumeus...
porquerizo:	swineherd
transfigurado:	transfigured
filete:	steak
mediterráneas:	Mediterranean
rociarlas:	spray them
servirlas:	serve them
grasa;:	fat;
untarlas:	spread them
ensartar:	Ancestor
Odisea.:	Odyssey.
explicarme:	explain to me
propiciatorio:	propitiatory
cerdas:	intelligent
arcaico.:	archaic.
salvajes.:	wild.
atribuirse:	attribute
apetito:	appetite
desaforado:	unbridled
atiza:	he has run away
lomos:	loins
menudos:	giblets
descuartizamiento;:	quartering;
escaldadura:	scald
hoguera;:	bonfire;
habitualmente:	usually
alimenta:	feed
diluido:	diluted
manioco:	cassava
hartura:	take
cazadores:	hunters
uniendo:	uniting
¡Una:	A
«¡Una:	"A
tamaño.:	size.
salvaje:	wild
cerdo:	pig
83
:	83
pezuña:	hoof
Zevs:	Zeus
destino.»:	destination."
asigna:	assigns
desdichas:	misfortunes
agravan:	aggravate
tontería:	nuisance
dioses.:	gods.
enjuician:	prosecute
mortales:	mortal
Escuchad:	listen
clama::	cries:
lamentarse:	lament
Vuelve:	Comes back
Poseidón.:	Poseidon.
—afirma—:	—states—
soportal:	support
abruptos:	abrupt
construirá:	will build
encuentre:	find
antepasados.:	forefathers.
cargar:	carry
preciosos:	precious
metales:	metals
agarró:	grab
abrojos.:	caltrops.
cardos:	thistles
duras:	hard
echó:	threw
divisó:	spotted
lejos.:	far.
suyos::	his:
remedio:	remedy
múrices:	murices
cabras.:	goats.
habitados:	inhabited
peristilos:	peristalsis
tumbas:	graves
murallas:	walls
ruinas.:	ruins.
mediterráneo:	Mediterranean
conoce.:	know
campamentos.:	camps.
leyeron:	they read
cíclope:	Cyclops
váquiro:	vakiro
entortado:	bent
Itaca.:	Ithaca.
sirenas:	mermaids
enemigo:	enemy
visitador:	visitor
afinidad:	affinity
trágicos:	tragic
escuelita:	little school
sustituye:	replaces
anguloso:	angular
fragmentos:	fragments
versión:	version
separarse:	separate
páginas:	pages
hule:	cave
forrada:	lined
bilingüe:	bilingual
edición:	edition
modesta:	modest
partes::	parts:
sabe.:	he knows.
prospección:	prospecting
emprender:	undertake
burlado:	mocked
agotado:	exhausted
Desvío:	Detour
disimulos.:	dissimulations.
pueriles:	childish
valen:	worth
mujer»:	women"
formaliza:	formalize
cuándo:	when
marcada:	marked
vajilla:	crockery
limpiarla:	clean it
jicara:	mention of
gesto.:	gesture.
hombre::	man:
enorgullecerme:	proud
secándome:	drying myself
ordeñando:	milking
trayéndome:	trayendome
cuidados:	care
comprometido:	committed
remordida:	remorse
interrogante:	question mark
82
:	82
melancólico:	melancholy
palmada:	slap
instalado:	installed
Jamás:	Never
lejanía:	remoteness
desaparecido:	missing
fracaso.:	failure.
agobiar:	overwhelm
física:	physical
deploro:	I deplore
adentros:	inside
indiferente:	indifferent
aliviarse:	relieve
deber.:	duty.
cumplo:	I fulfill
seguirnos:	follow us
conciencia::	awareness:
adormecimiento:	numbness
donación:	donation
liberalidad:	liberality
leznas.:	legz
comercio:	trade
billetes:	tickets
quedándome:	staying
necesarios:	necessary
tratamientos:	treatments
instale:	install
traslados:	transfers
pague:	pay
atienda:	attend
embarcación.:	vessel.
envuelta:	wrapped
metido:	put
acoplamiento.:	coupling.
oponerse:	object
proceden:	proceed
insaciados:	insatiated
inseguros:	insecure
descubrirse:	be discovered
(Lunes:	(Monday
sangres:	bloods
gozosa:	joyful
acaricio:	caress
sembrado:	sown
agonía.:	agony.
conmoviera:	moved
morirse:	die
Pudiera:	could
oscuridad.:	darkness.
ritmo.:	rhythm.
imponerme:	impose
inerte:	inert
mortecino:	dead woman
encontrarse:	meet
desunidos:	disunited
delirio.:	delirium.
divagaciones:	ramblings
extravía:	misplaces
callar.:	shut up.
golpes:	blows
dispara:	shoot
¡Cochinos:	Pigs
—grita—.:	—screams—.
«¡Cochinos:	«Pigs
greñas:	shock
babeante:	drooling
crispada:	tense
asomada:	leaning out
gemía.:	he moaned.
Habíamos:	we had
golpe.:	blow.
desemparejándonos:	unpairing
escupe:	spit
quebrada:	ravine
acomodo:	arrangement
talle:	to him
arqueando:	arching
acaricia:	caress
tobillos:	ankles
piernas::	legs:
batiente:	swing
deleite.:	treat.
esparcidas:	scattered
Yacemos:	We lie
vivir.:	live.
pacto:	covenant
sellado:	sealed
cobramos:	we charge
jadeantes:	panting
deleitosa.:	delightful
trabazón:	interlock
vencerse:	expire
posesión.:	possession.
81
:	81
espera—:	wait-
crispación:	crispation
detenida:	detained
—más:	-further
sintiendo:	feeling
yerbabuena.:	spearmint
albahaca:	basil
estrechaba:	narrowed
mágicos:	magical
olía:	oil
—casi:	-almost
suspenso::	suspended:
resuello:	wheeze
azafrán.:	saffron.
sándalo:	sandalwood
alcanfor:	camphor
envolviéndonos:	involving us
crujiente:	crunchy
espeso:	thick
heno:	tonight
carnadas:	baits
cestas:	baskets
derriba:	knock down
quieta:	still
tenerla:	have it
muñecas:	dolls
violencias.:	violence.
irrupción:	irruption
riña:	fight
Tanto:	Both
puta.:	out.
perra:	bitch
dudar:	dude
escupir:	spit
insulto:	stroke
ofensa:	offense
inferido:	inflicted
imaginárselo:	it was imaginary
profundos.:	deep
instintos:	instincts
intención:	intention
tersura:	smoothness
firmeza:	the firm
insistencia:	insistence
pudor.:	modesty.
aldeano:	villager
conservado:	conserved
despoje:	dispossession
fingidas:	feigned
incita:	incites
probarlo:	try it
pierde:	lose
sospecho.:	I suspect.
Empezando:	Getting started
decidirla.:	decide it.
despertando:	awakening
vuela:	fly
espero:	expect
hablar.:	talk.
hombro::	shoulder:
posa:	put
garrasperas.:	claws
febril:	febrile
alzarse.:	rise.
irónicamente—.:	ironically-.
—concluyó:	—he concluded
blándula:	fool
vágula:	the vagus
andanzas.:	wanderings.
imposible.:	impossible.
acceso:	access
quedaría:	would remain
débil:	weak
forzarla:	force her
comodidad::	comfort:
aguardarme:	wait for me
conduciría:	would drive
inconveniente:	inconvenient
dicendo:	saying
providencial:	providential
tortura:	torture
Adivinando:	Guessing
aborrecía.:	hated
escolta:	listen
tonta:	old
preciosa:	lovely
equivalía:	was equivalent
implicaba:	implied
palúdica:	malaria
derribada:	knocked down
avisado:	warned
reconocerlo:	recognize it
esperó:	wait
zamba:	fraud
vergüenza:	shame
muerta:	dead
violada:	raped
décimas:	tenths
cantaban:	they sang
ribereñas:	riparian
canciones:	songs
indigna.:	unworthy
digna:	worthy
Villano:	Villain
Fiel:	Fell
Amante:	Lover
Ejemplar:	Copy
Esposa:	Wife
Malo:	Place
pieza:	part
80
:	80
tallados:	carved
teatros:	theaters
hombría:	manhood
Faltar:	Lack
discusión.:	discussion.
excluían:	they excluded
insoslayables:	unavoidable
eternos:	eternal
honraban:	in honor
obligaciones:	obligations
respeto:	I respect
convivían:	they lived together
sustituido:	replaced
auténtico.:	authentic.
rapidez:	speed
asestándole:	hitting him
quebrarla:	break it
afearla:	manure
cansarla:	tire her out
desarmarla:	disarm it
enfermedad.:	disease.
eligiera:	choose
insecto:	insect
maravillas:	wonders
embellecía:	embellished
ambiente:	environment
hollábamos:	we found
rezongando:	grumbling
deslizaron:	they slipped
regiones—.:	regions.
concedía:	granted
—enfermedad:	-disease
diagnosticó:	diagnosis
autorizado:	authorized
temblores.:	tremors.
hundirse:	sink
delirando:	delirious
incorporado:	incorporated
tiritaba:	shivered
noticia::	news:
espesarse:	thicken
concluyendo:	concluding
escuchando:	listening
formuladas:	formulated
aptitud:	fitness
advertía:	warned
mismo.:	same.
encerró:	locked up
sofocante:	suffocating
Transcurrieron:	They passed
comportamiento:	behavior
enardecida:	enraged
enamorada:	in love
ejemplo:	example
—algo:	-something
agredido:	assaulted
confería:	conferred
violenta:	violent
adivinaban:	they guessed
Mouche.:	Fly.
repelían:	repelled
disturbios:	unrest
solidaridad:	solidarity
tácita:	tacit
semillas.:	seeds.
desgranaba:	shelled
enseñaba:	taught
caían:	they fell
agraviado:	aggrieved
regodeado:	gloated
alpargatas:	espadrilles
remendaban:	they mended
falsete.:	falsetto.
ajo:	SHE
ají:	chili
aceite:	oil
discusiones:	discussions
hervía:	boiled
nerviosidad:	nervousness
ponían:	they put
cosa.:	What.
parecieran:	they seemed
fruncía:	puckered
chinchorro.:	chinchorro
desamparo:	helplessness
gemir:	moan
Dejándola:	leaving her
ruegos.:	prayers
descubrimiento:	discovery
añadidos:	added
recapacitaciones:	retraining
cambios:	changes
ternura.:	tenderness.
amistosa:	friendly
subsistir:	subsist
sentimiento—:	feeling-
asaltaban:	assaulted
—hasta:	-until
79
:	79
Apagado:	Off
extraña.:	strange
serme:	laying
prolongada:	prolonged
alabo:	those
admira:	admire
acorazado:	battleship
sentida:	felt
sacudido:	shaken
súplica:	appeal
suplica:	appeal
demencia.:	dementia.
agota:	exhausts
soporta:	supports
insistir:	insist
agresión;:	assault;
Herborizador.:	Herbalizer.
esparadrapos:	adhesive plasters
rubricada:	initialed
Hedionda:	Hideous
choza.:	hut.
enfurecido.:	enraged.
cerrándole:	closing him
testarudez:	stubborn
repitiendo:	repeating
gacha:	up to
sentada:	sitting
negándose:	refusing
obstinado:	obstinate
mutismo:	mutism
ocurrido.:	occurred.
tratamos:	we treat
rodeando:	surrounding
curarla.:	cure it.
desollones.:	skinning
arañazos:	scratches
nariz.:	nose.
sangra:	bleed
dientes.:	teeth.
tenerse:	have
levanto:	I lift
bufidos:	snorts
roncos:	snoring
gruñidos:	grunts
traduce:	translate
sujetan:	hold
muerde:	bite
retuerce:	twists
agarrarla.:	grab it.
corremos:	we run
pegando:	catching
escupiendo:	spitting
estaca.:	stake.
grueso:	thick
pidiendo:	asking
empapada:	soaked
villano.:	villain.
afrentara:	will affront
sorprender:	surprise
grita.:	shouts.
extrañado:	missed
oyen:	they hear
peligrosas.:	dangerous.
albergan:	they house
pocetas:	you will start
cubre.:	covers.
costra:	crust
desprenden:	detach
infructuosa:	fruitless
desacompasando:	out of step
adivinado:	guessed
fulgor:	glow
reaviva:	revive
ilusión:	illusion
encuentro.:	meeting.
pobre:	poor
descubridor:	discoverer
fatalidad:	fatality
desesperanzas:	despair
Riqueza.:	Wealth.
milímetros:	millimeters
desvío:	detour
lateralmente:	laterally
interrogado:	interrogated
lodazal:	mud
revuelto;:	scrambled;
escarbado:	scratched
Agamenón:	Agamemnon
Regreso:	Return
78
:	78
Moisés:	Moses
ranas.:	frogs.
mugían:	go away
fría.:	cold.
alumbraba:	illuminated
pepitas:	nuggets
sabor.:	flavor.
tentó:	tempted
alquimista.:	alchemist.
sopesábamos:	we were weighing
crecer.:	grow.
Palpábamos:	We palpated
amarillearon:	yellowed
piedrecitas:	pebbles
destapó:	uncovered
conjuro:	incantation
marcharon:	marchon
Espesura:	Thickness
tomaban:	they took
pude:	could
Desconocido—.:	A stranger-.
cercanías:	surroundings
planteada:	raised
edificaban:	they built
Parima.:	The best.
rebrillaban:	resplendent
prodigios.:	prodigies.
pararnos:	stop
infancia.:	childhood.
Formas»:	Shapes»
«Nadie:	"Nobody
pintaban:	they painted
Ríos.:	Rivers.
misteriosos:	mysterious
descifrar:	decipher
Emplumada:	feathered
Serpiente:	Snake
talladas:	carved
máxima.:	maximum.
alfabetos:	alphabets
castigando:	punishing
nudos:	knots
transitado:	traveled
vastos:	vast
Pacífico:	Peaceful
Descubríanse:	They discovered each other
negada:	denied
inmortalidad:	immortality
fenecidos:	deceased
derrocados:	overthrown
—dioses:	—gods
Avenidas:	Avenues
fijas:	fixed
hallarla:	with cases
Unas:	Nails
sacerdotes-langostas.:	lobster-priests.
sacerdotes-peces:	fish-priests
representaban:	they represented
portentosas:	portentous
atracaderos:	berths
escalinatas:	stairs
Mayas:	Mayans
Imperio:	Empire
caribes:	caribbeans
existido::	existed:
Urre.:	gold
contemplada:	contemplated
divisado:	spotted
reputado:	reputed
geógrafo:	geographer
narración:	narration
Setenta:	Seventy
Luces.:	Lights.
Siglo:	Century
pleno:	full
misioneros:	missionaries
Prodigios:	prodigies
Abogado:	Lawyer
trataba.:	tried.
embustes:	lies
difundir:	spread
77
:	77
Maligno:	Malignant
consejas:	advice
endosar:	endorse
rugiendo...:	roaring...
rabiando:	raging
murió:	died
Constantinopla:	Constantinople
exhibida:	exhibited
Arpía:	Harpy
portentos:	portents
fidedigno:	trustworthy
—según:	-according to
avestruz:	ostrich
pezuñas:	hooves
cobijarse:	shelter
venados:	deer
virtudes:	virtues
prodigiosas:	prodigious
Bezar:	Market
aceptábamos:	we accepted
alimentaban:	they fed
dormir:	sleep
anfibios:	amphibians
Bogotá:	Bogota
Ensalmo:	I praise
portentos.:	portents.
anhelantes:	longing
envolver:	involve
dejábamos:	we left
dedos.:	fingers.
yema:	bud
prodigio:	prodigy
frialdad:	coldness
ausentes.:	absent.
sostenerla:	support her
estatura:	stature
alabarda:	halberd
agarrados:	clinging
espadas:	swords
morriones:	morions
lúgubre:	lugubrious
revuelta:	revolt
narró:	narrated
acallados:	silenced
pasábamos:	we passed
Conquistadores.:	Conquerors.
—fecha:	-date
escrita:	writing
forja:	forging
perfil::	profile:
extrañeza:	strangeness
hacha:	axe
arrimó:	arrived
Irguiéndose:	standing up
inaccesible:	inaccessible
quemado:	burned
partidas:	matches
crónicas:	chronicles
conocidas;:	known;
dardos.:	darts.
reiterado:	reiterated
sorber:	drink
monturas:	mounts
extraviarse:	stray
expediciones:	expeditions
fracaso:	failure
trágico:	tragic
tanteo:	score
tremebundo:	trembling
corrido:	run
contempló:	contemplated
Urre:	gold
Hutten:	Cabins
movedizo:	shifting
asentar:	settle
calzaron:	they shod
corceles:	steeds
cabalgando:	riding
estandartes:	banners
chivo:	billy goat
enjutos:	lean
extremeños:	Extremadurans
rizadas:	curly
rubios:	blondes
alemanes:	germans
difuntos.:	deceased.
tenedores:	forks
herbolarios:	herbalists
algebristas:	algebraist
nigromante:	necromancer
escoltados:	escorted
capellanes:	chaplains
Espira:	Turn
Belalcázar:	Belalcazar
escaupiles:	escapiles
cotas:	quotas
calentar:	heat
surgen:	arise
aventureros:	adventurers
prodigiosos:	prodigious
invocar:	invoke
llamaban:	they called
españoles:	spanish
ríos.»:	rivers."
arrojada:	bold
grava:	important
paridora:	birther
veta:	Know
"la:	"the
llamara:	will call
hallamos.:	we find
planeta—:	planet-
explorada:	exploited
empavesadas:	buntings
76
:	76
alquimia:	alchemy
desconocemos:	we don't know
—arguye:	—argues
«Luego:	"Then
objeta:	objects
«Aluviones»:	«Alluvium»
lodos:	sludge
abarca:	encompasses
buscó:	look for
Donde:	Where
realidad.:	reality.
recolector:	collector
lumbre.:	fire.
ramillas:	twigs
máscara:	mask
cazurra:	cazura
espejismo:	mirage
refiere.:	refers.
estudiado:	studied
ser—:	to be-
—narrador:	-narrator
narrador:	narrator
Tesoros.:	Treasures.
agrada:	like
guardián:	guardian
gnomo:	gnome
carnosos:	fleshy
pecas:	parts
cortas:	short
calva:	bald
cauces.:	channels.
encoge:	shrink
exhausta.:	exhausted
desatan:	untie
Prendido:	On
cayéndose.:	falling
graznando:	thanking
grillos.:	irons.
gozamos:	we enjoy
compartimos:	we share
sosiego:	quiet
bienestar:	welfare
ebrios:	drunk
ensalmados:	soulful
dormir.:	sleep.
fatigosa.:	tiring
pierden:	lose
estelas:	trails
apostura:	pose
fantástica:	fantastic
ocupamos:	we occupy
pizarroso:	slaty
repecho:	slope
paradas:	stops
propicia:	conducive
astilla:	sliver
muriendo:	dying
saltos:	heels
crecen:	grow
miramos:	we look
griegos::	Greeks:
tuerto:	one-eyed
dogo:	small
recostadas:	lying down
mentón:	chin
codo:	elbow
alrededor:	around
involuntaria:	involuntary
tomates:	tomatoes
rábanos:	radishes
bateas:	you punt
aplaca:	plate
familia.:	family.
Iluminado:	Enlightened
obsesión:	obsession
obstinadamente:	stubbornly
Lulio:	Lullius
Raimundo:	Raymond
directo:	straight
descendiente:	descendant
herejes:	heretics
alquimistas:	alchemists
prosapia:	lineage
divertida:	fun
forjado:	wrought
fantasear:	fantasize
cuelgue:	hang up
cansarse:	tire
francés:	French
personaje.:	character.
silencios:	silences
inagotable:	inexhaustible
considera:	consider
mellado.:	jagged.
bolsa:	if
75
:	75
cuentan:	they count
médico:	doctor
indígenas.:	indigenous.
mofa:	mold
buscándose:	looking for
sien:	see
metales.:	metals.
visuales:	visuals
alucinaciones:	hallucinations
clavaria:	keyboard
bajará:	will go down
comprimido:	pill
traga:	trace
relacionados:	related
interesan:	interest
gentes—:	people—
desatención:	inattention
venimos.:	we come
Señor-de-los-Venenos:	Lord-of-Poisons
calificándose:	qualifying
botánicos:	botanicals
repara:	repair
acertadamente.:	aptly.
bautizado:	baptized
haberlos:	have them
explicándonos:	explaining to us
tritura:	crushes
clasificación:	classification
terminología:	terminology
quiénes:	who
mayormente:	mainly
experimentar.:	experiment.
estudiar:	study
estupefacientes:	narcotics
colector:	collector
científico:	scientific
engolado:	haughty
hablando:	talking
gesticulando:	gesturing
refrescando:	refreshing
víspera—:	eve-
hablara:	will speak
resguardo:	guard
anuncia:	announces
triunfo.:	triumph.
bajorrelieve:	bas relief
reproducen:	they reproduce
ambiente.:	environment.
helenismo:	Hellenism
dórico.:	Doric.
fuste:	skirts
instintiva:	instinctive
diámetro:	diameter
eligieron:	they chose
pilastras:	pilasters
arquitrabe.:	architrave
inventado:	invented
quedara:	will remain
cobrara:	Bill to
hastial:	gable
empinamiento:	steepening
bastado:	enough
arquitecturas:	architectures
palmera:	palm
materiales:	materials
prosapia.:	lineage
sábado):	Saturday)
escozor.:	stinging.
aceptaba:	accepted
Del:	Of the
viajes.:	trips.
difuminadas.:	blurred
imprecisas:	inaccurate
deshaciéndose:	falling apart
claramente:	clearly
dibujarse:	draw
acabó:	just
Pensé:	Think
pintaron:	they painted
llevada.:	carried
sabida:	because
infamia:	infamy
aliviado:	relieved
74
:	74
relevaban:	relieved
cantores:	singers
junqueras:	reeds
llenaba:	filled
anochecer:	dusk
castigarla:	punish her
menos—:	less-
impulsos:	impulses
refería:	referred
gravísimo:	very serious
ignoraba:	I ignored
entendido:	understood
acostada:	lying down
Brabante.:	Brabant.
leer:	file
austero:	austere
enardecer:	inflame
reinaba:	reigned
timón—:	rudder-
—afirmaba:	—he stated
fornicaciones:	fornications
Tantas:	So many
holgarse.:	relax
hallaban:	they found
parejas:	couples
albergaban:	they housed
franciscano:	Franciscan
ruinosas:	dilapidated
risas:	laughter
carcajeó:	cackled
llamarla»:	call her"
Príapo:	Priapus
rubor.:	blush.
distraídamente:	absently
—dejada:	—left
reavivaba:	revived
montañas.:	mountains.
despedazador:	breaker
inconcebibles:	inconceivable
rotos.:	broken.
unidas:	united
mixtas:	mixed
descendían:	they descended
derribadas:	knocked down
intervenido:	intervened
ciega:	blind
ignorados.:	ignored.
vestigios:	vestiges
perderse:	be lost
florecido:	blossomed
civilización:	civilization
necrópolis:	necropolis
—restos:	-remains
dólmenes:	dolmens
menhires:	menhirs
arcaicos:	archaic
esparcidos:	scattered
escasos:	scarce
basálticos:	basaltic
huérfano:	orphan
respiraba:	I was breathing
saltar.:	hop.
bárbaro:	barbarian
quietud:	stillness
erguía:	raised
petrificados.:	petrified
faldas:	skirts
tristeza.:	sadness.
pizarrosas:	slate
colinas:	hills
sombrío.:	gloomy.
solemne:	solemn
mostraba:	showed
poniente.:	west.
mástil:	mast
desprendida:	detached
galera:	crowd
poderoso:	powerful
avanzaba:	advanced
pértiga:	pole
instalados:	installed
vimos:	we saw
cuidó:	cared
aclaraciones:	clarifications
mano.:	thousand.
abandonada:	abandoned
frondosa:	leafy
peñones:	rocks
crecían:	they grew
traídas:	betrayed
fronda:	frond
anduviera:	walked
Aprovechando:	Taking advantage
rebozo.:	shawl
hatillo:	bundle
fregaderos:	sinks
cuartos:	quarters
protestas:	protests
armaron:	they armed
73
:	73
voluntad.:	willpower.
costurero:	sewing box
viniera:	would come
asegurándose:	making sure
riesgo:	risk
engorros:	hassle
enterarse:	find out
figuro:	figure
siguiéramos:	we would continue
descansaríamos:	we would rest
Mañana:	Tomorrow
acompañara:	will accompany
rogándole:	begging
colgó:	hung up
alborozo.:	joy.
aceptó:	accepted
gemas—:	excited—
—deslumbrada:	—dazzled
aseguraba:	assured
comodidad.:	comfort.
adelantar:	pass
debíamos:	we should
entendía—:	understood—
—
que:	—
what
tajó:	milk
decían:	they said
prestaba:	lent
gargantas:	throats
recogido:	collected
mostrando:	showing
bramidos.:	roars.
espumosos:	sparkling
lloraran:	they will cry
descubridores:	discoverers
rogado:	begged
navegable:	navigable
burlando:	mocking
aprestaban:	they prepared
coser:	sew
expresada:	expressed
rabiosamente:	rabidly
concertaba:	arranged
dormidos:	asleep
muerte—.:	death-.
quehaceres:	chores
entregadas:	delivered
cotidiano.:	everyday.
despierta.:	wake up.
intensamente:	intensely
deseando:	wishing
disputa:	dispute
librado:	delivered
Contento:	Happy
reaparecido.:	reappeared.
desperté:	I woke up
almohada.:	pillow.
abrazada:	hugged
durmiendo:	sleeping
amanecido:	dawn
prolongaba:	prolonged
comenzaba:	began
envolvía:	wrapped
rústica:	rustic
demorado:	time-consuming
paganos.:	pagans
ensangrentadas:	bloody
asentaban:	they settled
obispos:	bishops
alfanjes:	alphas
mártires:	martyrs
bizantina:	Byzantine
factura:	bill
capilla:	chapel
viejísima:	very old
sobrecogido:	overcoected
atmósfera:	atmosphere
desangrarse:	bleed out
venía.:	permission.
vitalidad:	vitality
vitral:	stained glass
plásticos:	plastics
amaneramientos:	mannerisms
capillas:	chapels
áureas:	golden
desteñimiento:	fading
divino:	divine
72
:	72
riendo—:	laughing-
contaba:	counted
trato.:	deal.
prendía:	turned on
descarte:	discard
invocaban:	they invoked
jugadores:	players
bestias.:	beasts.
extravíos:	misplacements
granizadas:	hailstorms
reumatismos:	rheumatism
sometían:	they subjected
interpelaba;:	interpelava;
grandes.:	big.
blasfemia:	blasphemy
solían:	they used to
recibían:	they received
Reclamaciones.:	Claims.
Ruegos:	Prayers
Ministerio:	Ministry
disponibles:	available
celestiales:	heavenly
burócratas:	bureaucrats
destajo:	piecework
intercesores:	intercessors
divinos:	divine
categoría:	category
procesión:	procession
sacados:	taken out
exvotos:	votive offerings
moneda:	currency
pagados:	paid
atributivos:	attributive
Ricos:	Rich
llagas.:	sores.
parezcan:	seem
verdaderamente:	truly
Lázaro:	Lazarus
oído;:	ear;
asido:	acid
Cristóbal:	Christopher
enemigo;:	enemy;
garrocha:	pole
saña:	fury
dragón:	dragon
alanceando:	reaching
llave;:	key;
llavero:	key ring
maíz;:	corn;
fresca:	fresh
labre:	labor
entregados:	delivered
aleluya:	alleluia
mañaña:	tomorrow
pasada:	past
románicas.:	Romanesque
evoca:	evokes
artesonadas:	coffered
toscos;:	rough;
tozudez:	stubbornness
hornacinas:	niches
acusados:	accused
espesísimas:	very thick
chata:	cottage
Pasión.:	Passion.
enumerados:	enumerated
cortos:	shorts
zócalo:	plinth
embaldosado:	tiling
portón:	gate
separado:	separate
dependencia:	dependence
prolongación:	extension
enterrado:	buried
dejamos:	we leave
tapias:	walls
Medio:	Half
atrio:	lobby
contaban:	they counted
ratas:	wheel
Danubio:	Danube
Oscuros:	Dark
Años:	Years
cronistas:	chroniclers
aquéllas:	those
diurna:	daytime
entierro:	burial
ocurrían:	occurred
testigos:	witnesses
suceso:	event
multiplicación:	multiplication
espantadas:	scared
ignoto:	unknown
levantado:	up
violado:	broken
hombros.:	shoulders.
vasijas:	vessels
subiera:	would rise
candentes:	hot
71
:	71
rojiza:	reddish
alzarse:	rise
Extrañados:	Missed
amaneció.:	it dawned
relojes:	watches
entrega.:	delivery.
halagada:	flattered
pasividad:	passivity
decíamos.:	we said.
secándose:	drying
regresaba:	was returning
hoyo:	hole
mirándome:	looking at me
apoyó:	support
sesgado:	biased
dándole:	giving
lutos:	collapse
desnudó:	naked
afanosa:	eager
tornará:	will return
fábulas:	fables
tejía:	weaved
adolescencia.:	adolescence.
ansia:	anxiety
deseaba:	I wanted
Avergonzándome:	Embarrassing me
sombríos.:	gloomy
remotas:	remote
moviendo:	moving
arqueaba:	arched
comba:	swing
adosada:	semi-detached
ropa.:	clothes.
atraído:	attracted
corazón.:	heart.
endurecimiento:	hardening
inflamación:	inflammation
provocándole:	provoking him
plasmada:	embodied
promovido:	promoted
exceso:	excess
complicado:	complicated
compadre:	buddy
comenzado:	started
fisiología:	physiology
mitológico:	mythological
revelaba:	revealed
legendario:	legendary
enfermedad:	disease
Auxiliares:	Assistants
oración:	prayer
borra.:	drill.
paño:	cloth
cono:	Pussy
hirviente:	boiling
verter:	pour
empellón.:	shove.
sólido:	solid
empujándome:	pushing me
riendo::	laughing:
concluyó:	concluded
agarrado:	grabbed
estupefacción:	stupefaction
engendraron:	will engender
hallarás:	you will find
«Entrando:	«Entering
añadió::	added:
declamado:	declaimed
consejo:	advice
chocante:	shocking
replicarle:	reply
afortunado:	lucky
audaz:	bold
lección—:	lesson-
—dijo:	-said
turbe:	disturbances
«Vete:	"Alone
distraerla:	distract her
inoportuno:	inopportune
irónico:	ironic
Molesto:	Annoying
calentando:	warming up
buscara:	will search
aconsejarme:	advise me
maliciosa:	malicious
Diamantes:	Diamonds
Pensaba:	Thought
representaba.:	represented.
sonreír:	smile
Pudieran:	They could
monedas.:	coins.
tendidas:	lying
solemnidades:	solemnities
enlutados:	mourners
preparadores:	preparers
agremiación:	union
hielo:	ice
lechos:	beds
coronas:	crowns
ocultaban:	they hid
oraciones:	prayers
bronces:	bronzes
cuán:	how
Recordaba:	I remembered
70
:	70
conocen.:	they know
tarifas:	tariffs
Otra:	Other
Señores:	Sirs
salvoconductos:	safe conduct
credenciales:	credentials
señas:	address
músicos—;:	musicians—;
servidores:	servers
—se:	—with
promesas:	promises
arrojarían:	they would throw
gritar:	scream
incierto:	uncertain
dejen:	the dough
adivinan:	guess
quedar:	meet
conocían:	they knew
sentido::	sense:
repetía:	repeated
surgía:	arose
precedieron:	preceded
funerarios:	funeral
remembranzas:	remembrances
despertara:	will wake up
arrastrado:	dragged
lloraban:	they cried
mí—:	my-
—cerca:	—about
admirado:	admired
deudo:	finger
ello.:	it.
gritando:	yelling
sollozando:	sobbing
maldiciendo:	cursing
Hécuba:	Hecuba
nueve—:	nine-
dramático:	dramatic
persistencia:	persistence
incendiados.:	set on fire.
aullantes:	howlers
sublimes:	sublime
perras:	bitches
cabelleras:	scalps
soltando:	letting go
coéforas:	coephoras
clamaban:	they cried
campesinas:	peasants
desesperada:	desperate
protestaban:	they protested
apropiado:	appropriate
rezar:	to pray
agonía:	agony
consabidas:	known
repartían:	they distributed
parían:	they gave birth
arcas:	chests
plegadas:	folded
Impresionado:	Impressed
ataúd...:	coffin...
abrazando:	hugging
atroz.:	atrocious.
desgarramiento:	tearing
puntas:	tips
arrastrados:	dragged
teñidos:	dyed
tacón:	tacon
deshecha.:	undone
inertes:	inert
desmayada:	fainted
sacaron:	they took out
expiaciones.:	expiations.
rajada:	to establish
profecía.:	prophecy.
videncia:	clairvoyance
surgido:	emerged
escalofriante:	spooky
desprender:	detach
trataban:	they tried
amenazando:	threatening
enrabecida:	enraged
resistió:	resisted
quisieron:	they wanted
arrojaría:	would throw
arrancarse:	tear off
lacerar:	lacerates
Decía:	He said
ataúd.:	coffin.
endemoniada:	possessed
parturienta:	parturient
flechada:	arrow
inhumano:	inhuman
aullido:	howl
69
:	69
lanzó:	launched
agrandados:	enlarged
pálidos:	pale
lustroso:	glossy
enlutada:	mourner
túmulo.:	tomb.
acercaba:	approached
sacada:	balcony
convulsiones.:	convulsions.
sacudida:	shake
flacuchenta:	skinny
muchacha:	girl
colilla:	stub
inclinarse:	lean
Pieles:	Skins
Curtidor:	Tanner
Alcalde:	Mayor
Raudales:	Rapids
Práctico:	Practical
Varios:	Several
lienzos.:	canvases.
crespones:	crepes
velados:	veiled
arrecife.:	reef.
apacibles:	peaceful
cayendo:	falling
hinchándose:	inchingando
oscuros:	dark
contigo:	with you
dormitorios:	bedrooms
antífona:	antiphon
rezaban:	they prayed
gravemente:	seriously
recibidor:	receiver
zaguán:	hallway
bailar.:	dance.
peinados:	hairstyles
adornaban:	they adorned
cerosas:	waxy
silvestres:	wild
pétalos:	petals
jazmines:	jasmine
recobrados:	recovered
jardines:	grounds
alféizares:	windowsills
olorosas:	smelly
vivos:	alive
mensuración:	mensuration
conservaba:	preserved
precavida:	cautious
difunto:	deceased
exacta:	exact
fallaba:	failed
gruesos:	thick
hincado:	driven
ataúd:	coffin
túmulo:	tomb
alzaba:	raised
obra.:	work.
estancias:	stays
cupiera:	fit
velando:	watching
llantos:	cries
agrupando:	grouping
solícita:	helpful
diligente:	diligent
enrejadas:	trellises
caserón:	mansion
viernes):	Friday)
graciosamente:	graciously
ostentaba:	flaunted
taguara:	back
demoraba:	delayed
faltaba:	was missing
turbios:	cloudy
arroyos:	streams
deceso:	death
espoleado:	plundered
afectado:	affected
acabada:	finished
medicina.:	medicine.
panderos:	tambourines
jarras-para-bramar-en-funerales:	jugs-for-bellowing-at-funerals
onomatopeyas:	onomatopoeia
enumeró:	listed
interrogaba:	interrogated
revueltas.:	revolts.
tornadizo:	twisty
tribu:	tribe
Autana:	Autoana
efectivamente:	indeed
Signo:	Sign
fundación:	foundation
Penélope.:	Penelope.
él.:	he.
cuarzos:	quartz
abril:	April
bajado:	lowered
botador:	bouncer
bogar:	arcs
impaciencia.:	impatience.
incisión:	incision
respondiendo:	responding
terminaron:	they finished
disponer:	provide
trascendencia:	transcendence
finjo:	I pretend
griegos.:	Greeks.
comenta:	comment
estuve:	I have been
tarda:	afternoon
navegar:	browse
tienda:	store
imaginar:	imagine
desollado:	desolate
tomé:	Thomas
matadores:	matadors
mutilado:	mutilated
recientemente:	recently
bravios:	brave
Navio:	Ship
agorero:	doomsayer
salón:	salon
suficiente:	enough
empeño:	endeavor
aturdirse:	stun
Padrenuestro:	Our Father
subirse:	get on
blandura:	softness
sobresalta:	startles
convergencia:	convergence
enteros:	whole
extremos:	extremes
colillas:	butts
estaré:	I will be
huelen:	take
hastiado:	jaded
abro:	I open
terreno.:	land.
quedó:	remained
indefinidamente:	indefinitely
alarga:	lengthens
abogado:	lawyer
corazón:	heart
figura.:	figure.
revista:	magazine
taberna:	bar
corren:	they run
Apocalipsis:	Apocalypse
transcurrido:	elapsed
abuso:	abuse
ennoblecidos:	ennobled
estrechez:	narrowness
meros:	heritage
consiste:	consists
quieren:	they want
Venusberg:	Venus mountain
precisamente:	precisely
vivirlo:	live it
cemento:	cement
órdenes:	orders
vivienda.:	dwelling.
pública:	public
automatismo:	automatism
guirnaldas:	garlands
haba:	length
multitud:	crew
cruzan:	cross
leves:	light
plantada:	planted
tenerme:	have me
yeso:	and so
decoración:	decoration
habría:	there would be
indulgencia:	indulgence
escucharme:	listen to me
tránsito:	transit
engañados:	deceived
precisa:	it needs
inmovilizada:	immobilized
máscaras:	masks
lectura:	reading
biblioteca:	library
deseos:	wishes
crueles:	cruel
espera.:	wait.
galería:	gallery
observo:	noticed
recepción:	reception
conviven:	coexist
borracho:	drunk
presidente:	president
intimidad:	privacy
acude:	come
suelen:	they usually
peores:	worst
vender:	sell
cuartillas:	quarters
Ese:	That
repasando:	reviewing
creí:	I believed
reunirse:	meet up
pista:	track
cautivo:	captive
explorador:	explorer
sufre:	suffer
sacarme:	take me out
conyugal;:	conjugal;
irrita:	irritates
plácido:	placid
elogios:	compliments
comunión:	communion
fotografías:	photographs
ignorada:	ignored
actualidad:	present
patética:	pathetic
pidió:	asked
exploradores:	explorers
tuvo:	had
apartamento:	apartment
dramática:	dramatic
publicaciones:	publications
creía:	believed
suburbios:	suburbs
seis:	six
índices:	indexes
nacer:	be born
jarras:	jugs
mando:	command
hablo:	speak
callarme:	shut up
amigos:	friends
llevaría:	would take
culpas:	blame
víctima:	victim
haberme:	have me
regresaré:	I will return
plena:	full
ofrecida:	offered
maleta:	suitcase
cuadernos:	notebooks
expresar:	express
marchar:	leave
aguarda:	wait
acontecimiento:	event
hacerse:	become
sendero:	path
cierran:	they close
aluminio:	aluminum
cantimplora:	canteen
telas:	screens
cruzarse:	cross
admiro:	admire
área:	area
pilotos:	pilots
premio:	award
prisionero:	prisoner
contacto:	contact
repite:	repeat
pesado:	heavy
regresa:	come back
volaban:	they flew
muros:	walls
salía:	went out
Petroglifos:	Petroglyphs
marcaban:	they marked
seña:	sign
atropello:	run over
dije:	said
umbral:	threshold
brotado:	sprouted
acariciar:	stroke
ansias:	craving
cosas.:	things.
bruma:	Hoar
confundidos:	confused
fomento:	promotion
reglas:	rules
padecer:	suffer
torrente.:	torrent.
pintan:	they paint
agobio:	burden
aligerando:	lightening
excitación:	excitement
vuelva:	come back
Sigo:	I continue
acabar:	end
ir:	and
terminen:	the semester
leproso:	leper
esperando:	waiting
¡Vete:	¡Alone
pedazos:	pieces
agitando:	waving
agujero:	hole
antigüedad:	antique
lepra:	leprosy
oyendo:	hearing
mueve:	moves
licor.:	liqueur.
engaño:	deception
quita:	remove
atadura:	tie
casamiento:	marriage
dominical:	Sunday
festiva:	festive
realmente.:	really.
consumado:	consummated
quién:	who
despecho.:	spite.
resquemante:	resequent
haciéndome:	making me
establecida:	established
pasará:	will pass
lamento:	I regret
arduo:	arduous
trato:	deal
zozobra:	anxiety
veré:	I will see
suscrita:	subscribed
aceptar:	accept
llevada:	carried
comedia:	comedy
Podría:	Could
tribunales:	courts
principios:	beginning
prorrumpo:	I burst out
nupcial:	bridal
cromo:	chrome
cayado:	crook
legales:	legal
obligación:	obligation
Medievo:	Medieval
guitarra:	guitar
libretas:	notebooks
«Te:	"The
papel.:	paper.
cuaderno:	notebook
sorpresa.:	surprise.
tregua:	truce
Sé:	See
facilidad:	ease
consignas:	slogans
inspiración:	inspiration
colocados:	placed
recuperar:	recover
espontaneidad:	spontaneity
ahora.:	now.
gráfica:	graphic
irregularmente:	irregularly
lápiz.:	pencil.
discantus:	students
pondrá:	will put
traído:	brought
vacas:	cows
regrese:	come back
Libación:	Libation
arruga:	wrinkle
respondo:	answer
escándalo:	scandal
ponerme:	put on
opuesto:	opposite
retórica:	rhetoric
morado:	purple
Vidas:	Lives
inglés:	English
ministerio:	ministry
textos:	texts
rodean:	surround
versos:	verses
Ciertos:	Some
mentalmente:	mentally
tercio:	third
Prometeo:	Prometheus
pentagramas:	staves
esbozar:	outline
empiezo:	start
entrega:	delivery
contemplaba:	contemplated
—forma:	—shape
hechicero:	sorcerer
poblado:	populated
inteligentes:	smart
músicos:	musicians
armonía:	harmony
referencia:	reference
desconfiar:	distrust
concepción:	conception
lograr:	achieve
polifonía:	polyphony
puros:	cigars
pasaba:	was passing
restaba:	remained
colgada:	hung
directamente:	directly
darle:	give
tropo:	trope
encuadrar:	frame
sencillez:	simplicity
cuidado:	Careful
entonación:	intonation
elocuencia:	eloquence
reclamar:	complain
haciéndose:	making
paroxísticos:	paroxysmal
exasperados:	exasperated
compositores:	composers
inflexiones:	inflections
recitativo:	recitative
problema:	problem
incitación:	incitement
necesaria:	necessary
burbujeantes:	bubbly
sonidos:	sounds
resuelto:	resolved
imaginado:	imagined
siguiente:	following
molesta:	bothers
pluma:	feather
creación:	creation
euforia:	euphoria
informes:	information
acontece:	it happens
abrazar:	embrace
vez.:	time.
sostienen:	hold
pasamos:	we passed
Llueve:	It's raining
manchado:	stained
caracol:	snail
simplemente:	simply
superiores:	superiors
Llego:	Arrive
dibuja:	draw
viento.:	wind.
descubierto:	uncovered
cerca.:	fence.
apremio:	pressure
metida:	stuck up
demasiado.:	too much.
oscuramente:	darkly
unidad:	unit
combates:	fighting
etnógrafo:	ethnographer
«Este:	"It is
aparecer:	to appear
inteligente:	intelligent
crótalo:	crotalus
numerosos:	numerous
llegará:	will arrive
haciéndosele:	making him
«Hasta:	"Until
castigos:	punishments
hombrecito:	little man
ultimo:	last
latines:	Latin
recuerda:	remember
respondía:	responded
explicaciones.:	explanations.
severamente:	severely
granos.:	grain.
públicas.:	public.
considerar:	consider
comarca:	district
sentado:	sitting
Responsable:	Responsible
portada:	front page
libreta:	notebook
horcón:	pitchfork
enrojecidas:	reddened
desconcertado:	embarrassed
tristes:	sad
ingratos:	ungrateful
contempla:	contemplate
mediodía.:	average.
cayado.:	crook.
espesor:	thickness
hundirme:	inside
rodeaba:	surrounded
contrario:	contrary
humanos:	humans
alimento:	food
firmemente:	firmly
atacar:	attack
bestias:	beasts
hubo:	was
vencedor:	winner
ladridos:	barking
máquina:	machine
—afirma:	—states
«En:	"In
leído:	read
opinión:	opinion
mitologías:	mythologies
volante:	steering wheel
advocación:	dedication
civilizaciones:	civilizations
tuvieron:	they had
esmalte:	enamel
limpios:	clean
escorias:	slag
calcedonias:	chalcedony
arcano:	arcane
—un:	— and
escombros:	debris
filos:	edges
ascendido:	promoted
evasión.:	evasion.
correo.:	mail.
hermana:	sister
dañado:	damaged
enojo.:	anger.
ausente:	absent
pertenecen.:	they belong.
acusadora:	accuser
funeraria:	mortuary
éstas:	are
fabricación:	manufacturing
líneas:	lines
figuración:	figuration
zafarme:	get away
singulares:	singular
escalas:	scales
útil:	useful
oficio.:	job.
código:	code
constantemente:	constantly
práctica:	practice
él;:	he;
hipótesis:	hypothesis
llegaron:	they arrived
ésos:	those
dijeron:	they said
tesis:	thesis
confirma:	confirm
nacimiento:	birth
animales.:	animals.
galope:	gallop
debida:	due
representación:	representation
plástica:	plastic
ingeniosa:	ingenious
prehistórico:	prehistoric
situarse:	situate oneself
especulaciones:	speculations
vanas:	old
teoría:	theory
físico:	physical
encuentran:	find
irritación:	irritation
bancos:	banks
alegría.:	happiness.
estará:	will be
entera:	whole
claridades:	clarities
quedo:	stay
ahora—:	now-
entrañablemente:	endearingly
conocido.:	acquaintance.
nacida:	born
comprendido:	understood
ceniza:	ash
vengo:	come
aprender:	learn
tomado:	taken
traje:	lasts
cueros:	leathers
mármol.:	marble.
añoranza:	yearning
columna:	column
conservan:	preserve
franja:	fringe
brisa:	breeze
limpia:	clean
fingimiento:	pretense
árbol.:	tree.
disputan:	they dispute
vegetaciones:	vegetations
escala:	scale
contemplo:	I contemplate
ocultarse:	hide
brumas:	mists
refleja:	reflects
demoran:	delay
redonda:	round
menester:	need
Noés:	Noah
«Ya:	«Yes
yerbas.:	herbs.
desconocidas:	unknown
regiones:	regions
consideraba:	considered
patraña:	humbug
—por:	-by
patas.:	paws.
enseñado:	taught
narrarle:	narrate
—cuenta:	-account
andamiaje:	scaffolding
cantos:	songs
destinos:	destinations
creado.:	created.
sobresaltos:	shocks
consideran:	consider
circunda:	surrounds
empeños:	pawns
auténticas:	authentic
sobrellevar:	endure
hambruna:	famine
inundación:	flood
nacieron:	were born
orquídeas:	orchids
polvo:	dust
inventar:	inventory
semillas:	seeds
rodean.:	surround.
trabajos:	jobs
vías:	ways
asentada:	seated
rencores:	grudges
bombonas:	candy
yacimientos:	deposits
rumbo.:	course.
llaga:	sore
examinando:	examining
habitaciones:	rooms
llave:	key
llegan:	they arrive
podridas:	rotten
recetas:	recipes
enfermo:	sick
adolescente:	adolescent
crecidas:	floods
canta:	sing
cura:	treatment
viejos.:	old
caserío:	hamlet
fardo:	burden
impide:	prevents
interrogaciones:	interrogations
«Así:	"So
llamaba:	called
vecindario:	neighborhood
cerdos:	pigs
inicia:	starts
cercado:	surrounded
granos:	grain
tenemos:	have
«Esta:	"This
voz::	voice:
construcción:	construction
limpiado:	cleaned
Venados.:	Deer.
portento:	portent
laberintos:	labyrinths
podrían:	could
Época:	Era
mapas:	maps
Fundador:	Founder
proseguimos:	we continue
tiende:	tends
teniendo:	having
conocedor:	connoisseur
borrando:	erasing
compartir:	share
despide:	say goodbye
señalando:	pointing
incienso:	incense
comenzara:	will begin
Génesis:	Genesis
apartarse:	depart
helechos:	ferns
legado:	legacy
cargan:	they load
arrojados:	thrown
llenan:	fill
helados:	ice cream
holladas:	trampled
vírgenes:	virgins
espumas:	foams
cornisa:	cornice
arabesco:	arabesque
creado:	created
terraza:	terrace
farallón:	cliff
adorna:	adorns
meseta:	plateau
ahondan:	they delve
parados:	stopped
cuarzo:	quartz
cristales:	crystals
bronce:	bronze
inmensos:	immense
vejez:	old age
pudieran:	could
elementalidad:	elementality
grandiosa:	great
reducidas:	reduced
desnuda:	naked
peldaño:	step
compás:	compass
salto:	jump
Historia:	History
Hace:	Does
dejándome:	leaving me
ensalmador:	salamander
Palabra:	Word
presa:	taken
horrenda:	horrible
sustraerme:	steal away
hombre—.:	man-.
potencias:	powers
profunda:	deep
desgarrado:	torn
encara:	still
vocalización:	vocalization
jadeo:	panting
ronquido:	snore
embrión:	embryo
llegando:	arriving
repiten:	they repeat
gaznate:	fizzy
increpa:	rebukes
ensalmo:	I praise
mandatarios:	representatives
hinchado:	swollen
respetar:	respect
miran:	another
empreñadas:	engaged
hembras:	females
preparándose:	getting ready
principio:	principle
Dios.:	God.
estuviese:	was
hoyos:	holes
aullidos:	howls
buitres:	vultures
roer:	stir
sepan:	know
último.:	last.
vértigo:	vertigo
Siento:	I feel
legítima:	legitimate
movido:	moved
Tal:	Of
anatómicas:	anatomical
asomarme:	look out
coincidencia:	coincidence
admitiendo:	admitting
Contemplo:	I contemplate
perros.:	dogs.
uñas:	nails
gusanos:	worms
tragan:	swallow
devoran:	devour
comiendo:	eating
energía:	energy
pecado:	sin
desnudas:	naked
órganos:	organs
ocultar:	disguise
ubres:	udders
Esos:	Those
retroceder:	back
entrar:	to enter
paralelas:	parallel
atardecer:	sunset
atónito:	amazed
dilatación:	dilatation
hora—:	time—
preocupa:	worries
—ahora:	-now
tuviese:	had
Muy:	Very
preguntar:	ask
lleve:	carry
mujeres»:	women"
expresiones:	expressions
simplificación:	simplification
fragor:	roar
esposa.:	wife.
reiteración:	reiteration
refiriéndose:	referring
humano.:	human.
atravesar:	cross
particularmente:	particularly
preocupación:	worry
fatiga:	fatigue
temo:	theme
acompasado:	rhythmic
leve:	live
maravillado:	amazed
vean:	see
gineceo:	gynoecium
imaginan:	imagine
atribuyen:	attribute
cuidando:	caring
confió:	trusted
ignorantes:	ignorant
forasteros:	outsiders
intrusos:	intruders
hueso.:	bone.
técnicas:	techniques
Quienes:	Who
necesitado:	needy
fijar:	set
inventó:	invention
alcanzamos:	we reach
crecer:	grow
Anunciación.:	Annunciation.
Cero:	Zero
Año:	Year
cayeron:	they fell
relumbre:	glare
cifras:	figures
devolviendo:	returning
calendarios:	calendars
perdiendo:	losing
seguían:	they followed
conocía:	knew
bálsamos:	balms
plectro:	plectrum
bailar:	dance
Conocía:	I knew
tetas:	tits
soñar:	dream
hijos:	children
parroquia:	parish
viajan:	they travel
Caballo:	Horse
Aguinaldos:	bonuses
pelear:	fight
tenazas:	tongs
pasando:	passing
puertas:	doors
antes.:	before.
llegándose:	arriving
Acaso:	Chance
detiene:	stops
nostri.:	our.
siglos.:	ages.
misas:	masses
ninguna:	none
ídolos:	idols
adoradores:	worshipers
catedrales:	cathedrals
subterráneos:	underground
solemnidad:	solemnity
dolorosa:	painful
barcas:	boats
mí::	my:
volvió:	came back
pasó:	passed
mirada.:	look.
situaba:	situated
Cáliz:	Chalice
herrumbres:	rust
litúrgicos:	liturgical
raído:	raido
colgaba:	hung
saliendo:	leaving
entrando:	entering
contrapunto:	counterpoint
medida.:	measure.
confiado:	confident
excepcional:	exceptional
deleitosamente:	delightfully
alcanzado:	reached
pusieron:	they put
resonancia:	resonance
desagradable:	disgusting
gravedad:	gravity
órgano.:	organ.
Ahí:	There
emplumada:	feathered
ornamentado:	ornate
cilindro:	cylinder
puse:	side
colección:	collection
viaje::	journey:
llamándome:	calling me
dirigía:	directed
caderas:	hips
fuertes:	strong
severa:	severe
mozos:	guys
humano:	human
fibras:	fibers
éste:	this
necesarias:	necessary
situados:	situated
Aquellos:	Those
ocupaciones:	occupations
impresión:	impression
aclarar:	clarify
pasadas:	passed
mías.:	mine
ancianas:	old women
pezones:	nipples
negras.:	black.
agobiado:	overwhelmed
Casi:	Almost
geológica:	geological
aceptando:	accepting
desconcertante:	disconcerting
destinados:	intended
hilos:	threads
barridos:	swept
campanarios:	bell towers
gótica:	gothic
miraba:	looked
pintores:	painters
irse:	go
detuve:	I stopped
salí:	I went out
dormido:	asleep
Nuestras:	Our
semilla:	seed
maceración:	maceration
pesca:	fishing
flechas:	arrows
moriche:	in chili
guayuco:	hang on co
remedio.:	remedy.
—del:	-of the
tragar:	swallow
despierto:	awake
dejarlo:	leave it
cantan:	they sing
impedir:	prevent
peligroso:	dangerous
relámpagos:	lightning
dibujadas:	drawn
colmo:	full
espuma:	foam
agarrar:	grab
saltando:	jumping
peñas:	rocks
escapar:	escape
metiendo:	putting
caiga:	fall
peligros.:	dangers.
termina:	ends
estalla:	explodes
trabado:	stuck
hayamos:	let's have
parte.:	part.
vertiente:	slope
paisajes:	landscapes
anunciadores:	announcers
riberas:	banks
vemos:	we see
interrumpe:	interrupts
oculta:	hidden
percata:	notice
comienza:	starts
mercaderes:	merchants
decires:	you say
queriendo:	wanting
«La:	"The
oficiante:	officiant
humildad:	modesty
exige:	demands
demostrarme:	show me
socarronamente:	slyly
fangoso.:	muddy.
reconocer:	recognize
hubiésemos:	we would have
ánfora:	amphora
alturas:	heights
tremendas:	tremendous
dibujaban:	they drew
rectas:	straight
capítulos:	chapters
encarnado:	red
gorro:	cap
espanto:	astonishment
mentían:	they lied
mentía:	lied
alzaban:	raised
frutas:	fruits
madurez:	maturity
detenerse:	stop
curiaras.:	would you like
vegetales:	vegetables
falso:	false
trampa:	trap
mentira:	lie
plomo:	lead
coladas:	glued
falena:	moth
anegada:	flooded
poniendo:	putting
ocultaba:	hid
corriendo:	in a hurry
termes:	terms
vientos:	winds
Entonces:	So
inmóvil:	still
revelando:	revealing
tomando:	taking
líquenes:	lichens
encajes:	lace
colgaban:	they hung
sorbido:	sordid
palmeras:	palm trees
especies:	species
arrojaban:	they threw
guacamayos:	macaws
ramazón:	branch
garzón:	waiter
lagunatos:	lagoons
intríngulis:	intrigued
trabada:	stuck
légamo:	let's go
casada:	married
oportunidades:	opportunities
inicio:	start
espectros:	spectra
Habrá:	There will be
envuelve:	wraps
inexploradas:	unexplored
Prueba.:	Proof.
comprendí:	I understood
capitular:	capitulate
amenazas:	threats
nerviosa:	nervous
expectación:	expectation
aturdido:	stunned
entera.:	whole.
cubrir:	cover
grillos:	irons
caño.:	spout.
reír:	laugh
rompió:	broke
sustos:	scares
ranas:	frogs
hamaca.:	hammock.
atroz:	atrocious
resonaba:	resonated
enjambres:	swarms
caimán:	caiman
partes.:	parties.
desembocamos:	we flow
semblantes:	countenances
restos:	remains
avispas:	wasps
enredados:	tangled
abrían:	they opened
telarañas:	cobwebs
canoa.:	canoe.
sienes:	temples
hueco:	gap
preso:	taken 
morada:	household
resultaba:	it turned out
desconcierto:	bewilderment
crecía:	grew
espejismos:	mirages
cerrados:	closed
ángulos:	angles
maderos:	lumber
anegado.:	waterlogged.
hojarasca:	leaf litter
troneras:	enthroned
perdía:	lost
parecido:	similar
producía:	produced
frondas:	fronds
rayos:	good heavens
verdor:	greenery
quebradas:	ravines
transparentes:	transparent
chinches:	bed bugs
vinagre:	vinegar
lodo:	official
grisáceos:	grayish
barbudos:	bearded
erizados:	bristling
detenidas:	detained
opalescentes:	opalescent
indecisa:	undecided
rojizo:	reddish
barniz:	varnish
sucias:	dirty
ocre:	ocher
agujereadas:	perforated
mecían:	rocked
alud:	avalanche
polvos:	powder
horruras:	horrors
simientes:	seeds
limalla:	with slime
plancton:	plankton
llovía:	it was raining
cuello.:	neck.
sacándome:	taking me out
increíble:	incredible
barreras:	barriers
obstáculos:	obstacles
embarcación:	vessel
abovedado:	vaulted
pasadizo:	anecdote
abría:	opened
infinito:	infinite
sirviendo:	serving
penetraba:	penetrated
verticalmente:	vertically
superpuestas:	overlapping
despierta:	wake up
balanceo:	swinging
despacio:	slowly
atención.:	attention.
lindero:	boundary
absolutamente:	absolutely
hunde:	dogs
doce:	sweet
habituado:	accustomed
bragas:	panties
tomada:	outlet
Utre.:	Tomorrow
capellán:	chaplain
pueril:	childish
dominada:	dominated
gramíneas:	grasses
tupida:	bushy
geometrías:	geometries
(Tarde:	(Afternoon
caras.:	guys.
acurrucados:	snuggled
tradición:	tradition
soltar:	release
arrojo:	daring
Vivimos:	we live
cobrado:	charged
sílabas:	syllables
oírnos.:	eloquent
implica:	implies
precisan:	they need
torpezas:	clumsiness
conocimos:	we met
ladra:	thief
festín:	feast
terminado:	finished
tradiciones:	traditions
viejas:	old
estrofa:	stanza
suele:	usually
encender:	light
ademán:	gesture
asombrado:	amazed
Creo:	Believe
extraño:	strange
colgado:	hanging
concluye:	concludes
Dicen:	They say
miseria:	misery
flancos:	flanks
llamada:	call
afición:	hubby
parecida:	similar
Micenas:	Mycenae
abandonó:	abandonment
caracteres:	characters
enseñaron:	they taught
duro:	stand
leyendo:	reading
enfrente:	opposite
humedad.:	humidity.
Caño:	Spout
viéndose:	seeing each other
Seguro:	Insurance
arriba.:	above.
recoge:	collect
hereje:	heretic
casado:	married
entender:	to understand
iniciales:	initials
tengamos:	we have
creando:	creating
atenta:	attentive
paños:	cloths
conmigo.:	with me.
botánico:	botanical
prestancia:	presence
continencia:	continence
solicitud:	application
cuchillos:	knives
útiles:	useful
trueques:	barter
sigo:	I continue
haciéndola:	doing it
inconsciente:	unconscious
llorosa:	tearful
próximo:	next
maravilla:	wonder
amantes:	lovers
concertada:	concerted
despachado:	dispatched
Hemos:	We have
encontraron.:	they found.
confluencia:	confluence
vellón:	fleece
distinto.:	distinct.
Somos:	We are
aullando:	howling
estertora:	death rattle
afinca:	affina
hacerla:	do it
Gorgona:	Gorgon
sardónica:	sardonic
sube:	go up
quebrarse:	break
ternura:	tenderness
abrazo:	hug
sonrisa:	smile
pálpito:	palpito
sembraba:	sowed
éramos:	we were
así—:	So-
repentina:	sudden
Agarro:	Grab
llego:	arrive
epíteto:	epithet
subleva:	revolt
alabanzas:	praise
reto:	challenge
baño:	bathroom
estera:	foreign
respira:	breathe
suspira:	sigh
abrazo.:	hug.
reflejarse:	reflect
cumplir:	achieve
avergonzado:	ashamed
vacías:	empty
mío;:	mine;
comido:	eaten
clásicos:	classics
constantes:	constants
obligaba:	forced
proceder:	proceed
rectitud:	rectitude
padres:	parents
otros.:	others.
ejemplar:	copy
derrota:	defeat
asombraba:	astonished
soportar:	endure
picada:	chopped
estúpidamente:	stupidly
posibles:	possible
fronteras:	borders
enferma:	sick
comprimidos:	pills
estremecida:	extremecidal
inconsciencia:	unconsciousness
fiebre.:	fever.
comenzó:	began
pausado:	slow
reflexiones:	reflections
bíblico:	biblical
sentencioso:	sententious
insinuante:	insinuating
atribuir:	assign
miraban.:	they looked
sonaban:	they sounded
dándose:	giving
olla:	be
pescados:	fish
demasiada:	too much
ceño:	frown
malestar:	discomfort
silenciosa:	silent
calmada:	calm
regresé:	I came back
retornos:	returns
llegara:	will arrive
convivencia:	coexistence
ajena.:	foreign
oportuna:	timely
dureza:	hardness
permanezco:	I remain
gimotea:	gimme
denegación:	denial
Todavía:	Still
ferocidad:	ferocity
insultos:	insults
bárbaramente:	barbarously
refajo:	they're rehashing
pensamos:	we think
Voces:	You
alimañas:	vermin
bañando:	bathing
fango:	mud
pulso:	pulse
cordilleras:	mountain ranges
endeudado:	indebted
miserias:	miseries
margen:	margin
regresando:	returning
profundidad:	depth
gemas:	excited
maravillosa:	wonderful
decepción:	disappointment
antemano:	beforehand
regocijo:	joy
vara:	be
arrojó:	daring
tornaba:	returned
volvieron:	they came back
acercábamos:	we were approaching
tubo:	profit
nombre.:	name.
decir::	say:
ganas:	desire
tuvimos:	we had
devolvió:	returned
erguido:	erected
astrales:	astral
logrado:	accomplished
acantilados:	cliffs
remotos:	remote
pintaba:	painted
gigantescos:	gigantic
dibujos:	drawings
quedarían:	would remain
largas:	long
Muerte.:	Death.
contemplación:	contemplation
pupilas:	pupils
caídos:	fallen
párpados:	eyelids
Maíz.:	Corn.
varones:	men
afirmaba:	claimed
científica:	scientific
aceptada:	accepted
cuentos:	stories
seriedad:	seriousness
frailes:	friars
relaciones:	relations
obligado:	obliged
ciegos:	blind
cantado:	sung
rematadas:	finished
resplandeciente:	resplendent
llevaban:	they carried
heridas:	wounds
cerraban:	they closed
curanderos:	healers
humanas:	human
osamentas:	bones
soldado:	soldier
campesino:	peasant
estampaba:	stamp
castellana:	Spanish
segur:	for sure
rocas.:	rocks.
entradas:	entries
comerse:	eat
mudo:	period
alucinado:	hallucinated
envueltos:	wrapped
testimonios:	testimonials
vetas:	veins
cubren:	cover
escalonamiento:	staggering
orilleros:	edgers
provincia:	province
fantasmal:	ghostly
sorna.:	sarcasm.
sonríe:	smile
bibliotecas:	libraries
lejanas:	distant
palabras.:	words.
cavernas:	caves
cubiertas:	covers
armadura:	armor
parezca:	seem
palabras::	words:
Pasan:	They pass
solidario:	supportive
encerrado:	closed
ninguno:	none
tinieblas.:	darkness.
cimeros:	crests
peldaños:	steps
escalinata:	staircase
brasas.:	embers.
leños:	logs
azules:	blue
Unos:	Some
unidos:	joined
sentados:	sitting
remembranza:	remembrance
ofrecen:	offer
diminuta:	tiny
toscas:	rough
daban:	different
tratados:	treaties
proclamarse:	proclaim oneself
soledades:	loneliness
historias:	stories
entiende:	understand
larguísimos:	very long
índice:	index
llevan:	they carry
proximidad:	proximity
desconocida:	unknown
burla:	derision
vistos:	visas
destina:	intended
agobia:	overwhelms
herborizador:	herbalizer
interesarse:	interest
conocida:	known
selváticos:	jungle
tósigos:	codes
cuantos:	how many
curare:	cure
aventurero:	adventurous
raras.:	rare.
cercana:	close
éstos:	these
inesperado:	unexpected
remedar:	helper
servir:	serve
sostén:	support
anchura:	width
aleros:	eaves
resistencia:	endurance
normas:	norms
dictado:	dictation
construir:	build
cesta:	way
recordaba:	I remembered
suelto:	loose
zumbido:	tinnitus
sapos:	frogs
hecho.:	made.
común.:	common.
capuchino.:	cappuccino.
aspirar:	aspire
antiguo:	ancient
debían:	they had to
abandonada.:	abandoned.
pregunté:	I asked
aclaración:	clarification
latido:	beat
fantástico:	fantastic
guijarros:	shingle
erráticos:	erratic
baldosas:	tiles
erguidas:	erected
dispersión:	dispersion
edades:	ages
perdida:	lost
rectangulares:	rectangular
amontonamientos:	pile-ups
formación:	training
rematada:	finished
empaque:	packing
yacían:	lay
veían:	they saw
antesala:	anteroom
reflejaban:	they reflected
esquivar:	dodge
bordeando:	bordering
caucheros.:	nightmares.
delante:	in front of
locura.:	craziness.
reunió:	meeting
aquiescencia:	acquiescence
suspenso:	suspended
partida.:	match.
Asunción:	Assumption
corta:	short
adelante.:	forward.
etapa:	stage
rutilante:	sparkling
gruta:	cave
podríamos:	we could
boga:	have
impaciente.:	impatient.
decía:	said
raras:	rare
literatura:	literature
empezaba:	started
tragantes:	swallowers
atravesados:	crossed
levantadas:	raised
pavorosa:	terrifying
límite:	limit
llevara:	will carry
atajo:	shortcut
Negras:	Black
obligada:	obligatory
creyó:	believed
maligna:	malignant
contrario::	contrary:
griego.:	Greek.
próxima:	next
percance:	mishap
costumbre:	habit
plácidamente:	placidly
vestidas:	dressed
llevaron:	they carried
fatigas:	fatigue
enervante:	annoying
herraduras:	horseshoes
caballos:	horses
guerreros:	warriors
oreja:	ear
encajados:	embedded
tremebunda:	trembling
reciente:	recent
prostituta:	prostitute
rogativas:	prayers
diario:	diary
funcionarios:	officials
población:	population
cotidiana:	everyday
agobiados:	overwhelmed
poderes:	powers
pelos:	by the
mide:	stomach
cuelgan:	they hang
vestido:	dress
azada:	hoe
Oficios:	Offices
atraviesa:	goes through
éxodo:	Exodus
primitivas:	primitive
espolones:	dewclaws
contrafuertes:	buttresses
volúmenes:	volumes
cincel:	chisel
tosco:	Tuscan
cementerio:	cemetery
vencido:	won
invadido:	invaded
(Sábado:	(Saturday
vecinos:	neighbors
ciudades.:	cities.
manadas:	herds
narradas:	narrated
enrojecida:	flushed
viese:	see
región:	region
historia.:	history.
cataclismo:	cataclysm
inmensa:	immense
estriadas:	striated
amaranto:	amaranth
Eran:	Were
techos:	roofs
llover:	rain
comenzaron:	they started
estuvo:	was
abriéndose:	opening
polen:	Poland
cenizas:	ashes
dieron:	they gave
Poco:	Bit
lágrimas:	tears
ratos:	rats
vecindad:	neighborhood
apetecer:	feel like
asunto:	affair
apoyados:	supported
alcanzaba:	reached
desprendía:	gave off
acercando:	approaching
transformado:	transformed
muslos:	thighs
subir:	rise
humores:	moods
ascensión:	rise
cruzar:	cross
disgusto:	disgust
habló:	speak
Catorce:	Fourteen
aliviada:	relieved
teñido:	had
atareada:	such
fogones:	stoves
ollas:	pans
tinajas:	jars
fijó:	fixed
procede:	proceed
repentinamente:	suddenly
necesitaba:	I needed
Iba:	Different
recitando:	acting
respondí:	I responded
singularmente:	singularly
Buscador:	Seeker
alcanzaban:	they reached
usados:	used
negocios:	business
gente—:	people-
mezquina:	petty
exigencias:	demands
Orilla:	Bank
monedas:	coins
milenario:	millennial
cumplían:	they fulfilled
pliegue:	fold
reino:	kingdom
observado:	observed
observó:	noticed
sospechar:	suspect
preparando:	preparing
apareciendo:	appearing
desesperación:	despair
arrojadas:	thrown
velos:	fleeces
diapasón:	diapason
Muerte:	Death
mágica:	magic
conminatoria:	injunction
protesta:	protest
remoto.:	remote.
difuntos:	deceased
vestir:	dress
infancia:	childhood
tareas:	tasks
presencia.:	presence.
Madres:	Mothers
corriente.:	current.
numerosas:	numerous
familias:	families
causaron:	caused
gastado:	spent
zapatos:	shoes
Juicio:	Judgment
desgracias:	misfortunes
profundidades:	depths
misterioso:	mysterious
apartarla:	put it away
estertores:	death rales
entrecortada:	choppy
ronca:	snore
herida:	wound
belleza.:	beauty.
pelo:	for the
Toda:	All
habitación.:	room.
agudo:	sharp
tabaco:	tobacco
Pescador:	Fisherman
gravas:	it matters
ménsulas:	mensulas
rosarios:	rosaries
imágenes:	images
rincones:	corners
levantaba:	lifted
tú:	you
bendita:	blessed
eres:	are
obsesionante:	haunting
hablaban:	they spoke
cintas:	ribbons
apretados:	tight
pesados:	heavy
surgían:	arose
moraban:	they dwelt
Carpintero:	Carpenter
plateados:	silver
martillazos:	hammer blows
resonante:	resonant
anchos:	wide
encendiendo:	lighting
ordenando:	ordering
(Noche:	(Evening
absurdo::	absurd:
población.:	population.
velorio:	wake
corrían:	they ran
calles:	streets
esquina:	corner
encaminé:	I headed
llegada:	arrival
brusquedad:	suddenness
morir.:	to die
estábamos:	we were
cuerno:	horn
trompas:	deceives
afinadas:	in tune
Pintado:	Painted
necesita:	needs
marca:	mark
diciembre):	December)
Cabellera:	Hair
andando:	going
descansar:	rest
destinadas:	intended
busco:	I'm looking for
Alzo:	I get up
bóvedas:	vaults
colectivo:	collective
debilidad:	weakness
aspecto:	aspect
autor:	author
periodista:	journalist
Parece:	It seems
conyugal:	conjugal
abraza:	hug
Tengo:	Have
mentiras:	lies
suma:	addition
velado:	veiled
ignoran:	they ignore
hallarse:	be
iniciar:	start
vitrinas:	showcases
dejé:	I left
llamáis:	you call
acuesto:	I lie down
estrépito:	crash
divorcio.:	divorce.
esfuerzo:	effort
destino.:	destination.
vocación:	vocation
tinta.:	ink.
admito:	I admit
Hago:	Do
beber:	to drink
minutos:	minutes
cuarto:	room
decirme:	tell me
esto.:	this.
señaló:	pointed out
rebozo:	shawl
diálogo:	dialogue
salidos:	exited
admitir:	admit
rodillas:	knees
encontró:	found
pintado:	painted
nociones:	notions
lápiz:	pencil
lugares:	places
evasión:	evasion
vanidad:	vanity
situación:	situation
verla:	see it
gravidez:	pregnancy
pasaron:	bird
libertad:	freedom
abierta:	open
ridículo:	ridiculous
edificante:	edifying
pueden:	they can
empiezan:	they start
papeles:	papers
venidos:	come
Todas:	All
casos:	cases
dolor.:	pain.
respiración:	breathing
prisa:	hurry
asegurar:	ensure
puntos:	points
llenado:	fill
episodio:	episode
pasajes:	tickets
Vuelvo:	I'm back
propiciatorio.:	propitiatory.
estilo:	style
Brabante:	Brabant
aullan:	howl
vida.:	life.
añadiendo:	adding
ancianos:	seniors
Aún:	Still
melismático:	melismatic
pureza:	Preza
dibujo:	drawing
Aquello:	That
corifeo:	coryphean
posibilidades:	possibilities
Treno.:	Train.
esbozos:	sketches
oscuridad:	darkness
fórmulas:	formulas
curiosidad:	curiosity
partitura:	score
lógica:	logic
haberle:	have him
tratando:	treating
efectos:	effects
inútil:	useless
armado:	armed
grasas:	fats
afirma:	states
marcha:	march
pereza:	laziness
voz.:	voice.
buscador:	seeker
—si:	-and
sabido:	known
señalado:	indicated
trabajo:	job
comunidad:	community
acuerdos:	agreements
Indios:	Indians
Capitán:	Captain
señala:	points out
dejaron:	they left
regresado:	returned
sordo:	deaf
llegó:	arrive
demiurgo:	demiurge
amenaza:	threat
dificultad:	difficulty
dios:	God
inquieto:	restless
conduce:	lead
descender:	descend
solución:	solution
cabecera:	head
esteras:	mats
quebrado:	broken
ellas:	they
recoger:	collect
treno:	train
mágico:	magical
prácticas:	practices
Veo:	I see
abrir:	open
amarla:	love her
renuncia:	resignation
quiera:	want
medido:	measured
edificación:	building
decisión:	decision
cubre:	covers
bulle:	bulls
atando:	tying
Noé:	Noah
Diluvio:	Flood
pienso:	I think
usando:	using
indudable:	doubtless
fieras:	beasts
enfermedades:	diseases
Terrenal:	Earthly
Paraíso:	Paradise
interesa:	interest
abandonado:	abandoned
percutiente:	striking
revelar:	reveal
frascos:	jars
encierran:	enclose
descansan:	they rest
hallaron:	they found
misiones:	missions
duermen:	they sleep
halló:	found
Tierras:	Land
tinta:	ink
título:	title
llamo:	called
peligros:	dangers
advierte:	warns
recibir:	receive
acuden:	they come
También:	Also
almacén:	store
viviendas:	housing
curso:	course
Henoch:	Enoch
llevando:	carrying
traerá:	will bring
haberse:	have
tristeza:	sadness
cimas:	tops
últimas:	latest
ecos:	echoes
amarillas:	yellow
presenta:	presents
palmos:	spans
guardar:	keep
rodeado:	surrounded
subterráneo:	underground
confusa:	confused
Hechicero:	Sorcerer
horas.:	hours.
presión:	pressure
cubiertos:	covered
bocas:	mouths
horribles:	horrible
inutilidad:	futility
anteriores:	previous
andan:	from the moment
Adán:	Adam
Génesis.:	Genesis.
disposición:	provision
resulta:	result
«el:	"he
recompensa:	reward
salud:	health
comarcas:	regions
creen:	believe
Adelantado.:	Advanced.
desaforada:	unbridled
viajar:	travel
Que:	What
prestos:	ready
Conquista:	Conquest
Libros:	Books
contemplando:	contemplating
tus:	the
«Hijo:	"Son
actitud:	attitude
jefe:	boss
distinta:	different
ornamentos:	ornaments
mío.:	mine.
sonido:	sound
juegos:	games
sonajeras:	rattles
Pensando:	Thinking
años.:	years.
perfiles:	profiles
vientres:	bellies
común:	common
relatos:	reports
sometida:	subdued
concierto:	concert
propios:	own
Comprendí:	I understood
rodeada:	surrounded
madres:	mothers
grandeza:	greatness
familia:	family
interpretación:	interpretation
órgano:	organ
nieblas:	fogs
prohibido:	forbidden
suelo.:	floor.
embriaguez:	drunkenness
caza:	hunting
llaman:	they call
aldea:	village
duermo:	I sleep
acorde:	chord
tormenta:	storm
puedan:	can
nacido:	born
dejo:	let
incapaz:	unable
pluralidad:	plurality
silueta:	silhouette
viento:	wind
peso:	weight
acrece:	increases
torrentes:	torrents
costado:	side
excluye:	excludes
cumple:	meets
hubiese:	would have
malos:	bad
ejemplos:	examples
Creación:	Creation
acabará:	will end
atribuye:	attributes
detenido:	arrested
separación:	separation
hechas:	made
Tampoco:	Neither
prodigiosa:	prodigious
hundía:	sank
Hasta:	Until
vertiginoso:	vertiginous
palmo:	palm
pensamientos:	thoughts
distinto:	distinct
techumbres:	roofing
Mundo:	World
azufre:	sulfur
inmóviles:	motionless
caños:	pipes
yacer:	lie
abajo.:	below.
musgos:	mosses
garzas:	herons
mármol:	marble
cauce:	channel
llenas:	full
retroceso:	recoil
nocturnos:	nocturnal
vieron:	they saw
propias:	own
copas:	glasses
colores:	colors
dueño:	owner
transforma:	transform
entendimiento:	understanding
igualmente:	also
remanso:	backwater
llevado:	carried
temor:	fear
cobre:	copper
dónde:	where
Alguien:	Someone
Tenía:	Had
distancia:	distance
laja:	intervene
estanque:	pond
embate:	clash
arañas:	spiders
trataba:	tried
crepúsculo.:	dusk.
miedo.:	fear.
salidas:	Departures
suelo;:	floor;
ojos.:	eyes.
extraviados:	lost
atravesado:	crossed
moscas:	flies
eterno:	eternal
dejaban:	they left
socavones:	sinkholes
Entre:	Between
hacían:	they did
encendían:	they lit
perenne:	perennial
puntiagudo:	pointed
letras:	lyrics
adonde:	where to
valladar:	fence
confesión:	confession
bambúes:	bamboos
bejucos:	vines
CAPITULO:	CHAPTER
bordas:	edges
desciende:	descends
impar:	odd
incluye:	includes
aquellas:	those
cubierto:	covered
canoas:	canoes
Dos:	Of the
tremendamente:	tremendously
vienen:	they come
sueña:	sounds
inútiles:	useless
dejó:	let
ignorar:	ignore
países:	countries
oscura:	dark
página:	page
buscan:	search
tránsitos:	transits
largos:	long
moteadas:	speckled
consigo:	with you
hato:	there
acerco:	approach
dándome:	giving me
hembra:	female
condición:	condition
reposo:	repose
excusa:	excuse
irónica:	ironic
cerrando:	closing
sucios:	dirty
creer:	believe
importa:	matter
olvidados:	forgotten
rodado:	wheeled
buscamos:	we seek
apremio.:	pressure.
volvemos:	we return
rápido:	fast
entregado:	delivered
canteros:	stonemasons
guarda:	guard
cariño:	dear
hábil:	skillful
pájaro:	bird
aproxima:	approaches
explicación:	explanation
muere:	die
mañana.:	tomorrow.
llevarse:	take away
tendría:	would have
dignidad:	dignity
renunciar:	give up
marido:	husband
trágica:	tragic
escenario:	scenery
estimación:	estimate
sacado:	taken
divertido:	fun
cercanía:	closeness
desconocido:	a stranger
quedé:	I stayed
paludismo:	malaria
andanzas:	wanderings
experiencia:	experience
furia:	rage
reacción:	reaction
dientes:	teeth
jicaras:	jikaras
carroña:	carrion
víspera:	eve
vínculo:	bond
viendo:	seeing
inhabitual:	unusual
diciendo:	saying
rompe:	breaks
motivo:	reason
ignora:	ignore
preguntas:	questions
farmacia:	pharmacy
exasperante:	infuriating
Está:	This
suelta:	loose
empellón:	shove
huyendo:	fleeing
ropa:	clothes
Pregunto:	Asked
hallazgo:	find
cavado:	dug
seguramente:	surely
caverna:	cave
serpiente:	snake
petroglifos:	petroglyphs
millares:	thousands
planeta:	planet
imagen:	image
hubiesen:	they would have
pinturas:	paintings
migración:	migration
Reino:	Kingdom
soldados:	soldiers
Durante:	During
relato:	report
Hidra:	Hydra
aparecían:	appeared
ponía:	put
alzando:	raising
fecha:	date
ennegrecido:	blackened
muralla:	wall
esqueleto:	skeleton
girar:	spin
llamados:	called
inmediato:	immediate
centenares:	hundreds
precioso:	precious
extrañas:	strange
inmenso:	immense
telúrica:	telluric
laboratorio:	laboratory
escucha:	listen
Habla:	Speaks
encienden:	turn on
Herborizador:	Herbalizer
estrellas:	stars
ancha:	much
queja:	complaint
renacer:	be reborn
Polifemo:	Polyphemus
arrodillado:	kneeling
alboroto:	riot
espesura:	thickness
cobran:	they charge
herbarios:	herbal
quinina:	quinine
aquí.:	here.
pretende:	intend
colecciones:	collections
conozco:	know
virtud:	virtue
hoja:	move
fibra:	fiber
sirven:	serve
deleitosa:	delightful
acunado:	cradled
regazo:	lap
enojado:	angry
ocurrir:	occur
bastaba:	it was enough
dejados:	left
puñados:	handfuls
creada:	created
conocidos:	acquaintances
inmovilidad:	immobility
templos:	temples
monolitos:	monoliths
árboles.:	trees.
gigantesca:	gigantic
saurios:	saurians
bloques:	blocks
permanecer:	remain
mayores:	older
señalaba:	pointed out
primitivo:	primitive
miré:	Look
nosotros.:	us.
grato:	grateful
sumamente:	extremely
abandonar:	abandon
imagino:	I imagine
trecho:	excerpt
aprovechar:	leverage
parecer:	opinion
discurso:	speech
salvajes:	wild
espectáculo:	show
despecho:	spite
angosto:	narrow
raudal:	torrent
explicar:	explain
desafiante:	challenging
seguida:	followed
viviendo:	living
encontraba:	found
albergue:	hostel
momentos:	moments
hagiografía:	hagiography
leyendas:	legends
problemas:	problems
presentes:	gifts
cobraban:	they charged
pegado:	glued
tramo:	section
cañas:	white hair
rodeados:	surrounded
Dentro:	Within
bajos:	bass
maleza:	evil
migraciones:	migrations
rincón:	corner
haría:	would
novedad:	novelty
vertiginosa:	vertiginous
miríadas:	myriads
salimos:	we go out
amante.:	lover.
dejaba:	left
voces.:	you.
catedral:	cathedral
estrecha:	narrow
olvidada:	forgotten
sentí:	I felt
cintura:	waist
bordes:	edges
codos:	elbows
fiebre:	fever
salvar:	save
explicó:	explained
leña:	firewood
mujeres.:	women.
cumplido:	compliment
fríos:	cold
ponen:	they put
burlar:	cheat
imposibles:	impossible
efecto:	effect
realmente:	really
derecha:	right
nueve:	nine
menudo:	slight
luto:	cooked
pensé:	think
rotas:	routes
vestidos:	dresses
abrazó:	hug
llanto:	crying
sobrecogedora:	overwhelming
apretado:	tight
vestida:	dressed
acababan:	they finished
hicieran:	they did
olas:	eggs
repetición:	repetition
lirios:	lilies
traídos:	brought
mordidos:	bitten
terciopelos:	velvets
viejos:	old
profundos:	deep
vastas:	answered
cirios:	candles
pompas:	pomp
muerte.:	death.
trabajando:	working
ventanas:	windows
Porvenir.:	Future.
Recuerdos:	Memories
enseña:	teaches
deleite:	treat
probar:	prove
sabor:	flavor
cráneo:	skull
tambores:	drums
tocara:	will touch
licor:	liqueur
llega:	arrives
prensa:	press
ciento:	hundred
fusil:	gun
crece:	grows
atrás.:	back.
compañero:	buddy
Curador.:	Curator.
apuntes:	notes
aturdimiento:	daze
tanta:	so much
hará:	will do
escribir.:	write.
componer:	compose
adolescencia:	adolescence
escena:	scene
terreno:	land
distancias:	distances
público:	public
acentos:	accents
melodía:	melody
composición:	composition
quise:	I wanted
claro:	Of course
elementos:	elements
torna:	returns
pensar.:	think.
Perteneciente:	Belonging
de...:	of...
pregunto:	asked
quedado:	left
interés:	interest
Cuaderno:	Notebook
suprema:	supreme
mazorcas:	cobs
marcado:	marked
proceso:	process
hondamente:	deeply
capítulo:	chapter
estudio:	study
preciso:	necessary
empeñado:	pawned
tema:	him
podía:	could
querido:	darling
pudo:	could
ausencia:	absence
paredón:	wall
siguen:	they continue
viven:	they live
haga:	do
contorno:	contour
tuve:	I had
música.:	music.
acepta:	accept
ésta:	this
Gobierno:	Government
detengo:	I stop
crear:	create
posee:	owns
cazador:	hunter
enunciado:	statement
tratar:	treat
situado:	situated
dedo:	finger
planchas:	irons
huesos:	bones
recursos:	resources
Apenas:	Just
larvas:	larvae
cultura:	culture
Este:	It is
más.:	further.
tercera:	third
oscuro:	dark
días.:	days.
arranca:	starts
seguro:	insurance
fechas:	dates
funciones:	functions
Edad:	Age
asentado:	settled
quisiera:	I'd like
pensaba:	thought
deber:	duty
extraños:	strangers
desarrollo:	development
arrugado:	wrinkled
ajeno:	unaffiliated
fueran:	were
buscaba:	I was looking for
metidos:	stuck up
habíamos:	we had
espejo:	mirror
tensión:	strain
trueno:	thunder
sinfonía:	symphony
agarra:	grab
sorprendente:	surprising
tremenda:	tremendous
raudales:	rapids
llamar:	call
riendo:	laughing
misionero:	missionary
pregunta:	ask
distintas:	distinct
repente:	suddenly
plumas:	feathers
Sólo:	Only
altura:	height
redondez:	roundness
hervor:	out
alfombra:	rug
penumbras:	shadows
maderas:	woods
Detrás:	Behind
muertas:	dead
naves:	ships
espantos:	frights
milenios:	millennia
milenaria:	millennial
hermoso:	beautiful
orgullo:	pride
Hubo:	Was
—una:	-a
pequeño:	little
vueltas:	turns
pequeños:	small
sucesión:	succession
apariencias:	appearances
abiertas:	open
noción:	notion
cortezas:	crusts
fondos:	funds
corteza:	crust
cerrada:	closed
novela:	novel
vamos:	let's go
amante:	lover
sabores:	flavors
serán:	will be
pareja:	couple
dueños:	owners
abrazamos:	we hug
llevo:	he took
indios.:	Indians.
remeros:	rowers
seguido:	followed
ofrecido:	offered
desnudo:	naked
danta:	interest
tenga:	have
remos:	oars
Océano:	Ocean
manantiales:	springs
capaz:	able
mitos:	myth
acá:	here
confesar:	confess
conversación:	conversation
agujas:	needles
simples:	simple
acaban:	end
cierra:	close
cuelga:	hanging
vuelven:	they come back
echa:	cast
lentamente:	slowly
cabaña:	cabin
entra:	enter
contento:	happy
ansioso:	anxious
viajes:	trips
recuerdan:	remember
secas:	dried
oportunidad:	chance
oigo:	I hear
queda:	is left over
Comprendo:	Understand
hormigas:	ants
ajena:	alien
perder:	lose
fidelidad:	fidelity
época:	era
pocos:	few
trajo:	brought
cuentas:	accounts
silencio.:	silence.
tuviera:	had
Nunca:	Never
firme:	firm
roto:	inside
palabra.:	word.
golpea:	hits
alcanza:	reaches
desnudez:	nakedness
selvas:	jungles
gema:	echo
veinte:	twenty
torrente:	torrent
lecho:	litter
buscadores:	search engines
Todos:	All
figuraciones:	figurations
trazados:	traces
ignorados:	ignored
Dioses:	Gods
afán:	eagerness
podían:	they could
orejas:	ears
misteriosa:	mysterious
olivo:	olive tree
traspasado:	transferred
estupor:	stupor
barbas:	barbs
zona:	area
cascadas:	waterfalls
macizo:	solid
vasta:	only
reflejo:	reflection
fría:	cold
pinta:	surface
erguidos:	erected
cipos:	cipes
húmedas:	wet
hábito:	habit
traen:	they bring
encuentros:	meetings
explica:	explains
cuchillo:	knife
respuesta:	answer
cuento:	tale
somos:	we are
—de:	-of
cabras:	goats
ocurrido:	occurred
vivienda:	dwelling
portentosos:	portentous
día.:	day.
carga:	load
arrojar:	throw
—en:	-in
fui:	I went
sucedido:	happened
obeliscos:	obelisks
geometría:	geometry
arquitectura:	architecture
dejando:	leaving
derribados:	knocked down
Sobre:	On
empuje:	push
pedirle:	ask
asiento:	seat
hallé:	I found
fácil:	easy
oír:	hear
hermanos:	siblings
llenos:	full
creyendo:	believing
posible.:	possible.
—que:	-what
perdón:	sorry
verdadero:	TRUE
volando:	flying
personajes:	characters
luminarias:	luminaries
vigas:	beams
semana:	week
tremendo:	tremendous
continente:	continent
profundo:	deep
rápidamente:	quickly
extraña:	strange
puso:	heart
debió:	should have
tinaja:	jar
Mientras:	While
cerebro:	brain
apacible:	gentle
Parecía:	It seemed
adentro:	inside
hallaba:	found
acercó:	approached
dan:	And
angustia:	distress
mundo.:	world.
portentosa:	portentous
terribles:	terrible
rostros:	faces
venido:	come
sabían:	they knew
sollozos:	sobs
bestia:	beast
cayó:	fell
vivido:	vivid
espejos:	mirrors
colgados:	hung
clavos:	nails
umbrales:	thresholds
Estaba:	Was
seguía:	continued
avellanado:	countersunk
seguidos:	followed
hueso:	bone
flautas:	flutes
primitivos:	primitives
botella:	bottle
divorcio:	divorce
cincuenta:	fifty
todo.:	all.
tratado:	treated
escribir:	write
elemento:	element
significado:	meaning
extraviado:	lost
prosa:	prose
aparición:	appearance
intento:	tried
empezar:	begin
habré:	there will be
tipo:	type
destinado:	intended
Pienso:	I think
creo:	believe
preguntándome:	wondering
mazorca:	cob
allá.:	there.
pesar:	weigh
probablemente:	probably
última:	last
mozo:	guy
extremo:	extreme
fundado:	founded
aleja:	move away
naturales:	natural
vacío:	empty
siete:	seven
dibujado:	drawn
cautivos:	captives
vuelvo:	I'm back
hayan:	have
rumbo:	course
generación:	generation
gentes:	people
comprender:	grasp
matriz:	headquarters
dejar:	leave
existe:	exists
alguno:	some
danzas:	dances
transcurre:	passes
—el:	-he
revelación:	revelation
tempestad:	storm
instrumento:	instrument
planos:	plans
Formas:	Shapes
peligro:	danger
demora:	delay
cuerdas:	ropes
salido:	left
ritmos:	rhythms
consistencia:	consistency
inmensas:	immense
rayo:	ray
lejanías:	distances
enseres:	equipment
gritos:	shouting
empezó:	started
tinieblas:	darkness
cuero:	leather
alcance:	range
conocen:	they know
bajar:	lower
patas:	paws
fuga:	leak
garfios:	hooks
arrojado:	thrown
llevar:	carry
Bajo:	Low
empresa:	enterprise
Conquistadores:	Pathfinders
constante:	constant
júbilo:	jubilation
trata:	treats
abre:	open
destino:	destination
vasto:	vast
peces:	pieces
único:	single
yacimiento:	deposit
sudor:	sweat
da:	and
partida:	match
poca:	little
caída:	drop
caídas:	falls
oídos:	ears
impaciente:	impatient
senos:	old
alivio:	relief
valores:	values
personaje:	character
fuerte:	strong
inesperada:	unexpected
derecho:	right
instinto:	instinct
dudas:	doubts
frío:	cold
siente:	feel
llorar:	cry
podido:	could
Antes:	Before
ayuda:	aid
acercarse:	approach
conocer:	know
hacerlo:	do it
rumbos:	directions
escrito:	written
mirando:	looking
monumentos:	monuments
maravilloso:	marvelous
desorden:	disorder
hombres.:	men.
arrojando:	throwing
Mesetas:	Plateaus
hogar:	home
cantar:	sing
aparece:	appears
amarillo:	yellow
lengua:	language
estamos:	we are
conoce:	know
dicen:	they say
vocablos:	words
noticias:	news
añade:	duck
levantar:	lift
verdadera:	true
hiciera:	did
figura:	figure
dicho:	saying
ligero:	light
fija:	fixed
islas:	islands
distintos:	distinct
revela:	reveals
viaje.:	journey.
cuello:	neck
visión:	vision
importancia:	importance
granito:	granite
alegría:	happiness
estuviera:	was
acabando:	running out
habitación:	room
cabezas:	heads
descanso:	rest
arcos:	bows
aparecen:	appear
humo:	in it
nube:	cloud
impaciencia:	impatience
puesta:	putting
enorme:	huge
concepto:	concept
mismos:	themselves
primero:	first
emprende:	undertake
hombre.:	man.
oscuras:	dark
bastante:	quite
hicieron:	they did
—pues:	-well
hijas:	daughters
Frente:	Forehead
rito:	here
Sus:	Their
plagas:	pests
terciopelo:	velvet
tumba:	grave
labios:	lips
grito:	shout
echar:	throw
rodar:	rotate
te:	the
contemplar:	contemplate
entero:	whole
compañía:	company
apareció:	appeared
gestos:	gestures
llevaba:	wore
ritos:	rites
vivía:	lived
enana:	dwarf
hallado:	found
piloto:	pilot
mía:	tight
abierto:	open
estado:	state
dando:	giving
poema:	poem
signo:	sign
Curador:	Curator
olvidar:	forget
libros:	books
remedios:	remedies
maíz:	corn
cascada:	waterfall
noches:	nights
antiguos:	ancient
conocido:	acquaintance
escritura:	writing
asombro:	astonishment
Si:	And
veía:	saw
rescate:	rescue
jarra:	jug
venado:	deer
musicales:	musicals
dioses:	gods
hamacas:	hammocks
nivel:	level
lados:	sides
comprendo:	understand
nuevos:	new
enojo:	anger
serpientes:	snakes
tierras:	land
pecho:	chest
notas:	notes
hacerme:	make me
Nada:	Nothing
abiertos:	open
blancas:	white
segunda:	second
imposible:	impossible
cuestión:	question
vegetación:	vegetation
posesión:	possession
habrán:	there will be
hallando:	finding
Esta:	This
levanta:	get up
columnas:	columns
montaña:	mountain
atrás:	back
cien:	hundred
libro:	book
crepúsculo:	dusk
venas:	is coming
niños:	children
recordar:	remember
Allá:	There
causa:	cause
única:	unique
cuales:	which
ofrece:	offers
arroja:	throws
futuro:	future
existencia:	existence
sabe:	he knows
mesetas:	plateaus
signos:	signs
Cada:	Each
invención:	invention
aquellos:	those
hallada:	found
morir:	to die
siglo:	century
vuelo:	flight
—la:	-the
imaginación:	imagination
espíritu:	spirit
hombros:	shoulders
razón:	reason
hoguera:	bonfire
lunes:	Monday
nadie:	nobody
nuevas:	new
muestra:	sample
caras:	guys
mío:	mine
cercano:	nearby
insectos:	insects
proa:	bow
partir:	leave
misión:	mission
afirmando:	stating
modos:	modes
esperar:	wait
alcanzar:	reach
encontrado:	found
verme:	don't give
misterio:	mystery
perdido:	lost
hombro:	shoulder
fuese:	was
Así:	So
espesa:	thick
pequeñas:	small
mariposas:	butterflies
lleno:	full
mirada:	look
término:	term
poner:	put
siquiera:	even
saben:	per
olvidado:	forgotten
espesas:	thick
violencia:	violence
hermanas:	sisters
hablaba:	spoke
garganta:	throat
pareció:	it seemed
Dios:	God
hongos:	fungus
joven:	young
eso:	that
jornadas:	days
orquesta:	orchestra
ruido:	noise
orden:	order
tomar:	take
prueba:	proof
falta:	lack
sentir:	to feel
mente:	mind
obras:	works
caer:	fall
Estoy:	I'm
acabo:	just
deben:	they must
ambos:	both
estos:	these
oficios:	crafts
sexo:	sex
sigue:	go on
Mesetas.:	Plateaus.
poder:	can
mediodía:	average
celo:	even
ocurre:	occurs
país:	country
manera:	manner
confusión:	confusion
dinero:	money
belleza:	beauty
varón:	male
naturaleza:	nature
larga:	long
sueño:	dream
semanas:	weeks
pensado:	thought
golpe:	blow
estampa:	print
bastón:	cane
inacabable:	unending
pensando:	thinking
hamaca:	hammock
sonoridad:	sonority
evidente:	obvious
encuentra:	finds
perfil:	profile
menor:	smaller
función:	function
acaba:	ends
Había:	There was
lajas:	slabs
conmigo:	with me
propósito:	purpose
jornada:	day
noche.:	evening.
diamantes:	diamonds
además:	besides
atención:	attention
tiempo.:	time.
curiara:	court
otras:	others
templo:	temple
esperaba:	I expected
sé:	see
daba:	after
piel:	fur
Allí:	Over there
sorpresa:	surprise
minero:	miner
ánimo:	cheer up
figuras:	figures
rodea:	surrounds
último:	last
propio:	own
envuelto:	wrapped
sentía:	felt
izquierda:	left
tragedia:	tragedy
lenguaje:	language
cubierta:	deck
entrañas:	bowels
medida:	measure
capuchino:	cappuccino
centro:	center
sabía:	knew
llamado:	called
periódico:	newspaper
sabiendo:	knowing
medios:	media
trabajar:	work
uso:	use
salen:	the hall
aquello:	that
vuelve:	comes back
hijo:	son
creciente:	growing
mismas:	themselves
cuatro:	four
mirar:	look
tenido:	had
seres:	beings
Más:	Further
pasa:	happens
grita:	scream
Odisea:	Odyssey
existencia.:	existence.
yerbas:	herbs
comienzo:	beginning
volver:	return
Aquí:	Here
pudiera:	could
alguien:	someone
encima:	on
posibilidad:	possibility
hizo:	those
siglos:	ages
raíces:	roots
Desde:	From
ámbito:	scope
remoto:	remote
Estamos:	We are
mineros:	miners
pide:	ask
olor:	smell
parecían:	they seemed
Todo:	All
animales:	animals
encontrar:	find
nuestro:	our
perros:	dogs
posible:	possible
buen:	good
especie:	species
difícil:	difficult
pasos:	steps
dijo:	said
acaso:	chance
amanecer:	sunrise
juego:	game
cuarenta:	forty
rostro:	face
algunas:	some
voces:	you
ello:	it
ruinas:	ruins
dolor:	pain
negras:	black
cabellera:	hair
dedos:	fingers
vivir:	live
cadáver:	corpse
acababa:	ended
primeras:	first
quiero:	wanna
arte:	until
fuerza:	force
será:	it will be
puedo:	I can
tengo:	I have
digo:	I say
ríos:	rivers
movimiento:	motion
propia:	own
últimos:	last
Además:	Besides
buscando:	searching
habrá:	there will be
espaldas:	backs
tarea:	task
necesario:	necessary
hemos:	we have
Su:	They are
absurdo:	absurd
caído:	fallen
pocas:	few
quiere:	wants
quedaba:	remained
enormes:	huge
emoción:	emotion
nombres:	names
adelante:	forward
empieza:	begin
claridad:	clarity
ahí:	there
meses:	months
cambio:	change
hechos:	facts
acento:	accent
hecha:	made
griegos:	greeks
brazo:	arm
cuerpos:	bodies
paisaje:	landscape
acto:	act
voluntad:	willpower
seguir:	follow
acción:	action
cierta:	true
junio):	June)
luces:	lights
mí.:	my.
muchos:	many
ropas:	clothes
quería:	wanted to
dar:	but
recién:	newly
partes:	parts
Algo:	Something
noticia:	news
memoria:	memory
suena:	sounds
debo:	I must
espacio:	space
semejante:	such
cierto:	TRUE
siento:	I feel
segundo:	second
correr:	run
recuerdo:	memory
canoa:	canoe
pueda:	can
cuenta:	account
después:	after
leyes:	laws
semblante:	countenance
oficio:	job
lluvias:	rains
andar:	to walk
montañas:	mountains
demás:	others
árbol:	tree
caminos:	roads
podría:	could
cualquier:	any
perro:	dog
parecen:	they seem
semejantes:	similar
borde:	should
tantas:	so many
espera:	wait
vuelto:	turned
según:	according to
formas:	shapes
Porque:	Why
piernas:	legs
brazos:	arms
llena:	full
Gavilán:	Hawk
tronco:	stem
aguardiente:	schnapps
objetos:	objects
Como:	As
orillas:	shores
Simón:	Simon
avión:	plane
sería:	I would be
Treno:	Train
objeto:	object
decir:	say
debajo:	below
señal:	sign
vientre:	belly
varias:	several
salir:	go out
ellos:	they
busca:	search
tenían:	they had
Grandes:	Big
muchas:	many
ramas:	remaining
dado:	given
uno:	a
silencio:	silence
pasar:	market
Esto:	This
lleva:	carry
techo:	ceiling
nuestros:	our
debía:	should
llegado:	arrived
tono:	application
expresión:	expression
ciudades:	cities
teatro:	theater
muerto:	dead
haciendo:	doing
Venados:	Deer
jamás:	never
fraile:	friar
tantos:	so many
texto:	text
peor:	worse
responde:	respond
año:	year
tras:	after
viene:	he comes
sensación:	sensation
forma:	shape
humedad:	humidity
caso:	case
regreso:	return
aquella:	that
navegación:	navigation
hora:	time
orilla:	bank
corriente:	current
iba:	others
griego:	Greek
caño:	spout
nubes:	clouds
pasado:	past
idioma:	language
—como:	-as
varios:	several
conciencia:	awareness
llegar:	arrive
gente:	people
tiempos:	time
sombras:	shadows
necesidad:	need
plantas:	plants
choza:	hut
Para:	To
historia:	history
instante:	instant
troncos:	trunks
tener:	have
así:	So
nuestras:	our
calor:	heat
parecía:	it seemed
entrada:	Prohibited
cosa:	What
muerte:	death
cabeza:	head
mejor:	better
deseo:	desire
encuentro:	meeting
lejos:	far
cerca:	fence
están:	are
habla:	speaks
debe:	has to
pájaros:	birds
Anunciación:	Annunciation
esposa:	wife
secreto:	secret
detrás:	behind
dejado:	left
algunos:	some
hacen:	do
hubieran:	they would have
Ya:	Of
visto:	view
estar:	be
estoy:	I'm
presente:	gift
ciertas:	certain
Le:	The
cómo:	as
qué:	that
hacía:	toward
Luego:	Then
unas:	nails
puesto:	position
través:	through
mientras:	while
hallar:	cases
porque:	why
abajo:	below
él:	he
allí:	over there
punto:	point
súbito:	sudden
estaban:	were
nombre:	name
aunque:	although
ciertos:	some
lluvia:	rain
buscar:	look for
todavía:	still
viaje:	journey
parte:	part
fondo:	bottom
realidad:	reality
nuevamente:	again
tarde:	afternoon
habían:	had
haya:	these
primeros:	first
hablar:	talk
Un:	And
bien:	GOOD
tenía:	had
demasiado:	too much
nuestra:	our
Mónica:	Monica
mañana:	tomorrow
tienen:	have
arriba:	above
verdad:	TRUE
apenas:	just
fueron:	were
torno:	lathe
acerca:	about
hojas:	leaves
estas:	is
puede:	can
también:	also
obra:	work
cuanto:	how much
instrumentos:	instruments
sentido:	sense
presencia:	presence
grandes:	big
hacer:	do
pensar:	think
menos:	less
ritmo:	rhythm
cuyos:	whose
frente:	forehead
entonces:	so
momento:	moment
cuyas:	whose
nunca:	never
misma:	same
horas:	hours
palabras:	words
sí:	Yeah
suelo:	floor
miedo:	fear
primera:	first
palabra:	word
Por:	By
nosotros:	us
cual:	which
mujeres:	women
papel:	paper
veo:	I see
tanto:	both
regresar:	go back
les:	THE
esos:	those
años:	years
casi:	almost
mucho:	a lot
esas:	those
otro:	other
Ahora:	Now
otros:	others
cosas:	things
quienes:	who
cuyo:	whose
veces:	times
Una:	A
gesto:	gesture
unos:	some
toda:	all
aquel:	that
hecho:	made
han:	he
lado:	side
parece:	it seems
mano:	thousand
cuerpo:	body
dentro:	within
cuya:	whose
sólo:	only
árboles:	trees
tiene:	has
algún:	some
pues:	well
música:	music
tres:	three
alguna:	some
fuera:	out
voz:	voice
vida:	life
sido:	been
medio:	half
modo:	way
nada:	nothing
indios:	indians
suerte:	luck
esto:	this
junto:	together
lugar:	place
fue:	was
antes:	before
hubiera:	had
aún:	still
todas:	all
siempre:	always
durante:	during
Cuando:	When
allá:	there
hasta:	until
poco:	bit
ni:	in
De:	Of
mundo:	world
mujer:	women
está:	this
esta:	this
Mouche:	Fly
tal:	of
mismo:	same
otra:	other
eran:	were
estaba:	was
este:	it is
ese:	that
noche:	evening
día:	day
días:	days
desde:	from
pero:	but
ojos:	eyes
todos:	all
cada:	each
hombre:	man
tiempo:	time
hombres:	men
bajo:	low
luego:	then
hacia:	toward
quien:	who
hace:	does
muy:	very
dos:	of the
algo:	something
mí:	my
ser:	to be
entre:	between
aquí:	here
Adelantado:	Advanced
La:	The
En:	In
le:	the
si:	and
ya:	of
ahora:	now
todo:	all
donde:	where
El:	He
Pero:	But
vez:	time
cuando:	when
había:	there was
sobre:	on
sus:	their
más:	further
como:	as
para:	to
su:	are
por:	by
del:	of the
se:	with
una:	a
un:	and
el:	he
en:	in
la:	the
que:	what
de:	of
