11
:	11
biblioteca.:	library.
fueron:	were
huir:	flee
ejemplar.:	copy.
moralidad:	morality
edificante:	edifying
alegoría:	allegory
personajes:	characters
Predicador:	Preacher
Libertino:	Libertine
momento:	moment
actuaban:	they acted
barroco:	baroque
inscribía:	enrolled
presencia:	presence
oculta:	hidden
arquitectura:	architecture
sostenidos:	sustained
convivíamos:	we lived together
hablando:	talking
siguiera:	follow
callado:	reserved
estuviera:	was
Parecía:	It seemed
perdidos.:	lost.
foso:	pit
tinieblas:	darkness
ahondaba:	delved
algún:	some
aspirado:	aspirated
hombre.:	man.
volver:	return
oírme:	hear me
aterro:	landfill
expresarse:	express yourself
físicos:	physical
medios:	media
propios:	own
valiera:	worth
saberlo:	know it
llevara:	will carry
dichas:	said
hunden:	the dog
noche.:	evening.
inconsciencia:	unconsciousness
aturdimiento:	daze
inutilidad:	futility
betunes:	bitumen
feos:	ugly
colores:	colors
execración—:	execration-
anhelo:	longing
alcanza:	reaches
sí:	Yeah
euforia:	euphoria
—llevado:	—carried
concupiscencias:	concupiscences
iniquidades:	inequities
confesionario:	confessional
vuelca:	overturns
pecador:	sinner
así:	So
sombría.:	gloomy
exaltación:	exaltation
sostenido:	sustained
atropellado:	run over
ritmo:	rhythm
Entonces:	So
esperada.:	expected.
fuese:	was
frialdad:	coldness
sorprendente:	surprising
distante:	distant
Impasible:	Impassive
vacío:	empty
¡estoy:	I'm
—
gritaba:	—
shouted
«Además:	"Besides
existencia.:	existence.
horas:	hours
mejores:	best
vender:	sell
aquélla:	that
solución:	solution
estéril:	sterile
inteligencia:	intelligence
hambre:	hunger
obsesionados:	obsessed
acabando:	running out
armarios:	wardrobes
cocinan:	they cook
fuman:	they smoke
agujereadas:	perforated
suelas:	soles
nieve:	snow
cruzan:	cross
noche:	evening
camisa:	shirt
lavan:	stage
tránsito:	transit
conocía:	knew
vivido:	vivid
haberlo:	have
parte.:	part.
cualquier:	any
afrontar:	affront
miseria:	misery
asfalto:	asphalt
arrojado:	thrown
militar:	military
intérprete:	interpreter
ruinas:	ruins
mundo:	world
través:	through
zarandeado:	you will be
mercaderes:	merchants
peores:	worst
alimentaba:	fed
arte:	until
falsas:	fake
encandilado:	dazzled
adolescencia:	adolescence
desarraigado:	rootless
cómo:	as
sabía:	knew
primitivos.:	primitives.
vivir:	live
puedan:	can
posible:	possible
preguntándole:	asking him
gruesas:	thick
estallido:	pop
increpo:	scold
vuelve:	comes back
vergüenza:	shame
encuentro:	meeting
segundo.:	second.
mangas:	sleeves
marcados:	marked
naipes:	suits
agarrado:	grabbed
tramposo:	cheating
muestra:	sample
organológica.:	organological.
desinencia:	ending
olvido:	forgot
frase:	phrase
remedio:	remedy
varo:	precautionary
mentira:	lie
resonancias:	resonances
devuelta:	returned
parece:	it seems
exploradores:	explorers
grabados:	engravings
recién:	newly
cantos:	songs
reunir:	gather
necesidad:	need
supuesta:	supposed
asir:	captive
especialistas.:	experts.
desechadas:	discarded
están:	are
rectificación:	rectification
irónica:	ironic
enterarme:	find out
bibliografías:	bibliographies
apoyarme:	support me
Trato:	Deal
sabidos.:	known.
esenciales:	essential
datos:	data
clasificaciones:	classifications
enredo:	plot
técnicos:	technicians
términos:	terms
manejo:	management
errores:	errors
risibles:	laughable
cometo:	comet
evidente:	obvious
uso:	use
hábito:	habit
falta:	lack
obra.:	work.
elaboración:	elaboration
diferido:	deferred
hubieran:	they would have
escollos:	pitfalls
inventando:	inventing
mentirle:	lie to him
empiezo:	start
escapar:	escape
imposibilidad:	impossibility
mimetismo-mágico-rítmico:	magic-rhythmic mimicry
ingenios:	wits
pensé:	think
—tal:	— of
conclusiones:	conclusions
examinar:	examine
investigación:	investigation
nuevos:	new
conocer:	know
búsquedas:	searches
Quiere:	Wants
discutir.:	to discuss.
escucharme:	listen to me
dispone:	has
advirtiéndome:	warning me
pregunta:	ask
afectuosamente:	affectionately
acorralándome:	cornering me
10
:	10
temía::	I feared:
cantar:	sing
surco.:	groove.
diafragma:	diaphragm
levanta:	get up
De:	Of
realizar.:	accomplish.
permitía:	allowed
tiranías:	tyrannies
cotidianas:	everyday
época:	era
sueños:	dreams
desván:	loft
cosas:	things
otras:	others
relegaba:	relegated
pensar:	think
giraba:	turned
frente:	forehead
colérico:	choleric
juncos.:	reeds.
oquedad:	cavity
aliento:	breath
resonante:	resonant
mano:	thousand
buscados:	wanted
salto:	jump
galope:	gallop
trote:	trot
fueran:	were
ritmos:	rhythms
creencia:	belief
desacertado:	ill-advised
imagen—:	image-
posesión:	possession
presa:	taken
hacerse:	become
—
el:	—
he
ardid:	scheme
debían:	they had to
cavernas:	caves
pintados:	painted
bisontes:	bison
renos:	reindeer
representaciones:	representations
primeras:	first
teníamos:	we had
animales:	animals
remedar:	helper
afán:	eagerness
rítmica:	rhythmic
expresión:	expression
nacimiento:	birth
explicaba:	explain
elaborar:	elaborate
empezado:	started
sustentadas:	sustained
generalmente:	generally
Inconforme:	Dissatisfied
órgano.:	organ.
teológico:	theological
suntuoso:	sumptuous
factores:	factors
barniz:	varnish
prodigioso:	prodigious
vigencia:	validity
milenaria:	millennial
perduran:	they endure
producir:	produce
modos:	modes
madres:	mothers
chivo:	billy goat
tripa:	gut
hueca:	hollow
caña:	cane
calderería:	boiler room
obras:	works
morfológico:	morphologic
clasificación:	classification
apasioné:	I was passionate
ocuparnos:	take care of ourselves
debieran:	should
precisamente:	precisely
tareas:	tasks
energía:	energy
darse:	give
consiste:	consists
pereza:	laziness
Impelido:	Driven
Fuga.:	Leak.
Arte:	until
conduciría:	would drive
emprender:	undertake
gigantescas:	gigantic
osamentas:	bones
erizado:	bristly
todavía:	still
planeta:	planet
largos:	long
tobilleras:	anklets
zumbadores:	buzzers
bestias:	beasts
quijadas:	jaws
litófonos:	lithophonist
ahuecados:	cupped
troncos:	trunks
percutores:	strikers
conocimiento:	knowledge
trabado:	stuck
techo:	ceiling
Bajo:	Low
orgullo:	pride
orientado:	oriented
creación.:	creation.
exigida:	required
propósitos:	purposes
continuidad:	continuity
asueto:	holiday
domingos:	Sundays
llevarse:	take away
pudiera:	could
tarea:	task
orientándome:	guiding me
temporadas:	seasons
funciones:	functions
ausencias:	absences
ingratas:	unwelcome
anhelaba.:	I longed for.
convivencia:	coexistence
tipo:	type
mujer:	women
vocación:	vocation
convencí:	I convinced
amorosa:	loving
anarquía:	anarchy
tiempos:	time
agotamos:	we exhausted
excelente.:	excellent.
destrozado:	destroyed
hubiéramos:	we would have
comercial:	commercial
empresa:	enterprise
ingreso:	income
justificación:	justification
abandonada:	abandoned
obra:	work
culpabilidad:	culpability
complejo:	complex
alivio:	relief
probablemente:	probably
compositores:	composers
perspectivas:	perspectives
infinitas:	infinite
abrían:	they opened
afirmando:	stating
ponía:	put
engañoso:	misleading
sucedáneos:	substitutes
técnicas:	techniques
derivar:	derive
dejaba:	left
armario:	cupboard
empaquetados:	packaged
quedado:	left
habían:	had
inicial:	initial
escena:	scene
guiones:	scripts
terminado:	finished
preludio:	prelude
regreso:	return
ambiciosa:	ambitious
composición:	composition
interrumpido:	disrupted
Eran:	Were
primitiva.:	primitive
organografía:	organography
orígenes:	origins
transcurso—:	course-
rapidez:	speed
inútil:	useless
asustaban:	they scared
realizados:	carried out
recordándome:	reminding me
pecho:	chest
resonancia:	resonance
halla:	lean
remedo:	imitation
enconar.:	lead on.
vienen:	they come
prisa:	hurry
apuradas:	cleared
irritación:	irritation
creciente:	growing
decirme:	tell me
quiere:	wants
demasiado:	too much
comprendo:	understand
acceso:	access
abrazándoseme:	hugging me
teoría»:	theory"
comprobación:	proof
propicia.:	propitious
9
:	9
posesional:	possessional
rito:	here
cazarlo:	hunt it
imitan:	imitate
continente:	continent
indios:	indians
¿Te:	¿The
«¿Te:	«¿The
pregunta::	ask:
júbilo:	jubilation
transfigurado:	transfigured
audición:	audition
Termina:	Finish
ornitólogo.:	ornithologist.
interesante:	interesting
documento:	document
qué:	that
imagino:	I imagine
ni:	in
fuera:	out
pregonado:	trumpeted
está:	this
dónde:	where
comprender:	grasp
acabo:	just
terminando:	ending
Casi:	Almost
telegrafista.:	from the telegraph.
cabina:	cabin
sonando:	ringing
alfabeto:	alphabet
sonoridad:	sonority
mismas:	themselves
portamento:	bearing
ignora:	ignore
siquiera:	even
idéntica.:	identical.
duración:	duration
parecen:	they seem
silencios:	silences
breves:	brief
cortado:	cut
monótono:	monotonous
ese:	that
sigue:	go on
grabado:	recorded
andamos:	we walk
escucharse:	listen
Algo:	Something
gira.:	tour.
placa:	plate
índice:	index
reclama:	complain
preguntarle:	ask him
acabara:	it was over
suavemente:	gently
sonríe:	smile
Sorprendido:	Surprised
espaldas:	backs
llenar:	fill
espiras.:	spirals.
zona:	area
juzgar:	judge
minutos:	minutes
unos:	some
breve::	brief:
engorro:	nuisance
—el:	-he
—pienso:	-I think
muelle.:	dock.
aguja:	needle
cuidado:	Careful
eligiendo:	choosing
gramófono:	gramophone
coloca:	put
etiqueta:	label
grabar:	gravedigger
medio:	half
chanclos:	galoshes
quitándose:	taking off
regresa:	come back
vendré:	I will come
tajante:	cutting
decir:	say
oscuros.:	dark
rincones:	corners
revueltos:	scrambled
rotos:	broken
fuelles:	bellows
organitos:	organist
entablillados:	splinted
mástiles:	masts
sueltas:	loose
clavijas:	pegs
dulzainas:	dulzain
rabeles:	struggled
hacer:	do
atraer:	attract
haberme:	have me
enojo:	anger
hostigada:	harassed
impaciencia:	impatience
burlar:	cheat
trata:	treats
Damasceno:	Damascene
impresión:	impression
acaso:	chance
pasando:	passing
tañer:	tanner
Cifra:	Cipher
Libro:	Book
príncipe:	prince
edición:	edition
monjes:	monks
Llevándome:	taking me
año.:	year.
largas:	long
junio:	June
prematuramente:	prematurely
oscurecido:	darkened
importa;:	matters;
responden:	respondents
urgido:	urged
hora:	time
Pregunto:	Asked
veinte.:	twenty.
parado:	stopped
vacaciones:	vacation
realidad:	reality
acostumbrarme:	get used to
percato:	notice
anoche:	last night
cuerda:	rope
dado:	given
ineludible.:	inescapable.
cita:	dream
alarma:	alarm
fingir:	to fake
despacio:	slowly
camina:	walk
resulta:	result
Como:	As
embriaguez.:	drunkenness.
procuraran:	will try
bebidas:	drinks
inventar:	inventory
arregló:	arrangement
épocas:	eras
todas:	all
atavismo:	atavism
agradece:	thanks
organismo:	body
poco:	bit
piensa:	think
—cómica:	—comic
vierte:	fourth
Luego:	Then
infusión.:	infusion.
comprueba:	check
Hernán:	Hernan
famoso:	famous
jinete:	rider
cámara:	camera
trompeta:	trumpet
«Fue:	"Was
cobre.:	copper.
dentadura:	teeth
alargan:	lengthen
abiertas:	open
esmalte:	enamel
plateadas:	silver
escamas:	scales
ornada:	ornate
pabellón:	pavilion
preciosísimo:	precious
México:	Mexico
Conquista:	Conquest
yace:	he said
ficha:	record
redacción:	wording
esperando:	waiting
trabajo:	job
incaica;:	Inca;
cuelga:	hanging
estantes:	bookshelves
martiniqueño.:	Martinican.
acompañado:	accompanied
té:	has
tazas:	mugs
preparando:	preparing
asiáticos:	Asian
panderos:	tambourines
címbalos:	cymbals
atestada:	attested
pequeña:	small
cortos:	shorts
pasos:	steps
anda:	you
toser:	cough
8
:	8
estramonio:	extramonium
uno:	a
encender:	light
asfixia:	suffocation
tabaco:	tobacco
cigarrillo:	cigarette
apagando:	erasing
Renegando:	Renouncing
escudo:	shield
rococó:	rococo
encuadra:	frame
visitas:	visits
tiesura:	direct
actitud:	attitude
compostura:	composure
imponiéndome:	imposing
cilicio:	shirt
rigores:	rigors
incrustan:	embed
vencidos:	defeated
disparejamente:	unevenly
butaca:	armchair
resortes:	springs
anacronismo.:	anachronism.
intercala:	intersperse
grava:	important
platabanda:	platformband
cristales:	crystals
comienzos:	beginnings
regalo—:	gift—
extraordinario:	extraordinary
—un:	— and
señas.»:	address."
tus:	the
perdido:	lost
«Te:	"The
nombre::	name:
insulto:	stroke
responderá:	will respond
creo:	believe
carcajada.:	laugh.
manera:	manner
cómica:	comic
ruedas:	wheels
triturado:	crushed
arranca:	starts
viento:	wind
abierto::	open:
paraguas:	umbrella
esquina:	corner
doblar:	fold
arrecia.:	intensifies
porque:	why
correr:	run
desayuno.:	breakfast.
prefiero:	prefer
mañana:	tomorrow
cada:	each
libertad:	freedom
apenas:	just
ajenas:	alien
voluntades:	wills
regida:	governed
cambiar:	change
poder:	can
exasperado:	exasperated
ámbito:	scope
preso:	taken 
sentirme:	feel
algunas:	some
depresión:	depression
invadido:	invaded
vería:	would see
alcanzar:	reach
andar:	to walk
busca:	search
Graal...:	Grail...
Elevación:	Elevation
opuesta:	opposite
cuanto:	how much
aborrecía:	hated
generación:	generation
Además:	Besides
evocadores:	evokers
objetos:	objects
aparta:	separate
esquivado:	dodged
aus:	out of
Tochter:	Daughter
Götterfunken:	Sparks of the gods
Schöner:	More beautiful
Freunde:	Friends
soportar:	endure
infancia:	childhood
enfermedades:	diseases
unidas:	united
músicas:	songs
ciertas:	certain
toleraba:	tolerated
turbión.:	turbidity
seguido:	followed
presentaban:	they presented
Sinfonía:	Symphony
Porque:	Why
clásico.:	classic.
haberse:	have
también:	also
escenario.:	scenery.
coristas:	chorus girls
entrar:	to enter
suponerlo:	assume it
Debí:	I should have
espaldas.:	backs.
hinchaba:	swollen
esto:	this
brotar:	sprout
ignorarla:	ignore it
escuchar:	listen
encontraba:	found
dispuesto:	willing
disgusto.:	disgust.
levanté:	Levant
desatada...:	unleashed...
fuerza:	force
acometida:	affected
tremenda:	tremendous
huida:	flight
apremio:	pressure
angustia:	distress
hizo:	those
desgano:	reluctance
arcos:	bows
caídas:	falls
descenso:	descent
pintáronse:	they were tormented
cual:	which
violines:	violins
segundos:	seconds
aleteada:	fin
leve:	live
roto:	inside
cercana.:	close.
charcos:	puddles
rodar:	rotate
aplacados:	placated
cuyos:	whose
ocurría:	it happened
observar:	notice
contrabajos:	double basses
cajas:	boxes
oscuro:	dark
sorpresa:	surprise
traído:	brought
verme:	don't give
inhabitual:	unusual
encuadres:	frames
sometimiento:	submission
objeto:	object
hecho:	made
resultaba:	it turned out
detestables:	detestable
saturado:	crowded
estudios:	studies
salía:	went out
sinfónico;:	symphonic;
concierto:	concert
asistía:	attended
Hacía:	Toward
Cherubini.:	Cherubs.
Telemann:	Teleman
magro:	thin
junto:	together
hubiese:	would have
usufructuario:	usufructuary
máximo:	maximum
año:	year
evidencia:	evidence
podría:	could
ejecuciones:	executions
generación.:	generation.
demanda:	demand
virtud:	virtue
acrecieran:	would increase
7
:	7
merma:	decrease
sufrieran:	they would suffer
poderes:	powers
póstumos:	posthumous
esos:	those
—
pensaba:	—
thought
Ocurría:	It happened
futuro.:	future.
atención:	attention
lapsos:	lapses
imponiendo:	imposing
propiedad:	property
derechos:	rights
conservaban:	they kept
común:	common
fosa:	pit
desorden:	disorder
sórdido:	sordid
perdidos:	lost
huesos:	bones
pomposos:	pompous
mausoleos:	mausoleums
yacentes:	recumbent
mandatos:	mandates
signos:	signs
estampaban:	stamped
particellas:	parts
carátulas:	covers
antes.:	before.
siglos:	ages
tomadas:	sockets
disposiciones:	provisions
menudo:	slight
obedecía:	obeyed
último:	last
Este:	It is
Transcurso.:	Course.
Medidor:	Meter
gestos:	gestures
hablaba:	spoke
voluntad:	willpower
sometido:	lost
organizado:	organized
encuadrado:	framing
incoherentes:	incoherent
acarrear:	carry
dejara:	will leave
instante:	instant
expectación:	expectation
aguda:	acute
sinfónica:	symphonic
orquesta:	orchestra
colocarse:	be placed
Siempre:	Always
notas.:	notes.
ordenación:	ordering
anteriores:	previous
afinaciones:	tunings
trinos:	trills
escalas:	scales
hervor:	out
confuso:	confused
envueltos:	wrapped
seguían:	they followed
clarinetes:	clarinets
fagotes:	bassoons
concertino:	concertmaster
barbilla:	chin
violín:	violin
Sosteniendo:	Holding
calor.:	heat.
subidos:	uploaded
parches:	patches
falanges:	phalanges
interrogaba:	interrogated
timbalero:	timero
Un:	And
gradas.:	stands.
pasar:	market
voces:	you
agrupando:	grouping
estaban:	were
famosa:	famous
miembros:	members
conocidos:	acquaintances
eran:	were
pasaban:	they passed
algunos:	some
músicos:	musicians
entrada:	Prohibited
conducía:	drove
escalera:	ladder
Recordé:	I remembered
transeúnte.:	passerby.
resguardo:	guard
menor:	smaller
ofrecía:	offered
larga:	long
acera:	pavement
conciertos:	concerts
detrás:	behind
reventado:	busted
Había:	There was
latitud.:	latitude.
violencia:	violence
inesperada:	unexpected
reventó:	burst
seguro:	insurance
todo:	all
buscar:	look for
Debemos:	Must
implicaciones...:	implications...
tejido:	tissue
revelará:	will reveal
significado:	meaning
verdadero:	TRUE
encuentros:	meetings
todos:	all
aparentemente:	apparently
modo:	way
cierto:	TRUE
Encuentro:	Meeting
encuentro.:	meeting.
entonces—:	so-
—
ininteligible:	—
unintelligible
hubiesen:	they would have
alfilerazos:	pinpricks
deleitosos:	delightful
cayendo:	falling
insospechable—:	beyond suspicion-
recurrencia:	recurrence
dilatación:	dilatation
proceso:	process
transcurso:	course
brevedad:	brevity
aparente:	apparent
escapa:	escape
medida:	measure
rozaron:	rubbed
frías:	cold
unas:	nails
discusión:	discussion
deportes:	sports
mimando:	directed
estadios:	stadiums
regresaban:	they returned
quienes:	who
librado:	delivered
árboles.:	trees.
quise:	I wanted
dedos:	fingers
naranjas:	oranges
pelando:	peeling
plateados:	silver
papeles:	papers
rompiendo:	breaking
sentido:	sense
gente:	people
tanta:	so much
caminos:	roads
Hastiado:	Jaded
Mouche.:	Fly.
temprano:	early
primeros.:	first.
acoplamientos:	couplings
alegría:	happiness
Día:	Day
Séptimo:	Seventh
Convivencia:	Coexistence
encontrar:	find
volvían:	they came back
cuerpos:	bodies
nuestros:	our
interponía:	interposed
distancia:	distance
texto:	text
luminosos.:	luminous.
anuncios:	advertisements
agitación:	agitation
monótona:	monotonous
ensombrecía:	overshadowed
sofocante:	suffocating
lado:	side
deseaba:	I wanted
ahora;:	now;
persiguiendo:	chasing
realmente:	really
irritación::	irritation:
produjo:	produced
viaje:	journey
joyero.:	jeweler.
prestado:	provided
diamantes:	diamonds
luciendo:	showing off
retrato:	portrait
allá:	there
organografía;:	organography;
adelante:	forward
Vientos;:	Winds;
galeones:	galleons
rodeadas:	surrounded
islas:	islands
mapa:	map
demasiado.:	too much.
hablaban:	they spoke
tiendas:	stores
ignorarlas:	ignore them
ellas:	they
detenerme:	stop me
verdad:	TRUE
toda:	all
juez:	judge
vida:	life
hablar:	talk
¡Vacío:	Empty
colillas:	butts
palabras:	words
tal:	of
cuerpo:	body
ingeniosa:	ingenious
cobre:	copper
métodos:	methods
elementales:	elemental
trabajos:	jobs
mágico:	magical
les:	THE
caza:	hunting
antes:	before
primitivos:	primitives
cocido:	cooked
das:	the
trino:	triune
mitad:	half
distinto:	distinct
presente:	gift
hacerme:	make me
anciano:	old man
suena:	sounds
vuelvo:	I'm back
Ya:	Of
tantas:	so many
tengo:	I have
dejado:	left
ahora—:	now-
ello:	it
reloj:	clock
sorda:	deaf
sirvienta:	maid
buscarlo:	look for it
cosa:	What
escucha—:	listen-
copas:	glasses
punto:	point
explica:	explains
instrumento:	instrument
Entre:	Between
será:	it will be
suerte:	luck
Organográfico:	Organographic
le:	the
llevado:	carried
sucios:	dirty
tiene:	has
buscaba:	I was looking for
queda:	is left over
dueño:	owner
cabeza:	head
existencia:	existence
nada:	nothing
conocido:	acquaintance
estado:	state
licor:	liqueur
mucho:	a lot
Ahora:	Now
tuviera:	had
muchos:	many
muerte.:	death.
ciertos:	some
tenía:	had
tanto:	both
mejor:	better
Cuando:	When
súbito:	sudden
notas:	notes
silencio:	silence
rincón:	corner
hallaba:	found
forma:	shape
fuga:	leak
absurda:	absurd
hiciera:	did
Así:	So
veces:	times
sonidos:	sounds
instrumentos:	instruments
veía:	saw
trompas:	deceives
hacía:	toward
llegar:	arrive
difícil:	difficult
cierta:	true
pues:	well
parecían:	they seemed
nube:	cloud
comienzo:	beginning
primera:	first
advertencia:	warning
piel:	fur
entonces:	so
—por:	-by
nociones:	notions
cuya:	whose
gotas:	drops
contrario:	contrary
elegir:	choose
única:	unique
estaba:	was
aquí:	here
meses:	months
La:	The
teoría:	theory
estudio:	study
En:	In
dentro:	within
días:	days
acerca:	about
cuenta:	account
él:	he
día:	day
hace:	does
nuevamente:	again
veo:	I see
ojos:	eyes
Si:	And
luego:	then
gesto:	gesture
podía:	could
desde:	from
tres:	three
otro:	other
hombres:	men
siglo:	century
sentía:	felt
mientras:	while
tono:	application
fue:	was
truenos:	thunder
aquella:	that
sólo:	only
esas:	those
hubiera:	had
ir:	and
entre:	between
escenario:	scenery
vez:	time
otra:	other
tras:	after
repentina:	sudden
tratado:	treated
tener:	have
nuestra:	our
gorjeo:	goryeo
hombre:	man
espejo:	mirror
regalo:	gift
pero:	but
voz:	voice
siempre:	always
durante:	during
mismo:	same
Por:	By
casi:	almost
menos:	less
alguna:	some
sido:	been
primeros:	first
cuyo:	whose
esta:	this
recuerdo:	memory
ser:	to be
pájaro:	bird
años:	years
bajo:	low
lluvia:	rain
mí:	my
tarde:	afternoon
El:	He
muy:	very
música:	music
quien:	who
dos:	of the
si:	and
donde:	where
ya:	of
Pero:	But
sus:	their
ahora:	now
hacia:	toward
este:	it is
sobre:	on
Curador:	Curator
cuando:	when
había:	there was
más:	further
tiempo:	time
su:	are
como:	as
se:	with
para:	to
del:	of the
una:	a
por:	by
un:	and
en:	in
el:	he
la:	the
que:	what
de:	of
