68
:	68
requeridos:	required
hallar:	cases
podría:	could
elogios:	compliments
herborizador:	herbalizer
raro:	down
singulares:	singular
propósitos:	purposes
animadas:	lively
trato:	deal
Acostumbrado:	Used to
viaje.:	journey.
objeto:	object
conversación:	conversation
rápidamente:	quickly
mudar:	to change
regresaba:	was returning
tambores.:	drums.
trueno:	thunder
retumbaba:	rumbled
estacadas:	staked
defendido:	defended
afirmaban:	they claimed
trescientos:	three hundred
huidos:	fled
guerrera:	warrior
tribu:	tribe
comprados:	purchased
cautivos:	captives
valía:	worth
justicia:	justice
perseguida:	persecuted
ayuda:	aid
veta:	Know
explotando:	exploding
decía:	said
población.:	population.
vagar:	wander
dejarlos:	leave them
maleza:	evil
respecto:	regard
interrogaban:	they interrogated
cuantos:	how many
preguntas:	questions
Esquivaba:	I dodged
remotos.:	remote.
navega:	navigate
utilidad:	utility
escasa:	scarce
azúcar:	sugar
peines:	combs
telas:	screens
cría:	creates
además:	besides
llevando:	carrying
sustento:	livelihood
requerido:	requested
seguida:	followed
regresaban:	they returned
éstos:	these
cargadores:	chargers
aparecía:	appeared
explicaba:	explain
Nadie:	Nobody
secreto.:	secret.
arrumbamiento:	stowage
yacimiento:	deposit
prodigioso:	prodigious
andanzas:	wanderings
dado:	given
personaje:	character
extraordinario:	extraordinary
opinión:	opinion
ligero:	light
hablando:	talking
naturales:	natural
hijos:	children
cuarenta:	forty
diligencias:	errands
Pescador:	Fisherman
saludar:	greet
separara:	will separate
Aprovechando:	Taking advantage
común.:	common.
negocio:	business
presentaban:	they presented
pluma:	feather
arrancarles:	tear them off
agarrar:	grab
habilidad:	ability
Gavilán:	Hawk
orquídeas.:	orchids.
traían:	they brought
veinte:	twenty
seguido:	followed
ausencia:	absence
tras:	after
reaparecido:	reappeared
Cierta:	true
forastero.:	stranger.
interesar:	interest
podían:	they could
cesterías:	basket weaving
líricos:	lyrical
enseres:	equipment
antropomorfa:	anthropomorphic
alfarería:	pottery
extraña:	strange
silbaban:	dress up
vivos:	alive
pájaros:	birds
plumas:	feathers
sacos:	bags
lagartos:	lizards
pieles:	skins
mariposas:	butterflies
cargamento:	cargo
cosas.:	things.
trayendo:	bringing
muralla:	wall
boquete:	blowjob
surgía:	arose
meses:	months
muchos:	many
durante:	during
Desaparecía:	disappeared
rama-no-caída-sino-colocada.:	branch-in-the-fallen-bell-placed.
cortezas:	crusts
incisiones:	incisions
dobladas:	folded
código:	code
descifraba:	deciphered
practicables.:	practicable
conducían:	they drove
oculta:	hidden
petroglifos:	petroglyphs
caverna:	cave
hojarasca:	leaf litter
poterna:	the paws
cascada:	waterfall
permitía:	allowed
bejucos:	vines
pasarela:	catwalk
dónde:	where
sabía:	knew
Sólo:	Only
telúricos.:	telluric.
barroquismos:	baroque
lajas:	slabs
escalinata:	staircase
angosta:	narrow
conducía:	drove
leguas:	leagues
cincuenta:	fifty
entradas;:	entries;
secretas:	secret
llaves:	keys
conseguirse:	get
tenido:	had
penetrar:	penetrate
hombrecito.:	little man
acotó:	limited
pequeña»:	small"
cupieron:	fit
Noé:	Noah
así:	So
«Algo:	"Something
puertas.:	doors.
mapa:	map
escondida:	hidden
nación:	nation
lluvias::	rains:
elaboraba:	elaborated
meteoros:	meteors
armaba:	armed
nubes:	clouds
modelaba:	modellab
alimentaba:	fed
entero:	whole
compacto:	compact
desaparecidas:	missing
civilizaciones:	civilizations
vestigios:	vestiges
errantes:	wanderers
tesoros:	treasures
abismos:	abysses
montañas:	mountains
encerrando:	closing
explicaba—:	explain—
Cubriendo:	covering
Anunciación.:	Annunciation.
individuo:	individual
relación:	relationship
ponía:	put
celebraba:	celebrated
Gavilán.:	Hawk.
atendía:	attended
jicara:	mention of
cerveza:	beer
lamía:	lamia
advirtiéndome:	warning me
enmarañadas:	tangled
cejas:	eyebrows
hombrecito:	little man
enormemente:	enormously
bebiendo:	drinking
cercana:	close
taberna:	bar
67
:	67
horas.:	hours.
algunas:	some
olvidarme:	forget me
—necesitaba—:	—needed—
Quería:	Wanted to
sollozos.:	sobs.
llamadas:	calls
caso:	case
marché:	walk
catre:	by
trago:	I bring
beber:	to drink
hacerle:	do
roto.:	inside.
paño:	cloth
grueso:	thick
bañé:	I bathed
cieno:	silt
hediondas:	hideous
ropas:	clothes
quité:	I removed
habitación:	room
metí:	I put
ladridos:	barking
calladas.:	quiet
jaurías:	packs
despertó:	woke up
aullido:	howl
tembladera:	scrapie
guerreros:	warriors
armaduras:	armor
moverse:	move
empezaron:	they started
mojados:	wet
sentirse:	feel
tortugas.:	turtles.
charca:	pond
cayó:	fell
brutalmente:	brutally
resbaló:	slipped
fango:	mud
olvidada:	forgotten
palabras.:	words.
suceder:	happen
castigo:	punishment
corriendo:	in a hurry
huyó:	fled
mismo:	same
asombrosa:	amazing
sonarle:	sound
debió:	should have
tremenda:	tremendous
asqueaba.:	disgusted
amarla:	love her
gritaba:	shouted
amarras::	ties:
violencia:	violence
autorizadas:	authorized
arrepentidas:	regretful
hacia:	toward
Asustada:	scared
baraja.:	deck.
fallándome:	failing me
arrojó:	daring
alfiler:	pin
hincada:	kneeling
actuar:	act
efecto:	effect
tuvo:	had
calificándola:	rating it
insultar:	insult
empecé:	I started
comienzo:	beginning
modo:	way
mismo.:	same.
acumulados:	accumulated
rencores:	grudges
lastre:	plates
largar:	drop
vapulearla:	beat her
herirla:	hurt her
necesidad:	need
nerviosa:	nervous
sentía:	felt
verla:	see it
gozándome:	enjoying myself
discusiones:	discussions
excesivas:	excessive
proferir:	utter
cuidarme:	take care of me
solía:	used to
rodeado:	surrounded
pintora:	painter
solicitud:	application
turbia:	cloudy
recordándome:	reminding me
enfureció:	enraged
De:	Of
vacaciones.:	vacation.
quedara:	will remain
pasaríamos:	we would pass
reponerse;:	recover;
cumbres:	summits
frío:	cold
necesitaba:	I needed
antes;:	before;
Gritaba:	I screamed
vez.:	time.
rabiosa:	rabid
gesticulación:	gesticulation
sienes:	temples
puños:	cuffs
alzando:	raising
greñas:	shock
levantaba:	lifted
calificado:	qualified
fuerza:	force
atravesaba:	crossed
ende:	end
quedar:	meet
empeño:	endeavor
Ya:	Of
orden.:	order.
reclamara:	complained
religioso:	religious
tipo:	type
preocupaciones:	concerns
encerrara:	closed
físicas:	physics
licencias:	licenses
transigiera:	compromise
molestos:	annoying
principios:	beginning
deberes:	homework
vincularse:	link
criterio:	criterion
oponer:	oppose
intentara:	will try
denuesto:	last minute
burgués:	bourgeois
burguesa.:	bourgeois.
arquetipo:	archetype
pasiones:	passions
pequeñas:	small
placeres:	be placed
colocando:	putting
bienestar:	welfare
atenta:	attentive
Siempre:	Always
literarias.:	literary.
capillas:	chapels
estéticas:	aesthetic
amparo:	protection
haberlo:	have
sociales:	social
filosóficas:	philosophical
respaldo:	back
sexo:	sex
desafueros:	outrages
entregarse:	surrender
interesantes:	interesting
intelectuales:	intellectuals
arrastraba:	dragged
militancia:	militancy
intimidades:	intimacies
gozar:	to enjoy
revolucionarias:	revolutionary
proclamado:	proclaimed
formación:	training
—¡bien:	-GOOD
insulto:	stroke
Ese:	That
tratándome:	treating me
montó:	amount
encomendada:	ordered
musicales:	musicals
encontrar:	find
llegando:	arriving
cumplir:	achieve
pensaba:	thought
secamente:	shortly
declaré:	declared
deseos.:	wishes.
importaban:	they mattered
día.:	day.
regreso:	return
cubrir:	cover
corriente:	current
navegando:	browsing
partir:	leave
sentencia:	judgment
decisión:	decision
dando:	giving
carácter:	character
estudiar;:	study;
mérito:	merit
afirmó:	stated
menor:	smaller
oído:	ear
Fingiendo:	Pretending
66
:	66
milenario.:	millennial.
golpe:	blow
acabando:	running out
canciones:	songs
también:	also
lavandera:	washerwoman
gesto:	gesture
abolir:	abolish
automático:	automatic
dispositivo:	device
profunda:	deep
dispuestos:	willing
quedaran:	they will stay
agradaba:	liked
domicilio.:	home.
tener:	have
Canción:	Song
conservar:	keep
interesante:	interesting
allá.:	there.
quedado:	left
probablemente:	probably
válida:	valid
honrada:	honored
cultura:	culture
suma:	addition
tradiciones:	traditions
viejas:	old
animismo:	animism
ellos:	they
pervivía:	survived
guitarra:	guitar
budare:	open
fibra:	fiber
techo:	ceiling
contentaban:	they were happy
individuos:	individuals
muchísimos:	many
fiebres:	fevers
ajenos:	alien
vivían:	they lived
habitantes:	inhabitants
descubrimiento:	discovery
maravillando:	marveling
precisamente:	precisely
dije:	said
contraria:	contradicts
llevarle:	take him
hombre.:	man.
explotación:	exploitation
plusvalía:	capital gain
minería:	mining
falacias:	fallacies
agricultura:	agriculture
atraso:	delay
creencias:	beliefs
prejuicios:	prejudices
acá:	here
vivir:	live
proceso:	process
comenzó:	began
economista:	economist
«tono:	« request
generación:	generation
usado:	used
técnicos:	technicians
poblado:	populated
categórico:	categorical
«enterado»:	«informed»
lenguaje:	language
adoptando:	adopting
maravillas.:	wonders.
semejantes:	similar
lamentando:	lamenting
cocido:	cooked
aldeas:	villages
Albán:	Albanian
escalinatas:	stairs
imágenes:	images
—que:	-what
incaicas:	inca
fortalezas:	strengths
México:	Mexico
pirámides:	pyramids
Hablaba:	spoke
hojalata.:	tin.
sorbos:	sips
tomando:	taking
suavemente:	gently
mecía:	rocked
desgaire:	disabled
dejaba:	left
faldas:	skirts
desorden:	disorder
molestarse:	trouble
abrazada:	hugged
gallos.:	roosters
sueño:	dream
cabecera:	head
lámpara:	lamp
fatiga:	fatigue
arrastrándose:	crawling
peripecias:	adventures
trasladarse:	move
reiterada:	reiterated
monótona:	monotonous
grandeza:	greatness
ciudadano:	citizen
forzoso:	forced
encierro:	confinement
significado:	meaning
infancia—:	childhood-
olvidadas:	forgotten
sensaciones:	sensations
devolviéndome:	giving me back
cada:	each
deleitaban:	they delighted
emociones:	emotions
ajena:	alien
permanecía:	remained
—para:	-to
alucinado.:	hallucinated.
poeta:	poet
Floridas:	Florida
Increíbles:	Incredibles
fortuitos:	fortuitous
encuentros:	meetings
cotidiano:	everyday
fuga:	leak
viaje»:	journey"
«invitación:	"invitation
implicaciones:	implications
dotando:	endowment
evasión:	evasion
anhelo:	longing
consabido:	known
invocado:	invoked
ahora—:	now-
partida:	match
víspera:	eve
literario.:	literary.
júbilo:	jubilation
frases:	phrases
emprendido:	undertaken
gritar:	scream
poder:	can
latente:	latent
cansancio:	fatigue
aburrimiento:	boredom
mezcla:	mix
sentimiento:	feeling
reflejaban:	they reflected
jaspeado:	marbled
lindamente:	beautifully
castaño:	chestnut
Sus:	Their
flotante:	floating
galpón:	shed
barriles:	barrels
baldes:	buckets
atestada:	attested
vida:	life
impusiera:	would impose
agarrarse:	hold
constante:	constant
uñas:	nails
unas:	nails
barniz:	varnish
sosnían:	they dreamed
firme:	firm
busto:	bust
lonas:	tarpaulins
caídas:	falls
resinas:	resins
manchada:	spotted
blusa:	blouse
Bajo:	Low
coloraciones.:	colorations.
inteligentes:	smart
relumbre:	glare
cobrizo:	copper
revelándome:	revealing myself
matizado:	nuanced
desigualmente:	unevenly
estopa:	tow
sienes.:	temples.
abiertos:	open
demasiado:	too much
poros:	couples
zonas:	zones
descubriendo:	discovering
enrojecido:	flushed
duras:	hard
maltratado:	mistreated
cutis:	skin
navegación.:	navigation.
última:	last
despertar:	wake up
marchitado:	withered
haberse:	have
hecha:	made
misma:	same
cómo:	as
asombraba:	astonished
despecho.:	spite.
ceño:	frown
frunciendo:	puckering
examinaba:	examined
menudo:	slight
cuán:	how
ironía:	irony
maligna:	malignant
notando:	noticing
observarla:	observe her
65
:	65
divertido:	fun
suya:	to the water
estrategia:	strategy
Conociendo:	Knowing
atractiva.:	attractive.
bastaban:	they were enough
belleza:	beauty
juventud:	youth
entender:	to understand
daba:	after
intelectual:	intellectual
indignas:	unworthy
femeninas:	feminine
vanidades:	vanities
creyeran:	they would believe
semblante:	countenance
constantemente:	constantly
prodigaba:	lavished
atenciones:	attentions
callarse:	shut up
astucia:	cunning
cuidado:	Careful
útiles:	useful
farmacia:	pharmacy
siquiera:	even
espaldas:	backs
nuestras:	our
electricidad:	electricity
admitir:	admit
resolvía:	resolved
pésimo:	appalling
orilla.:	bank.
responsos:	answers
inesperados:	unexpected
pintadas:	painted
islas:	islands
franciscana:	Franciscan
misión:	mission
plateados:	silver
—desde:	-from
antífona:	antiphon
ululante:	wild
descanso:	rest
levantarse:	get up
aparecer:	to appear
acababa:	ended
Como:	As
mohosos.:	moldy
clavos:	nails
pedazo:	piece
moblaje:	furniture
constituían:	they constituted
lona:	his
catres:	cots
Dos:	Of the
penuria.:	shortage.
días:	days
previsión:	forecast
presas:	dams
tortugas:	turtles
arrastraban:	they dragged
lodo:	official
lleno:	full
daban:	different
habitaciones:	rooms
cuartel:	barracks
antiguo:	ancient
llamaban:	they called
lugar:	place
nuestra.:	our.
religión:	religion
practican:	they practice
parientes:	relatives
engorrosos:	cumbersome
ritos:	rites
tenerse:	have
resignada:	resigned
tolerancia:	tolerance
desvelo:	wakefulness
consiguiente:	consequent
aceptándose:	accepting
presagio:	omen
lúgubre:	lugubrious
interpretaba:	interpreted
aullidos:	howls
adoración:	worship
entregaban:	they delivered
tuvieran».:	"they had."
vigilias:	watches
sábados:	Saturdays
«en:	"in
arrojara:	would throw
perrero:	kennel
erigía:	erected
interesaba:	interested
nadie:	nobody
observada:	observed
nunca:	never
ordenanza:	ordinance
colectivos:	collectives
reuniones:	meetings
asistían:	they attended
asados:	roasted
vigilaban:	they watched
barcas:	boats
sentaban:	they sat
avisaban.:	they warned
escarbaban:	they dug
husmeaban:	they sniffed
estiraban:	they stretched
rejas:	bars
zaguanes:	hallways
Ladrido.:	Bark.
librada:	delivered
partido:	party
tomar:	take
derecho:	right
Prometeo:	Prometheus
acercamiento:	approach
arrogándose:	being arrogant
beneficios:	benefits
compartía:	shared
maniobraba.:	maneuvered
otro:	other
verticalidad:	verticality
empresa:	enterprise
aspecto:	aspect
socorrido:	rescued
cuatro:	four
atrofiados:	atrophied
caza:	hunting
compañero:	buddy
sentimientos:	feelings
aportaba:	contributed
hermandad.:	sisterhood.
trabajar:	work
poderes:	powers
complemento:	complement
mutuo:	mutual
Hombre::	Man:
ligaba:	linked
pacto:	covenant
Hombre.:	Man.
alianza:	alliance
través:	through
mantenido:	kept
erizado:	bristly
signos:	signs
peligro:	danger
escribía:	wrote
agudo:	sharp
olfato:	smell
tenso:	tense
podridas;:	rotten;
hojas:	leaves
caídos:	fallen
oquedad:	cavity
engañosas:	misleading
malangas:	oily
ocultaba:	hid
estaban:	were
jinete.:	rider.
admitían:	they admitted
peso:	weight
picas:	pizzas
veredas:	sidewalks
sur:	on
rumbos:	directions
cerraba:	closed
masa:	time
caminos.:	roads.
Nada:	Nothing
noche.:	evening.
senderos:	trails
borraba:	erased
feracidad:	fertility
rastrera:	creeping
maniguas:	get out
enrevesado:	convoluted
fragosa:	fragile
alejados:	far away
esparcidos:	scattered
obeliscos:	obelisks
soberbios:	superb
centinelas:	sentinels
avanzadas:	advanced
distante:	distant
primeros:	first
erguían:	they stood up
últimos:	last
Ahí:	There
Perro.:	Dog.
entrar:	to enter
comprendí:	I understood
ventajas—:	advantages-
64
:	64
centenares:	hundreds
libraba:	liberated
vegetaciones:	vegetations
asediada:	besieged
húmeda:	wet
llegados:	arrived
junio):	June)
(Viernes:	(Friday
vestrae.:	your
solemnitatis:	solemnity
dei:	of the
insigni:	remarkable
Neomenia:	Neomena
cítara.:	zither.
jocundum:	fun
Psalterium:	Psaltery
psalmum:	a psalm
Sumite:	You suspect
historia::	history:
Usualis:	Usual
Líber:	Bast
picadas:	bites
amarillas:	yellow
páginas:	pages
neumas:	I don't know
imprimía:	printed
gregoriano:	Gregorian
salmodiaba:	psalmodiaba
refrescarme:	cool down
lejana.:	distant
próxima:	next
sonaba:	it sounded
reflexiones:	reflections
distraído:	distracted
fui:	I went
culturas:	cultures
simbiosis:	symbiosis
posibles:	possible
sería:	I would be
estas:	is
preguntaba:	I asked
partes.:	parties.
incendiada:	burned
esculpido:	carved
sí.:	Yeah.
nuevas:	new
Un:	And
gemían:	they moaned
cuerpos:	bodies
mañas:	tricks
dislocaban:	dislocated
enredaderas:	vines
humedad:	humidity
ciertamente.:	certainly.
escenografía:	scenography
elementos:	elements
identificaba:	identified
cinocéfalos.:	cynocephalosis.
concilios:	councils
copas—:	drinks—
frondas:	fronds
redondez:	roundness
poniente:	west
pintaban:	they painted
entradas:	entries
grupos:	groups
reunidos:	gathered
orillas:	shores
cerrar:	close
comenzaban:	they started
enormes:	huge
desconcertante:	disconcerting
suelo:	floor
crecido:	grown
árbol:	tree
resultado:	result
identificables:	identifiable
razones:	reasons
estilos:	styles
hincaran:	they will sink
situar:	place
desprendía:	gave off
pensar:	think
marineros:	sailors
bailar:	dance
hacían:	they did
alboroto:	riot
bañaba:	bathed
luto:	cooked
camisón:	nightgown
prostituta:	prostitute
diamantes:	diamonds
cocineras:	cooks
semillas;:	seeds;
enredándose:	getting tangled
sueltos:	loose
cochinos:	pigs
enjauladas:	caged
gallinas:	chickens
carga:	load
inteligentes.:	intelligent.
oírle:	hear him
aburre:	boring
mujer:	women
hastiado:	jaded
saturación:	saturation
grado:	degree
Mouche;:	Fly;
observaciones:	observations
tontas:	stupid
árbol.:	tree.
hundía:	sank
pasamanos:	railing
alargadas:	elongated
rellano:	landing
subía:	went up
reales:	real
laberintos:	labyrinths
poético::	poetic:
baratillo:	dime store
imaginarias:	imaginary
arquitecturas:	architectures
vivía.:	lived.
palpaba:	Pulp
dimensiones;:	dimensions;
fantástico:	fantastic
arte:	until
temas:	themes
Aquí:	Here
modernos.:	modern.
estimaba:	estimated
pintores:	painters
imaginar:	imagine
mejor:	better
maravilloso:	marvelous
sugerencia:	suggestion
aventajaba:	advantaged
fantasmal:	ghostly
acertó:	got it right
borda:	edge
alargó:	lengthened
crepúsculo:	dusk
abandonados.:	abandoned.
castillos:	castles
antiguos:	ancient
63
:	63
tantos:	so many
sobrecogedor:	startling
acento:	accent
añejo:	old
Infantes:	Infants
evocar:	evoke
dieron:	they gave
atracadero:	dock
llegamos:	we arrived
tajara:	Tajara
Ganelón:	Ganelon
felonía:	felony
Turpín:	Turpin
hablaban:	they spoke
décimas:	tenths
cantaban:	they sang
juglares:	minstrels
Aquellos:	Those
evocaciones.:	evocations.
preludiaron:	preluded
antojo:	whim
música:	music
distraernos:	distract us
invitados:	guests
peste:	fish
asoladas:	ravaged
Barones:	Baroness
guerras:	wars
arruinadas:	ruined
ciudades:	cities
pensando:	thinking
misionero:	missionary
relato:	report
interesado:	interested
Muy:	Very
Aguinaldos.:	bonuses.
población:	population
dinteles.:	lintels.
techos:	roofs
arcos:	bows
ruina:	ruin
iniciándose:	getting started
gramas:	grams
entregar:	deliver
acabó:	just
muerte:	death
pantanos.:	swamps.
volvieron:	they came back
abandono:	abandonment
arrozales:	rice fields
surgidas:	arisen
plagas:	pests
azote:	nitrogen
deshaciéndose:	falling apart
emigró:	emigrated
pudo:	could
Quien:	Who
blasones.:	blazons.
yedra:	ivy
colgando:	hanging
heredades:	inheritances
arruinado:	spoiled
saqueos:	looting
continuos:	continuous
Holanda;:	Netherlands;
sábanas:	bed sheets
armarios:	wardrobes
ajuares:	trousseau
próspera:	prosperous
repletas:	full
arcas:	chests
antaño:	yesteryear
más.:	further.
prometiendo:	promising
procesiones:	processions
salvas:	salvo
meras:	the mayor
reducido:	reduced
año:	year
quejosos:	complainers
terciadas:	plywood
juntaron:	got together
tradición.:	tradition.
observaba:	observed
tutelar:	guardianship
fundada:	founded
festividad:	festivity
sacar:	withdraw
explicó:	explained
fraile:	friar
lento:	this
sentencioso:	sententious
Usando:	Using
embarcar:	embark
iba:	others
barbudo:	bearded
después:	after
restablecimiento:	restoration
encender:	light
árboles.:	trees.
embaldosado:	tiling
triste:	sad
quedé:	I stayed
dispersaron.:	they dispersed.
pariendo.:	giving birth
seguían:	they followed
groseros:	rude
ventanas:	windows
preguntando:	asking
perdieron:	they lost
bufones:	jesters
demonios:	demons
pasados:	past
brincando:	joking
riendo:	laughing
correr:	run
echaron:	they threw
afuera:	outside
dejados:	left
Entonces:	So
cirios.:	candles.
luminarias:	luminaries
escarceo:	dabble
tembloroso:	trembling
encontronazo:	clash
rudo:	love
cerraron:	they closed
engolfarse:	engulf
volvió:	came back
raído:	raido
terciopelo:	velvet
sombreado:	shading
hisopo.:	hyssop.
aspersiones:	sprinkles
gimiente:	moaning
grupo:	group
retrocedían:	they retreated
exorcisados:	exorcised
tormentos:	torments
mientras:	while
párroco:	parish priest
falsete:	falsetto
procesión:	procession
La:	The
patadas.:	kicks
impulsaban:	they promoted
espadaña:	bulrush
horcajadas:	straddle
montados:	mounted
niños:	children
diera:	give
arriba:	above
volteada:	turned
martirio.:	martyrdom.
est:	East
Sacer:	sacred
egregio:	excellent
Jerosolimis:	Jerusalem
Mártir:	Martyr
apostolis:	to the apostles
trombón::	trombon:
clarinete:	clarinet
sonoridad:	sonority
apoyado:	supported
himno:	hymn
brotado:	sprouted
Detrás:	Behind
rodando:	running
cayendo:	falling
tropezando:	tripping
convulsiones:	seizures
atacados:	wholesale
despavoridos:	terrified
retrocedieron:	they retreated
corona:	crown
62
:	62
hombros.:	shoulders.
llevaban:	they carried
montado:	mounted
Salomé:	Salome
Zebedeo:	Zebedee
hijo:	son
incienso:	incense
nube:	cloud
estrépito:	crash
abrieron:	opened
plañendo.:	planing
llorando:	crying
cerrada:	closed
permanecieron:	they remained
aldaba.:	latch
repetidas:	repeated
golpearon:	they hit
llegaron:	they arrived
nefando.:	by doing wrong
monstruo:	monster
fingirse:	pretend to be
disfraz:	costume
Semblante:	Countenance
Falso:	False
afición:	hubby
eterna:	eternal
perpetuar:	perpetuate
tiempos:	time
salidas:	Departures
máscaras:	masks
aquellas:	those
parricidas;:	parricide;
rostro:	face
aquellos:	those
miedo:	fear
sensación:	sensation
cuernos:	horns
demonio:	devil
máscara:	mask
Pasión:	Passion
Misterio:	Mystery
Belcebú:	Beelzebub
oficiar:	officiate
jefe:	boss
cortos:	shorts
saltos:	heels
avanzaban:	they advanced
cristianas;:	Christians;
cofradías:	brotherhoods
penitentes:	penitents
paños:	cloths
ocultas:	hidden
incendiada.:	burned down.
catedral:	cathedral
situada:	located
ladrillo:	brick
yeso:	and so
mísera:	miserable
dirigiéndose:	heading
esquina:	corner
aparecieron:	appeared
Diablos:	heck
flautas:	flutes
agudas:	acute
tambores:	drums
sonaron:	they sounded
instante:	instant
organográfica.:	organographic.
referencia:	reference
croquis:	sketch
revelar:	reveal
lápiz:	pencil
quise:	I wanted
admirado:	admired
dejó:	let
último:	last
Esto:	This
tecla:	key
órgano:	organ
tiorba:	thiorba
bajón:	bassoon
tocaban:	they played
ángeles:	angels
figuras:	figures
borroso:	blurred
desplomarse:	collapse
archivoltas:	archival
contrafuertes:	buttresses
quemada:	burned
mampostería:	masonry
hendeduras:	crevices
garfios:	hooks
hincando:	kneeling
trepaban:	they climbed
chimeneas.:	chimneys.
umbrales:	thresholds
servidores.:	servers.
invisibles:	invisible
alzados:	elevated
corrientes:	currents
eje:	axis
temblaban:	they trembled
candelera:	candlestick
brazos:	arms
cactos:	cacti
oscuros:	dark
rincones:	corners
Pascuas:	Easter
encarnado:	red
aromos:	aromas
oros:	golds
rajadas:	gusts
baldosas:	tiles
conservaban:	they kept
salones:	salons
cortinas:	curtains
ligereza:	lightness
ponían:	they put
blancas:	white
campanas:	bells
matas:	fed
hielo.:	ice.
colgados:	hung
ajemizados:	ajemized
balcones:	balconies
vacío:	empty
suspendidas:	suspended
principio:	principle
higuera.:	fig tree.
cornisa:	cornice
restos:	remains
cargando:	charging
soportal:	support
columnata:	colonnade
Quedaba:	was left
ennegrecida:	blackened
comejenes:	termites
roída:	gnawed
maestra:	teacher
viga:	error
rotura:	rip
siguiendo:	following
centro:	center
musgosos:	mossy
cabestrillo:	sling
jambas:	jambs
reducidas:	reduced
podridas:	rotten
deshabitadas:	uninhabited
desiertas:	deserted
calles:	streets
largas:	long
Eran:	Were
prodigiosa:	prodigious
mediodía:	average
aquel:	that
pértiga:	pole
sorteada:	drawn
timón:	rudder
magistral:	highway
Cumplido:	Compliment
alijo.:	stash.
aprovechándose:	taking advantage
impetuosos:	impetuous
particularmente:	particularly
raudales:	rapids
horas:	hours
salvar:	save
opuesta:	opposite
orilla:	bank
Aguinaldos:	bonuses
recoger:	collect
patrón:	pattern
navegación:	navigation
Reanudamos:	We resume
(Jueves:	(Thursday
centauros.:	centaurs.
tomados:	taken
fueron:	were
arrastrada:	dragged
entrada:	Prohibited
hiciera:	did
ámbito:	scope
Herradura:	Horseshoe
evidenciándose:	becoming evident
hemisferio:	hemisphere
cuarta:	quarter
blanquearían:	they would whiten
medioevo:	Middle Ages
ignotas:	unknown
mapas:	maps
según:	according to
dijo:	said
llamado:	called
él:	he
minero:	miner
perro:	dog
volvía:	came back
cabeza:	head
canadiense:	Canadian
estar:	be
pocos:	few
burgués.:	bourgeois.
instrumentos:	instruments
pudiera:	could
habló:	speak
interés:	interest
llevaba:	wore
Para:	To
ciertos:	some
recuerdo:	memory
conciencia:	awareness
cierto:	TRUE
bien:	GOOD
territorios:	territories
inmensos:	immense
calificaba:	qualified
jarro:	pitcher
pequeños:	small
camastro:	bunk bed
propias:	own
visión:	vision
palabra:	word
recordaba:	I remembered
nuestra:	our
viaje:	journey
qué:	that
cólera:	anger
amarillo:	yellow
menos:	less
raras:	rare
jornada:	day
parecía:	it seemed
muchas:	many
encima:	on
cuerpo:	body
quinqué:	five
época:	era
vuelto:	turned
sujeto:	subject
espejo:	mirror
noches:	nights
todos:	all
tanto:	both
todas:	all
punto:	point
debajo:	below
Por:	By
Hombre:	Man
único:	single
animales:	animals
patas:	paws
andar:	to walk
nariz:	nose
Porque:	Why
términos:	terms
pelo:	for the
troncos:	trunks
cuanto:	how much
veía:	saw
rodillas:	knees
altura:	height
cambio:	change
ramas:	remaining
tal:	of
cuya:	whose
todavía:	still
atrás:	back
habíamos:	we had
años:	years
Anunciación:	Annunciation
voz:	voice
memoria:	memory
lado:	side
cosa:	What
insectos:	insects
distinta:	different
gigantescos:	gigantic
caños:	pipes
ello:	it
fácilmente:	easily
mitos:	myth
visto:	view
aunque:	although
proa:	bow
hamaca:	hammock
corrían:	they ran
cubierta:	deck
noche:	evening
piezas:	parts
decir:	say
desconocida:	unknown
Cuando:	When
negras:	black
allá:	there
mucho:	a lot
llevó:	he took
sombras:	shadows
Luego:	Then
cualquier:	any
habían:	had
llenos:	full
esto:	this
entonces:	so
llegado:	arrived
porque:	why
costumbre:	habit
hablar:	talk
pocas:	few
presentó:	presented
nosotros:	us
compañía:	company
roto:	inside
levantado:	up
mujeres:	women
gritos:	shouting
cuyas:	whose
templo:	temple
figura:	figure
imagen:	image
fieles:	faithful
Apóstol:	Apostle
apareció:	appeared
batientes:	swings
extraños:	strangers
espíritu:	spirit
cubiertos:	covered
Una:	A
podido:	could
suerte:	luck
lentamente:	slowly
caras:	guys
varios:	several
ese:	that
Curador:	Curator
papel:	paper
busca:	search
regresar:	go back
concierto:	concert
tímpano:	eardrum
quedaban:	were left
paredones:	walls
hongos:	fungus
corredores:	runners
viejos:	old
vastedad:	vastness
abierto:	open
escaleras:	stairs
Había:	There was
hundían:	sank
puertas:	doors
ruinas.:	ruins.
hallé:	I found
otra:	other
manejo:	management
propósito:	purpose
tarde:	afternoon
mañana:	tomorrow
quería:	wanted to
pues:	well
llena:	full
llevada:	carried
parte:	part
Caballo:	Horse
tierras:	land
quien:	who
nombre:	name
hecho:	made
gente:	people
indios:	indians
país:	country
conocía:	knew
aguardiente:	schnapps
debía:	should
Ahora:	Now
grandes:	big
vasto:	vast
perros:	dogs
ser:	to be
ojos:	eyes
dejado:	left
día:	day
ciertas:	certain
primera:	first
otras:	others
manera:	manner
resultaba:	it turned out
podía:	could
nuestro:	our
griego:	Greek
rotas:	routes
les:	THE
hubieran:	they would have
aquella:	that
historia:	history
alguna:	some
larga:	long
punteadores:	pointers
allí:	over there
ruinas:	ruins
siempre:	always
otros:	others
unos:	some
misterio:	mystery
hocico:	snout
tres:	three
detrás:	behind
danzantes:	dancers
frente:	forehead
raíces:	roots
veces:	times
tejados:	roofs
cuyos:	whose
capuchino:	cappuccino
caballo:	horse
presencia:	presence
Tierras:	Land
sólo:	only
En:	In
ahora:	now
sido:	been
dos:	of the
palabras:	words
bajo:	low
súbito:	sudden
hombre:	man
tenían:	they had
esta:	this
medio:	half
algunos:	some
ni:	in
Adelantado:	Advanced
mí:	my
luego:	then
Perro:	Dog
mundo:	world
hacía:	toward
cosas:	things
estaba:	was
pero:	but
aquí:	here
entre:	between
diablos:	devils
tiempo:	time
cuyo:	whose
árboles:	trees
aún:	still
hacer:	do
hombres:	men
hasta:	until
Mouche:	Fly
vez:	time
poco:	bit
si:	and
todo:	all
hubiera:	had
cuando:	when
Pero:	But
algún:	some
donde:	where
El:	He
ya:	of
desde:	from
le:	the
algo:	something
este:	it is
muy:	very
eran:	were
tenía:	had
sobre:	on
más:	further
para:	to
como:	as
había:	there was
sus:	their
su:	are
del:	of the
una:	a
se:	with
un:	and
por:	by
el:	he
en:	in
que:	what
la:	the
de:	of
