86
:	86
ropas:	clothes
prendida:	on
humedad:	humidity
desagrado:	dislike
agravaba:	aggravated
Además:	Besides
suficiente.:	enough.
nunca:	never
hallar:	cases
respirar:	breathe
instinto:	instinct
trasmundos:	transworlds
indefinible:	indefinable
miedo:	fear
mío;:	mine;
torno:	lathe
tranquilos:	calm
parecían:	they seemed
Todos:	All
amenazaba.:	threatened.
Nada:	Nothing
miedo.:	fear.
tener:	have
Empezaba:	It started
esloras.:	lengths.
conservaban:	they kept
remeros:	rowers
preguntaba:	I asked
secreta.:	secret
morada:	household
umbrales:	thresholds
situarme:	situate myself
antes:	before
atolondrarme:	offer me
mismo:	same
vueltas:	turns
dar:	but
hicieran:	they did
angustiosa.:	distressing
indeciblemente:	unspeakably
resultaba:	it turned out
extravío:	loss
desconcierto:	bewilderment
sensación:	sensation
crecía:	grew
mano:	thousand
alcance:	range
espejismos:	mirages
pequeños:	small
sucesión:	succession
apariencias:	appearances
trastorno:	disorder
inexistentes.:	non-existent.
orillas:	shores
corredores:	runners
salidas:	Departures
ilusorios:	illusory
pasos:	steps
creer:	believe
acababa:	ended
cerrados:	closed
abiertos:	open
ángulos:	angles
reflejaban:	they reflected
maderos:	lumber
Como:	As
anegado.:	waterlogged.
conseguidos:	achieved
luminosos:	luminous
pozos:	wells
hojarasca:	leaf litter
abiertas:	open
troneras:	enthroned
suelo;:	floor;
techo:	ceiling
arriba:	above
venía:	permission
reflejo.:	reflection.
ojos.:	eyes.
mareo:	dizziness
desorientación:	disorientation
verticalidad:	verticality
perdía:	lost
nieves::	snow:
extraviados:	lost
montañeses:	mountaineers
conocen:	they know
parecido:	similar
fenómeno:	freak
producía:	produced
secreto:	secret
caño:	spout
tiempo:	time
algún:	some
plantas.:	plants.
buscar:	look for
pantanos:	swamps
fondo:	bottom
tornaba:	returned
musgo:	moss
frondas:	fronds
bajar:	lower
teñía:	had
rayos:	good heavens
pocos:	few
unos:	some
atravesado:	crossed
verdor:	greenery
tanto:	both
—pues:	-well
vibrátil:	it vibrates
punto:	point
apenas:	just
cínifes:	cynics
diminutos:	tiny
quebradas:	ravines
patas:	paws
moscas:	flies
blancas:	white
pulgas:	fleas
transparentes:	transparent
casi:	almost
chinches:	bed bugs
líquido::	liquid:
andar:	to walk
creados:	created
insectos:	insects
caminaban:	they walked
superficie:	surface
aceitosa:	oily
carroña:	carrion
vinagre:	vinegar
amasado:	kneading
sido:	been
fango:	mud
agriamente:	agrily
olían:	the oil
oscuras:	dark
aquellas:	those
debajo:	below
fermentación:	fermentation
eterno:	eternal
lodo:	official
rampante:	rampant
toda:	all
cercanía:	closeness
adivinaba:	guessed
liendres—.:	nits.
moteadas:	speckled
negras:	black
cortezas:	crusts
levantados:	raised
grisáceos:	grayish
—remolinos:	—swirls
podredumbres:	rotten
turbias:	cloudy
estela:	wake
sí:	Yeah
tras:	after
dejaban:	they left
invisibles:	invisible
seres:	beings
fuga:	leak
denunciaban:	denounced
bofetadas:	slaps
ondulaciones:	ripples
súbitas:	sudden
inesperados:	unexpected
Chasquidos:	Clicks
culebras:	snakes
enrevesamiento:	entanglement
cochambroso:	dumpy
parecía:	it seemed
donde:	where
—allí:	-over there
barbudos:	bearded
garfios:	hooks
erizados:	bristling
fondos:	funds
libraba:	liberated
sorda:	deaf
Una:	A
socavones:	sinkholes
detenidas:	detained
espesas:	thick
opalescentes:	opalescent
gasas:	gauze
allá:	there
Más:	Further
holoturia.:	holothuria.
indecisa:	undecided
estancamiento:	stagnation
tragante:	swallow
alejarse:	move away
cercano:	nearby
aletazo:	flap
rojizo:	reddish
polen:	Poland
barniz:	varnish
endurecidas:	hardened
sucias:	dirty
burbujas:	bubbles
racimos:	clusters
Flotaban:	They floated
encubrimiento.:	concealment.
plantas:	plants
ocre:	ocher
terciopelo:	velvet
semejantes:	similar
agujereadas:	perforated
grandes:	big
mecían:	rocked
Entre:	Between
cosas:	things
peor:	worse
estaba:	was
parda.:	curtain
alud:	avalanche
roto:	inside
comejenes:	termites
desplome:	collapse
súbito:	sudden
promovió:	promoted
proa:	bow
empellón:	shove
caras.:	guys.
enroñaba:	enroñado
fetidez:	smelly
polvos:	powder
horruras:	horrors
llorar:	cry
velludas:	hairy
simientes:	seeds
frutos:	fruits
piel:	fur
encendían:	they lit
hebras:	strands
descenso:	descent
perenne:	perennial
arrojado:	thrown
alguien:	someone
limalla:	with slime
puñados:	handfuls
momentos:	moments
—pesado:	-heavy
errante:	wandering
plancton:	plankton
veces:	times
hollín:	soot
llovía:	it was raining
cuello.:	neck.
sacándome:	taking me out
garrotazo:	clubbing
violencia:	violence
hombro:	shoulder
cayó:	fell
puntiagudo:	pointed
madero:	log
anegada.:	flooded
maleza:	evil
medio:	half
increíble:	incredible
adelante:	forward
llevar:	carry
barreras:	barriers
obstáculos:	obstacles
apartar:	set aside
había:	there was
remos:	oars
retorcidas.:	twisted
unas:	nails
duramente:	hard
rasparon:	scraped
bordas:	edges
deslizarse:	slide
poco:	bit
túnel:	tunnel
angosto:	narrow
introdujo:	introduced
embarcación:	vessel
nuestra:	our
85
:	85
ahí.:	there.
pareció:	it seemed
bajo:	low
estrecho:	narrow
abovedado:	vaulted
pasadizo:	anecdote
abría:	opened
Junto:	Together
reflejarse:	reflect
aquí:	here
multiplicaba:	multiplied
sólo:	only
infinito:	infinite
repetirse:	repeat
podido:	could
diseño:	design
segunda:	second
sirviendo:	serving
otra:	other
penetraba:	penetrated
modo:	way
verticalmente:	vertically
superpuestas:	overlapping
letras:	lyrics
semejante:	such
señal:	sign
estampaba:	stamp
corteza:	crust
su:	are
escamoso.:	scaly.
demás::	others:
todos:	all
igual:	equal
Había:	There was
está:	this
«¡Ahí:	"There
Adelantado::	Advanced:
grito:	shout
despierta:	wake up
párpados.:	eyelids.
cierro:	I close
balanceo:	swinging
espera:	wait
Adormecido:	Asleep
fija:	fixed
adonde:	where to
ojos:	eyes
lleva:	carry
erizado:	bristly
despacio:	slowly
lugar:	place
algo:	something
buscando:	searching
estemos:	we are
atención.:	attention.
acuciosa:	diligent
examinar:	examine
hosca:	Hoske
cerrada:	closed
aproximando:	approaching
La:	The
plomada.:	plumb.
teodolito:	theodolite
obra:	work
parecer:	opinion
acabando:	running out
absurdo:	absurd
prolonga:	prolong
húmedas:	wet
difumina:	blur
Bajo:	Low
grieta.:	crack.
aparente:	apparent
corriente:	current
lindero:	boundary
erguidos:	erected
muralla:	wall
empalizada:	palisade
absolutamente:	absolutely
inabordable:	unaffordable
valladar:	fence
alzando:	raising
hunde:	dogs
manchas:	stains
bordeando:	bordering
estamos:	we are
izquierda:	left
orilla:	bank
cedido:	ceded
han:	he
bambusales:	bamboo
Ahora:	Now
fraguando.:	forging
estoy:	I'm
decorado:	decorated
autenticidad:	authenticity
novela:	novel
realidad:	reality
visos:	all
da:	and
reparo:	repair
rige:	rich
bautizo:	christening
cuestión:	question
imagino:	I imagine
indios.»:	Indians."
doce:	sweet
«Eramos:	«We were
naturalmente::	naturally:
muy:	very
andanzas:	wanderings
alguna:	some
narrar:	narrate
cuando:	when
malicia:	malice
menor:	smaller
cierto:	TRUE
ello:	it
poner:	put
condiciones:	conditions
distinción:	distinction
habituado:	accustomed
extraño:	strange
parezca:	seem
aunque:	although
saqueo:	pillage
bragas:	panties
tomada:	outlet
mujer:	women
trompeta:	trumpet
cargos:	charges
empresa:	enterprise
otorgo:	I grant
pasa:	happens
Gavilán:	Hawk
astrólogo.:	astrologer.
Codro:	Cod
Micer:	mic
griego:	Greek
Utre.:	Tomorrow
puede:	can
bien:	GOOD
entrada.:	Prohibited.
quedamos:	we stay
confesión:	confession
pediremos:	we will ask
capellán:	chaplain
nuestro:	our
Reino:	Kingdom
busca:	search
vamos:	let's go
Conquistadores:	Pathfinders
somos:	we are
junto:	together
narradas:	narrated
historias:	stories
maravillosas:	wonderful
pueril:	childish
juego:	game
divierto:	I have fun
monotonía:	monotony
presencia:	presence
—
sustituye:	—
replaces
bambúes:	bamboos
macizo:	solid
ondulación:	undulation
constante:	constant
dominada:	dominated
gramíneas:	grasses
—tiesura:	—judiciary
tupida:	bushy
tremendamente:	tremendously
mediana:	median
vegetación:	vegetation
asombrarnos:	amaze us
dejado:	left
invención:	invention
diversidad:	diversity
geometrías:	geometries
conjugan:	conjugate
promontorios:	headlands
islas:	islands
entre:	between
horas:	hours
lunes):	Monday)
(Tarde:	(Afternoon
guardianes.:	guardians.
haya:	these
pues:	well
bejucos:	vines
inmovilidad:	immobility
silencio:	silence
habrá:	there will be
CUARTO:	ROOM
CAPITULO:	CHAPTER
mí:	my
sabía:	knew
noción:	notion
claridad:	clarity
hacía:	toward
abajo:	below
cuya:	whose
hacían:	they did
Un:	And
espacio:	space
árbol:	tree
pero:	but
dentro:	within
tal:	of
Pero:	But
ni:	in
nosotros:	us
De:	Of
aquel:	that
imposible:	impossible
tramo:	section
parece:	it seems
cada:	each
curiara:	court
hojas:	leaves
suerte:	luck
esto:	this
hombres:	men
tres:	three
hecha:	made
perro:	dog
ser:	to be
El:	He
sacado:	taken
inacabable:	unending
árboles:	trees
hubiera:	had
vez:	time
hasta:	until
tronco:	stem
raíces:	roots
ese:	that
indios:	indians
Adelantado:	Advanced
sus:	their
dos:	of the
eran:	were
para:	to
ya:	of
lajas:	slabs
navegación:	navigation
más:	further
si:	and
sobre:	on
como:	as
del:	of the
por:	by
se:	with
una:	a
un:	and
el:	he
en:	in
la:	the
que:	what
de:	of
