89
:	89
plumajes.:	plumages.
identidad:	identity
verdad:	TRUE
Sólo:	Only
celestemente:	heavenly
profundidades:	depths
hundía:	sank
azogue:	quicksilver
altura:	height
invirtiendo:	investing
mentía:	lied
Hasta:	Until
ardiente.:	burning.
zarza:	bramble
amarillos:	yellow
encendían:	they lit
amaranto:	amaranth
macizos:	solid
jalonaban:	jalonando
también:	also
Pero:	But
edelweis:	edelweiss
vertiginoso:	vertiginous
inalcanzable:	unattainable
irreal:	unreal
hacía:	toward
allá:	there
orquídea:	orchid
aparecía:	appeared
esperma:	sperm
tulipán:	tulip
palmo:	palm
alzaban:	raised
moteadas:	speckled
cactáceas:	cacti
almíbares:	syrups
rociados:	sprinkled
pensamientos:	thoughts
insectívoras:	insectivorous
vulvas:	vulva
hediondos:	hideous
terciopelos:	velvets
sudorosos:	sweaty
bulbos:	bulbs
mentidas:	lies
frutas:	fruits
redondez:	roundness
frutos;:	fruits;
Parecía:	It seemed
decrepitud.:	decrepit
grado:	degree
distinto:	distinct
mentidos:	lies
En:	In
insectos.:	insects.
hervor:	out
transformara:	will transform
alivio:	relief
este:	it is
segundos:	seconds
detenerse:	stop
Bastaba:	It was enough
curiaras.:	would you like
frescor:	freshness
vaharadas:	Vahardas
vegetales:	vegetables
techumbres:	roofing
logradas:	achieved
cerca:	fence
linazas.:	linseeds.
poso:	the post office
fulminaba:	fulminated
eléctrico:	electric
zanahoria:	carrot
crisálida-ciempiés:	chrysalis-centipede
castaña-erizo:	chestnut-hedgehog
lagarto-cohombro:	cucumber-lizard
Mundo:	World
metamorfosis.:	metamorphosis.
juego:	game
estratagema:	stratagem
disfraz:	costume
semblante;:	countenance;
falso:	false
trampa:	trap
mentira:	lie
La:	The
entero.:	whole.
salpicaduras:	splashes
ahora:	now
simulación:	simulation
intenso:	intense
amarillo:	yellow
estriado:	fluted
plomo:	lead
lapizlázuli:	lapis lazuli
camaleón:	chameleon
falsedad:	falsehood
azufre:	sulfur
espolvoreos:	sprinkles
coladas:	glued
hongos:	fungus
salmuera:	brine
cobraban:	they charged
cortezas:	crusts
firme::	firm:
fingiéndose:	pretending
corría:	ran
les:	THE
escondiendo:	hiding
tupida:	bushy
alfombra:	rug
apretaban:	they squeezed
acuáticas:	aquatic
anillas:	rings
ananá:	pineapple
escamas:	scales
falena:	moth
ojos:	eyes
preciosas:	precious
nervaduras:	ribbing
pieles:	skins
serpientes:	snakes
escaramujos;:	rose hips;
vestidos:	dresses
podridos:	rotten
maderos:	lumber
inmóviles:	motionless
anegada:	flooded
fondos:	funds
bajos:	bass
acechaban:	stalked
caimanes:	alligators
entredicho.:	interdicted
verdades:	truths
muchas:	many
poniendo:	putting
realidad:	reality
ocultaba:	hid
creándose:	being created
Aquí:	Here
naturaleza:	nature
mimetismo:	mimicry
inacabable:	unending
asombraba:	astonished
hormigas.:	ants.
fuera:	out
melosa:	honeyed
lengua:	language
corriendo:	in a hurry
acudían:	they came
cráteres:	craters
abriendo:	opening
termes:	terms
nidos:	nida
destrozando:	destroying
salían:	they went out
profundos:	deep
arados:	plows
extracción:	extraction
unidos:	joined
veían:	they saw
ajenos:	alien
caños:	pipes
vastas:	answered
intrincadas:	intricate
raíces:	roots
sacando:	taking out
milenario:	millennial
yacer:	lie
arcos.:	bows.
cuerdas:	ropes
hacia:	toward
disparaban:	they shot
reventar:	burst
tirando:	taking
desgajados:	torn apart
derribados:	knocked down
aplastados:	crushed
caída:	drop
Cien:	Hundred
quemar:	burn
mejor:	better
carbón:	coal
lleno:	full
rajado:	riven
vientos:	winds
cuatro:	four
arrojando:	throwing
astillas:	splinters
aullando:	howling
desplomarse:	collapse
prehistoria:	prehistory
salido:	left
coloso:	colossus
Entonces:	So
abajo.:	below.
deleznable:	despicable
derribarlo:	knock it down
buen:	good
algunos:	some
permanecía:	remained
tempestades:	storms
inmóvil:	still
lluvias:	rains
Chorreado:	dripped
88
:	88
cristalizaciones.:	crystallizations.
equilibrios:	balances
ritmos:	rhythms
simetrías:	symmetries
tenía:	had
arquitectura:	architecture
leyes:	laws
revelando:	revealing
desnudez:	nakedness
silenciosa:	silent
erguido:	erected
quedaba:	remained
granito:	granite
tomando:	taking
encanecían:	small
le:	the
orquídeas.:	orchids.
apagaba:	turned off
líquenes:	lichens
secaba:	dried
perdía:	lost
esos:	those
uno:	a
lacerados.:	lacerated
encajes:	lace
semejantes:	similar
transparentes:	transparent
musgos:	mosses
colgaban:	they hung
espacio:	space
suspendidos:	suspended
irreales:	unreal
aéreos:	aerial
boscajes:	forests
toda:	all
encima:	on
despejado:	clear
espigadas:	spiked
rastreante:	tracker
gente:	people
Arboles:	Trees
jamás.:	never.
visto:	view
grandes:	big
señeramente:	sensibly
dominada:	dominated
instante:	instant
batalla:	battle
diversas:	miscellaneous
fases:	phases
savia:	sap
sorbido:	sordid
hoja:	move
asomar:	show
lograban:	they achieved
sólo:	only
despunte:	blunt
escuálidas:	scrawny
palmeras:	palm trees
estiramiento:	stretch
desmedido:	excessive
alcanzar:	reach
salir:	go out
ascender:	ascend
otras:	others
treparse:	climb up
empeñadas:	pawned
especies:	species
violentas:	violent
pinceladas:	brush strokes
guacamayos:	macaws
vuelo:	flight
graznante:	beautifying
alborozo:	joy
empinada:	steep
caído:	fallen
malhumorado:	moody
garzón:	waiter
algún:	some
giba:	movement
redondeaba:	rounded
estiraban:	they stretched
cuello:	neck
hundiendo:	sinking
patas:	paws
empinadas:	steep
garzas:	herons
Centenares:	Hundreds
trompa.:	trunk.
refrescar:	refresh
busca:	search
danta:	interest
rompía:	broke
matapalos:	lazy
enredaderas:	creepers
matas:	fed
intríngulis:	intrigued
trabada:	stuck
entretejida:	Entretejida
feraz:	ferocious
orilleros:	edgers
sarmientos:	shoots
anónimos:	anonymous
bambúes:	bamboos
identificables:	identifiable
sujetos:	subjects
Detrás:	Behind
abismada.:	astonished.
cimeros:	crests
obeliscos:	obelisks
emergían:	emerged
mármol:	marble
blanquecinos:	whitish
muertas:	dead
selvas:	jungles
antiquísimas:	ancient
profundidad:	depth
espejismos:	mirages
alargaban:	they lengthened
otros:	others
tanto:	both
ancladas:	anchored
naves:	ships
légamo:	let's go
hundidas:	sunken
retorcidos:	twisted
ciertos:	some
porciones:	portions
inmensas:	immense
cauce:	channel
Como:	As
verdadera.:	true.
anunció:	advertisement
internaba:	interned
imponía:	imposed
viaje:	journey
continencia:	continence
alusiones:	allusions
llenas:	full
maliciosas:	malicious
coplas:	couplets
sonaban:	they sounded
remediar.:	remedy.
poderlo:	power it
verme:	don't give
lloraba:	I cried
recién:	newly
ser:	to be
debe:	has to
canturreando:	humming
echa:	cast
viaje.:	journey.
fase:	phase
ofrece:	offers
estar:	be
oportunidades:	opportunities
pocas:	few
excusarme:	excuse me
necesidad:	need
siento:	I feel
inicio:	start
malévolo.:	malicious.
deslinde:	unravel
espectros:	spectra
confusión:	confusion
despeje:	pour
rugidos:	roars
retroceso:	recoil
nocturnos:	nocturnal
espantos:	frights
término:	term
madrugada:	dawn
vieron:	they saw
milenios:	millennia
ancestros:	ancestors
propias:	own
venas:	is coming
atávico:	atavistic
entrañado:	entangled
júbilo:	jubilation
renueva:	renew
arboledas.:	groves.
infinitas:	infinite
arrojar:	throw
pueda:	can
copas:	glasses
liberado:	released
antes:	before
horas:	hours
esperar:	wait
Habrá:	There will be
despejado.:	clear.
augurar:	augur
parece:	it seems
indecisa:	undecided
claridad:	clarity
lluvia:	rain
grisallas:	gray
insinúa:	hints
neblinas:	mists
envuelve:	wraps
tierras:	land
exhala:	exhale
suelo:	floor
Sobre:	On
pensamos:	we think
hermoso:	beautiful
menos:	less
mucho:	a lot
creación.:	creation.
usufructuario:	usufructuary
dueño:	owner
proclamarse:	proclaim oneself
orgullo:	pride
hombre:	man
transforma:	transform
lejanías:	distances
conciencia:	awareness
cuya:	whose
—belleza:	-beauty
87
:	87
renacer:	be reborn
entendimiento:	understanding
cuerpo:	body
igualmente:	also
gozada:	cumshot
percibida:	perceived
físicamente:	physically
Ríos:	Rivers
Grandes:	Big
cabeceras:	headers
inexploradas:	unexplored
vivían:	they lived
compartía:	shared
pareció:	it seemed
desayuno:	breakfast
enseres:	equipment
limpiaba:	cleaned
remanso:	backwater
pecho:	chest
lavarme:	wash
víspera.:	eve.
temores:	fears
bían:	bian
Prueba.:	Proof.
Primera:	First
pasado:	past
había:	there was
comprendí:	I understood
junio):	June)
hombres.:	men.
voces:	you
oír:	hear
miedo—:	fear-
clamar:	cry
—de:	-of
capitular:	capitulate
punto:	point
rodeaban:	surrounded
amenazas:	threats
temor:	fear
venció:	expired
sueño:	dream
extenuado.:	exhausted.
nerviosa:	nervous
expectación:	expectation
fatigas:	fatigue
febril.:	febrile.
asustado:	scared
aturdido:	stunned
Estaba:	Was
hoyo.:	hole.
cencerros:	cowbells
agitaban:	they agitated
relinchaban:	Ralinchaban
niños:	children
aullaban:	lobby
crujían:	creaked
martillaban:	they hammered
zambullían:	dived
suelo;:	floor;
pegadas:	footprints
nosotros:	us
pasaban:	they passed
bajaban:	they went down
subían:	they went up
silbidos:	whistles
errantes:	wanderers
borborigmos:	borborygmi
pavo:	of them
gritos:	shouting
Hubo:	Was
entera.:	whole.
cubrir:	cover
grillos:	irons
tremulantes:	trembling
harmónicas:	harmonics
lengüetas:	reeds
leños:	logs
mordían:	they bit
peines:	combs
fueron:	were
frondas.:	fronds.
respondieron:	they responded
afinadas:	in tune
distintamente:	distinctly
notas:	notes
flautas:	flutes
caño.:	spout.
rompió:	broke
grotesco:	grotesque
embocadura:	mouthpiece
probar:	prove
empezó:	started
dónde:	where
sabía:	knew
Alguien:	Someone
deslizamientos.:	slides.
sustos:	scares
estremecían:	they shuddered
invadió:	invaded
ranas:	frogs
enormes:	huge
croar:	croak
hamaca.:	hammock.
acunado:	cradled
ámbito:	scope
aisló:	isolated
cual:	which
Cada:	Each
noche.:	evening.
somero:	summer
campamento:	camp
organizado:	organized
hubimos:	we had
apenas:	just
prematuro:	premature
crepúsculo:	dusk
cerraban:	they closed
miedo.:	fear.
Tenía:	Had
amante.:	lover.
calor:	heat
buscando:	searching
atroz:	atrocious
Huí:	I fled
gimiera:	moaned
vez—:	time-
llorosa:	tearful
mujer:	women
—una:	-a
alguien:	someone
queja:	complaint
afinación:	tuning
alcanzaba:	reached
momentos:	moments
resonaba:	resonated
carroña:	carrion
zumbido:	tinnitus
moscas:	flies
enjambres:	swarms
metían:	they put
cuyo:	whose
putrefactas:	rotten
muerto:	dead
caimán:	caiman
horrenda::	horrible:
mirar:	look
hacerme:	make me
canoas:	canoes
atracado:	moored
distancia:	distance
poca:	little
llamó:	called
partes.:	parties.
apretado:	tight
sentí:	I felt
amarilla:	yellow
laja:	intervene
moría:	died
inverno:	winter
estanque:	pond
pequeño:	little
semblantes:	countenances
asoleamiento:	sunning
ceroso:	waxy
caras:	guys
savias;:	swordfish?
resinas:	resins
escupitajos:	spit
recibido:	received
sudor:	sweat
adentro:	inside
ensombrecidas:	overshadowed
camisas:	shirts
sucios:	dirty
chupar.:	to suck.
medio:	half
antenas:	antennas
élitros:	elytra
restos:	remains
secas:	dried
avispas:	wasps
enredados:	tangled
grisáceos:	grayish
llenaban:	they filled
bordas:	edges
curiara:	court
embate:	clash
bajas.:	lows.
telarañas:	cobwebs
canoa.:	canoe.
desprendían:	they shed
arañas:	spiders
pequeñas:	small
Ahora:	Now
frialdad.:	coldness.
sienes:	temples
aliviarme:	relieve me
mano:	thousand
hueco:	gap
tenido:	had
trataba:	tried
frescor.:	freshness.
deleitosa:	delightful
sobresalto:	shock
dejó:	let
frente:	forehead
cayó:	fell
llegarían:	would arrive
anofeles:	helpless
dueños:	owners
nombre:	name
insectos:	insects
zancudos:	mosquitoes
picada:	chopped
continua:	continues
exasperante:	infuriating
haciendo:	doing
penetraba:	penetrated
pegajosa:	sticky
cabellos;:	hair;
piel:	fur
madurez:	maturity
pero:	but
orillas:	shores
pasar:	market
caídas:	falls
apariencias:	appearances
parecía:	it seemed
hasta:	until
allí:	over there
consistencia:	consistency
vida:	life
siglos:	ages
unos:	some
penumbras:	shadows
dejaban:	they left
varios:	several
ciertas:	certain
unas:	nails
abajo:	below
arrojaban:	they threw
ramazón:	branch
lagunatos:	lagoons
garfios:	hooks
bejucos:	vines
troncos:	trunks
casada:	married
durante:	during
rayo:	ray
varias:	several
día:	day
milenaria:	millennial
colores:	colors
belleza:	beauty
hora:	time
esta:	this
junto:	together
llevado:	carried
vez:	time
estaba:	was
jornada:	day
cosas:	things
través:	through
fondo:	bottom
reír:	laugh
cobre:	copper
tinieblas:	darkness
fue:	was
si:	and
dentro:	within
tal:	of
cuero:	leather
cosa:	What
Adelantado:	Advanced
desembocamos:	we flow
desde:	from
hombres:	men
aquellos:	those
ramas:	remaining
entre:	between
partes:	parts
abrían:	they opened
millares:	thousands
preso:	taken 
hubiera:	had
De:	Of
sensación:	sensation
Un:	And
crepúsculo.:	dusk.
espera:	wait
aún:	still
humedad:	humidity
demasiado:	too much
acababa:	ended
hojas:	leaves
plantas:	plants
arriba:	above
maderas:	woods
veces:	times
algo:	something
siempre:	always
nunca:	never
vegetación:	vegetation
amanecer:	sunrise
caño:	spout
otra:	other
dos:	of the
sombras:	shadows
debajo:	below
donde:	where
El:	He
Cuando:	When
tenían:	they had
habían:	had
casi:	almost
luego:	then
muy:	very
mundo:	world
parecían:	they seemed
ya:	of
estaban:	were
cada:	each
todas:	all
todo:	all
cuando:	when
árboles:	trees
su:	are
para:	to
eran:	were
sobre:	on
sus:	their
más:	further
del:	of the
como:	as
una:	a
por:	by
un:	and
se:	with
en:	in
el:	he
la:	the
que:	what
de:	of
