95
:	95
Medievales:	Medieval
sacrificios.:	sacrifices.
holocausto:	holocaust
enseres:	equipment
parecidos:	similar
usaban:	they used
pelear:	fight
elegida:	chosen
lanzas:	spears
clavos:	nails
tenazas:	tongs
vestida:	dressed
románica:	Romanesque
basamento:	base
sangrante:	bleeding
templos:	temples
primeros:	first
edificar:	build
llevaron:	they carried
románico:	Romanesque
pasando:	passing
tomadas:	sockets
puertas:	doors
Mundo:	World
salen:	the hall
empresa:	enterprise
enlistados:	listed
Descubrimiento:	Discovery
realiza:	perform
renacentista:	Renaissance
Porque:	Why
Edad:	Age
Estamos:	We are
antes.:	before.
Vivimos:	we live
siglo:	century
entrado:	entered
hemos:	we have
tiempo.:	time.
retroceso:	recoil
vertiginoso:	vertiginous
esfuman:	vanish
diluyen:	dilute
restan:	remain
años:	years
cierto.:	TRUE.
bonanza.:	see them.
vientos:	winds
reprendió:	rebuked
levantándose:	getting up
poca:	little
hombres:	men
teméis:	topical
¿Por:	By
les:	THE
perecemos;:	we perish;
sálvanos:	scarfed
diciendo::	saying:
despertaron:	they woke up
discípulos:	disciples
llegándose:	arriving
dormía:	I slept
mas:	but
ondas;:	waves;
cubría:	covered
movimiento:	motion
escritura:	writing
monje:	monk
azotadas:	spanked
han:	he
tiempo—.:	time-.
detiene:	stops
Entrada:	Prohibited
capellán:	chaplain
nostri.:	our.
miserere:	to pity
Dómine:	Lord
nostri:	our
Miserere:	To pity
savias.:	swordfish.
yerbas:	herbs
entres:	come in
dejado:	left
morrión:	morion
donadores:	donors
estampa:	print
orando:	praying
alimañas:	vermin
fiebres:	fevers
curtidos:	likes
rancio:	rancid
soldados:	soldiers
Contratación:	Hiring
Libros:	Books
asentado:	settled
algebrista:	algebraist
perfil:	profile
labriego:	laborer
renegridos:	blackened
flacos:	skinny
lados:	sides
ambos:	both
arrodillados:	kneeling
están:	are
—el:	-he
Maíz.:	Corn.
Hombres:	Men
asombro:	astonishment
Oeste:	West
migración:	migration
signos:	signs
plantan:	the plant
nombre:	name
orillas:	shores
arribados:	arrived
Descubridores:	Discoverers
Esta:	This
siglos.:	ages.
cuatro:	four
retrocedido:	regressed
lejanías.:	distances.
semejantes:	similar
escucharon:	they listened
misas:	masses
diferencia:	difference
ninguna:	none
revelación:	revelation
deslumhra:	dazzles
súbito:	sudden
éramos:	we were
figurarme:	figure
divertido:	fun
desde:	from
contemplando:	contemplating
ídolos:	idols
adoradores:	worshipers
nuestro:	our
peligros.:	dangers.
llenos:	full
follajes:	foliage
pesaban:	they weighed
cabezas:	heads
nuestras:	our
Sobre:	On
hacían:	they did
Troncos:	Trunks
Sanctus:	Saint
día.:	day.
triunfantes:	triumphant
catedrales:	cathedrals
entonados:	toned
himnos:	hymns
heroica:	heroic
talados:	felled
jamás:	never
hallando:	finding
hermandades:	brotherhoods
primera:	first
cristiandad:	Christendom
subterráneos:	underground
brotadas:	sprouted
—como:	-as
solemnidad:	solemnity
portentosa:	portentous
cobraban:	they charged
seculares:	secular
inmutables:	immutable
palabras:	words
Aquellas:	Those
garganta.:	throat.
hizo:	those
sequedad:	dryness
dolorosa:	painful
Una:	A
Amén.:	Amen.
Sancti.:	Saints
Spiritus:	Spirit
Filie:	daughter
Patris:	Father's
nomine:	by name
Luego::	Then:
silencio.:	silence.
Hubo:	Was
miedo.»:	fear."
tuviste:	you had
también:	also
barcas:	boats
mismas:	themselves
estabas:	you were
tú:	you
«Recuerda:	"Remember
áspero::	rough:
añadió:	he added
dudas:	doubts
apelando:	appealing
mí.»:	my."
hazlo:	do it
hacerlo:	do it
quieres:	want
Si:	And
indiferente.:	indifferent.
vieran:	they would see
te:	the
quisiera:	I'd like
bautismo;:	baptism;
rehusan:	they refuse
«Hijo:	"Son
mí::	my:
volvió:	came back
crios.:	belt
chillidos:	shrieking
acallaban:	they silenced
colmillos—.:	fangs.
collares:	necklaces
—todo:	—all
respetuosa:	respectful
actitud:	attitude
observaba:	observed
Aldea:	Village
jefe:	boss
miraban.:	they looked
acerca:	about
mascullando:	masculando
pasó:	passed
iconos:	icons
debía:	should
94
:	94
acción:	action
prometida:	betrothed
habló:	speak
religión:	religion
tuviera:	had
poco:	bit
distinta:	different
cosa:	What
tratara:	will try
si:	and
Como:	As
mirada.:	look.
interrogué:	questioned
espíritu:	spirit
daba:	after
Sabiendo:	knowing
sobrecogedor.:	startling.
parecía:	it seemed
lugar:	place
Todo:	All
rituales.:	rituals.
luminarias:	luminaries
situaba:	situated
abría:	opened
Purificador:	Purifier
Ara;:	We buy;
dibujaban:	they drew
Hostia:	Guests
sorpresa:	surprise
creciente:	growing
veía:	saw
disponerlos:	arrange them
mangas:	sleeves
vuelo:	flight
frotaba:	rubbed
herrumbres:	rust
mellados—:	dented—
—algunos:	-some
litúrgicos:	liturgical
objetos:	objects
ornamentos:	ornaments
sacó:	sack
raído:	raido
cuero:	leather
maletín:	briefcase
Luego:	Then
cuello.:	neck.
colgaba:	hung
plantó:	planted
amarillas.:	yellow.
rebosantes:	overflowing
jicaras:	jikaras
grosores:	thicknesses
distintos:	distinct
remendado:	patched
encajes:	lace
dispuesto:	willing
gorjeaban.:	gurgle
corro:	I run
seguido:	followed
saliendo:	leaving
entrando:	entering
danzante:	dancing
ligereza:	lightness
movía:	moved
aldea.:	village.
faenas:	chores
inhabitual:	unusual
alboroto:	riot
observé:	observed
salir:	go out
voces.:	you.
majestad:	majesty
presente:	gift
cabeza:	head
resonaba:	resonated
contrapunto:	counterpoint
manifestándose:	manifesting
enormemente:	enormously
madurado:	matured
abre:	open
durmiente:	sleeping
desperezo:	I stretch
transcurso:	course
regresé:	I came back
Cuando:	When
medida.:	measure.
toda:	all
liberó:	released
contento:	happy
silencio:	silence
Permanecí:	I stayed
mío.:	mine.
parecido:	similar
gesto:	gesture
instrumento:	instrument
sopesando:	weighing
pensaba:	thought
tarea:	task
confiado:	confident
separaba:	separated
instante:	instant
aboliendo:	abolished
destino:	destination
ligado:	connected
estimación:	estimate
propia:	own
crecía:	grew
hasta:	until
inscrito:	enrolled
excepcional:	exceptional
acto:	act
magnífica—:	magnificent—
—pieza:	-part
rescate:	rescue
cumplido.:	compliment.
deber:	duty
trofeos:	trophies
deleitosamente:	delightfully
palpaba:	Pulp
ello:	it
orgulloso:	proud
realmente:	really
alcanzado:	reached
justos:	fair
días:	days
cumplida.:	fulfilled.
misión:	mission
ciclo:	cycle
entraba:	came in
instinto:	instinct
creadas:	created
posesión:	possession
pusieron:	they put
trueques:	barter
concluir:	conclude
primera.:	first.
describiera:	describe
libro:	book
representada:	represented
costados:	sides
encajadas:	fitted
cañas:	white hair
sepultura:	grave
resonancia:	resonance
siniestro:	sinister
sonido:	sound
reviste:	magazines
desagradable:	disgusting
gravedad:	gravity
dotada:	gifted
órgano.:	organ.
antepasados:	forefathers
condición:	condition
Ahí:	There
pantanos.:	swamps.
extraviados:	lost
pescadores:	fishermen
llamar:	call
botuto:	boot
adornos:	ornaments
sonajeras:	rattles
venado:	deer
cuerno:	horn
trompas:	deceives
emplumada:	feathered
atravesada:	crossed
luego:	then
tambores.:	drums.
bastón:	cane
señalaba:	pointed out
empuñadura:	handle
ornamentado:	ornate
cilindro:	cylinder
puse:	side
extraños:	strangers
países:	countries
veinte:	twenty
recorrido:	route
reliquia:	relic
alcanza:	reaches
peregrino:	pilgrim
emoción:	emotion
encomendada:	ordered
colección:	collection
musicales:	musicals
anafre:	ref
suerte:	luck
Allí:	Over there
misión.:	mission.
término:	term
viaje::	journey:
este:	it is
dar:	but
Acababa:	it was over
exclamaciones.:	exclamations.
jubilosas:	jubilant
llamándome:	calling me
apareció:	appeared
93
:	93
dirigía:	directed
esto:	this
Pensando:	Thinking
años.:	years.
tantos:	so many
desempeñado:	performed
inútiles:	useless
eficientes.:	efficient.
envuelto:	wrapped
esqueleto:	skeleton
Cada:	Each
tobillos.:	ankles.
sólidos:	solids
andar:	to walk
ásperos;:	rough;
asir:	captive
dedos:	fingers
utilidad.:	utility.
cumplido:	compliment
cuerpos:	bodies
desarrollo:	development
demás:	others
cabelleras.:	hair
espesura:	thickness
narices:	nose
aguileño:	aquiline
nobleza:	nobility
perfiles:	profiles
alzado.:	raised.
enmarcaban:	they framed
caderas:	hips
maternidad:	maternity
vientres:	bellies
tenían:	they had
remos;:	oars;
esculpidos:	carved
dorsales:	dorsal
potentes:	potent
movían:	they moved
varones:	men
manejo:	management
disciplina:	discipline
severa:	severe
ejercitaban:	they exercised
mozos:	guys
autoridad:	authority
Bajo:	Low
teatro:	theater
propiciados:	propitiated
totalidad:	whole
llegado:	arrived
humano:	human
revelaban:	they revealed
común:	common
maderamen:	wood
fibras:	fibers
recubriendo:	covering
iba:	others
grupo:	group
técnica:	technique
concertada:	concerted
embocaba:	holed
coreógrafo:	choreographer
prestancia:	presence
flechaba:	arrowed
éste:	this
precisión:	precision
soberana:	sovereign
primitivismo.:	primitivism.
vestirlos:	dress them
necesarias:	necessary
esenciales:	essential
desconocían:	they did not know
evidencia:	evidence
salvaje.:	wild.
concepto:	concept
realidad:	reality
ajeno:	unaffiliated
Nada:	Nothing
cultura.:	culture.
dueños:	owners
absolutamente:	absolutely
ámbito:	scope
resultaban:	they turned out
existencia:	existence
margen:	margin
situados:	situated
seres:	beings
considerándolos:	considering them
fantasiosos:	fanciful
relatos:	reports
través:	through
visto:	view
primordiales.:	primordial.
ritmos:	rhythms
sometida:	subdued
vida:	life
tareas:	tasks
concierto:	concert
apacible:	gentle
propios:	own
fueran:	were
ocupaciones:	occupations
entregado:	delivered
cada:	each
mío:	mine
conocidos.:	acquaintances.
cuyo:	whose
remoto:	remote
emanación:	emanation
Su:	They are
orilla:	bank
regresar:	go back
día:	day
impresión:	impression
dado:	given
amante:	lover
Comprendí:	I understood
tez.:	quickly.
aclarar:	clarify
pasadas:	passed
generaciones:	generations
contribuido:	contributed
hubieran:	they would have
silueta:	silhouette
recobraba:	recovered
restregar:	scrub
hueso:	bone
suelto:	loose
pelo:	for the
arrodillarse:	kneel
manera:	manner
mías.:	mine
ropas:	clothes
lavaba:	washed
lechosos:	milky
tubérculos:	tubers
machacaban:	they crushed
ancianas:	old women
rodeada:	surrounded
árbol:	tree
píe:	foot
tejían.:	they wove
algunas:	some
pezones:	nipples
colgados:	hung
crios:	belt
Más:	Further
agallas.:	guts.
ensartados:	skewered
pescados:	fish
trayendo:	bringing
aparecieron:	appeared
anaranjado:	orange
grandes:	big
corrían:	they ran
peonías.:	peonies.
pulsera:	bracelet
diminuta:	tiny
mostrándome:	showing me
inseguras:	insecure
parado:	stopped
Un:	And
negras.:	black.
orillaban:	they bordered
Varias:	Several
estatura.:	stature.
bajar:	lower
momento:	moment
resigné:	resigned
grandeza:	greatness
agobiado:	overwhelmed
Casi:	Almost
árboles.:	trees.
copas:	glasses
llegar:	arrive
lluvia:	rain
quebrarse:	break
acababan:	they finished
rebotes:	rebounds
cien:	hundred
cascadas:	waterfalls
descolgaban:	they picked up
bordes:	edges
geológica:	geological
familia:	family
misma:	same
otras:	others
divisaban:	they saw
valores:	values
ensombramiento:	shadowing
definían:	they defined
evanescencias:	evanescence
planos:	plans
encajado:	fitted
colgado:	hanging
templo:	temple
imposible:	impossible
reflejos:	highlights
belleza:	beauty
razonar:	reason
aceptando:	accepting
telúrica:	telluric
arquitectura:	architecture
desconcertante:	disconcerting
aquella:	that
interpretación:	interpretation
pasmado:	stunned
ánimo:	cheer up
Juicio:	Judgment
celebración:	celebration
destinados:	intended
graderíos:	grades
tronos:	thrones
dioses:	gods
—morada:	-household
fuera:	out
órgano:	organ
tuberías:	pipes
flanqueadas:	flanked
terrazas:	terraces
vertiginosas:	vertiginous
rematadas:	finished
esas:	those
proporciones:	proportions
granito.:	granite.
rotas:	routes
espesas:	thick
nieblas:	fogs
barridos:	swept
hulla.:	corpse.
irisaciones:	iridescence
92
:	92
sombrías:	gloomy
extraña:	strange
cónico:	conical
peñón:	crag
montada:	mounted
arbotantes:	arbutants
ábside:	apse
gótica:	gothic
catedral:	cathedral
increíble:	incredible
Formas::	Shapes:
afirmaba:	claimed
cirros:	cirrhosis
fondo:	bottom
allá:	there
hombre.:	man.
prohibido:	forbidden
reino:	kingdom
estar:	be
parecían:	they seemed
troneras:	enthroned
ni:	in
almenas:	battlements
obsidiana:	obsidian
fortalezas:	strengths
extrañas:	strange
dominadas:	dominated
inmensas:	immense
explanadas:	esplanades
nubes:	clouds
metidos:	stuck up
mausoleos:	mausoleums
ciclópeas:	cyclopean
escaleras:	stairs
espaciadas—:	spaced—
múltiples:	multiple
edificaciones:	buildings
titánica:	titanic
miraba:	looked
Esto:	This
proporciones.:	proportions.
cuestión:	question
punto:	point
renunciar:	give up
tenía:	had
analogía:	analogy
contemplando.:	contemplating.
hallar:	cases
tentaciones:	temptations
ilustradores:	illustrators
alucinados:	hallucinated
fantástico:	fantastic
pintores:	painters
imaginarias:	imaginary
irse:	go
Tenía:	Had
fabulosos.:	fabulous
monumentos:	monuments
verdad:	TRUE
plomada:	plumb
tiradas:	shots
verticales:	vertical
flaneos:	flannels
macizas:	solid
enormes:	huge
alzaban:	raised
gigantescos:	gigantic
detrás:	behind
asombro.:	astonishment.
librarme:	free me
podían:	they could
nada:	nothing
exclamaciones:	exclamations
estupefacto:	thunderstruck
detuve:	I stopped
miré:	Look
salí:	I went out
adolorido:	sore
cuerpo:	body
suelo.:	floor.
dormido:	asleep
habíamos:	we had
recordaron:	they remembered
secar:	dry
puestas:	set
hamacas:	hammocks
brasas.:	embers.
lecho:	litter
rojiviolados:	red-violet
anchos:	wide
tres:	three
aspadas:	swords
pájaros.:	birds.
canutos:	canutes
aspiraban:	they aspired
polvos:	powder
embriaguez:	drunkenness
dispensadora:	dispenser
semilla:	seed
maceración:	maceration
después:	after
sabría:	would know
servían:	served
espejo:	mirror
paletas:	pallets
curare:	cure
taparas:	tapar
envenenados:	poisoned
dardos:	darts
carcajes:	quivers
cerbatanas:	blowguns
caza:	hunting
pesca:	fishing
flechas:	arrows
arcos:	bows
colgaban:	they hung
moriche:	in chili
hojas:	leaves
De:	Of
nalgas.:	buttocks.
cordón:	cord
cintura:	waist
sujeto:	subject
guayuco:	hang on co
oculto:	hidden
apenas:	just
sexo:	sex
desnudo:	naked
varias:	several
amasando:	kneading
Detrás:	Behind
remedio.:	remedy.
probaba:	tried
sólo:	only
estómago:	stomach
llaman:	they call
—del:	-of the
tremendamente:	tremendously
aguardiente:	schnapps
sorbos:	sips
tragar:	swallow
hacerme:	make me
llevara:	will carry
resfrío:	cold
agotamiento:	exhaustion
sensación:	sensation
indios;:	Indians;
aldea:	village
caminata:	hike
desembarco:	landing
Recordé:	I remembered
mí.:	my.
techo:	ceiling
leña.:	firewood.
humo:	in it
Olía:	Oil
delgada.:	slim.
paja:	straw
estera:	foreign
acostado:	lying down
hallaba:	found
despierto:	awake
comprendí:	I understood
viendo:	seeing
dejarlo:	leave it
largamente:	widely
bebí:	I drank
cántaro:	pitcher
agarré:	grip
horas:	hours
muchas:	many
sueño:	dream
Después:	After
junio):	June)
(Miércoles:	(Wednesday
Prueba.:	Proof.
Segunda:	Second
comprendo:	understand
un::	and:
saberme:	know me
varadero:	slipway
canoa:	canoe
descansa:	rest
seguida:	followed
duermo:	I sleep
nerviosa:	nervous
tensión:	strain
Agotado:	Exhausted
remoto.:	remote.
sigue:	go on
Desarrugando:	Unwrinkling
orillas.:	shores.
júbilo:	jubilation
cantan:	they sing
ranas:	frogs
prolongado:	prolonged
rodado:	wheeled
trueno:	thunder
acorde:	chord
sinfonía:	symphony
tremebunda:	trembling
cerrando:	closing
trajo:	brought
rayos:	good heavens
últimos:	last
lleva:	carry
tormenta:	storm
bordas.:	edges.
afincando:	settling
proa:	bow
pararse:	stop
vuelve:	comes back
peligro:	danger
Comprendo:	Understand
año:	year
transcurre:	passes
Acaso:	Chance
Conquista:	Conquest
recién:	newly
Conquistadores:	Pathfinders
columnas:	columns
tus:	the
naves:	ships
acento:	accent
estos:	these
uno:	a
tempestad:	storm
Cáliz:	Chalice
mordidos:	bitten
consigo:	with you
roto:	inside
busca:	search
esta:	this
quien:	who
distancia:	distance
pareció:	it seemed
jarra:	jug
aquello:	that
cierta:	true
todo:	all
juegos:	games
primitivo:	primitive
ritmo:	rhythm
comienzo:	beginning
sido:	been
choza:	hut
dentro:	within
llevaba:	wore
función:	function
Por:	By
fuertes:	strong
ya:	of
arrugado:	wrinkled
oficios:	crafts
cosas:	things
absurdo:	absurd
menos:	less
siempre:	always
Aquellos:	Those
torno:	lathe
misterio:	mystery
muerte:	death
mujeres:	women
cerca:	fence
mucho:	a lot
madres:	mothers
lejos:	far
negras:	black
donde:	where
piernas:	legs
acercó:	approached
remanso:	backwater
ojos:	eyes
antes:	before
ponía:	put
menor:	smaller
buscaba:	I was looking for
Formas:	Shapes
hilos:	threads
campanarios:	bell towers
hecho:	made
ahí:	there
encontraba:	found
semejante:	such
mundo:	world
memoria:	memory
presencia:	presence
árboles:	trees
Allá:	There
Nuestras:	Our
peces:	pieces
ramas:	remaining
Frente:	Forehead
cuyos:	whose
unas:	nails
modo:	way
fuerte:	strong
varios:	several
entonces:	so
Había:	There was
suelo:	floor
aún:	still
nivel:	level
quedaba:	remained
Dios:	God
nuevamente:	again
pecho:	chest
Océano:	Ocean
todas:	all
llena:	full
noche:	evening
fue:	was
cómo:	as
bajo:	low
vez:	time
estaban:	were
objeto:	object
durante:	during
instrumentos:	instruments
existencia.:	existence.
otro:	other
tiempo:	time
cuya:	whose
junto:	together
ser:	to be
aquel:	that
algún:	some
qué:	that
entrada:	Prohibited
hechos:	facts
mano:	thousand
forma:	shape
lado:	side
Pero:	But
cuando:	when
pasado:	past
hubiera:	had
cual:	which
indios:	indians
tal:	of
mí:	my
aquí:	here
Adelantado:	Advanced
hombre:	man
le:	the
ahora:	now
dos:	of the
entre:	between
hacia:	toward
como:	as
La:	The
medio:	half
En:	In
muy:	very
El:	He
algo:	something
estaba:	was
eran:	were
más:	further
para:	to
había:	there was
sus:	their
sobre:	on
su:	are
del:	of the
una:	a
se:	with
un:	and
por:	by
en:	in
el:	he
que:	what
la:	the
de:	of
