111
:	111
mismas.:	themselves.
sí:	Yeah
fuera:	out
empañado:	tarnished
hechas:	made
miraban:	they looked
crónica:	chronicle
conjuntivitis:	conjunctivitis
enrojecidas:	reddened
viejas:	old
pupilas:	pupils
eran:	were
momento:	moment
pertenecerle:	belong to him
dejado:	left
hubiera:	had
pintadas:	painted
venas:	is coming
sienes:	temples
pelos:	by the
llenas:	full
orejas:	ears
enmarañada:	tangled
larga:	long
capuchino:	cappuccino
arrugado:	wrinkled
semblante:	countenance
Todavía:	Still
motivos:	reasons
aunque:	although
enojo:	anger
causado:	caused
preguntándome:	wondering
desconcertado:	embarrassed
sentí:	I felt
resignada:	resigned
intensa:	intense
expresión:	expression
manera:	manner
mí:	my
fijaron:	they fixed
tristes:	sad
inmensamente:	immensely
respuesta:	answer
En:	In
parajes.:	places.
ingratos:	ungrateful
aventurarse:	venture
inutilidad:	futility
consideración:	consideration
burlona:	mocking
permití:	I allowed
instante:	instant
Creo:	Believe
allá.:	there.
misionero:	missionary
Ningún:	No
regiones»:	regions»
sanguinarios:	bloodthirsty
perversos:	wicked
indios:	indians
únicos:	unique
viven:	they live
«Allí:	"Over there
nudoso::	nude:
bastón:	cane
señala:	points out
fraile:	friar
belleza:	beauty
sobrecogedora:	overwhelming
hostil:	hostile
sombría:	gloomy
quebrados:	broken
pizarrosos:	slaty
volúmenes:	volumes
contempla:	contemplate
respira:	breathe
detiene:	stops
descenso.:	descent.
nuestro:	our
iniciará:	will start
borde:	should
alcanzamos:	we reach
rúbricas:	rubrics
nuevamente:	again
pasar:	market
Luego:	Then
frías.:	cold
nieblas:	fogs
extraviados:	lost
veamos:	let's see
desciendan:	descend
cumbre:	summit
sorprenda:	surprise
tarde:	afternoon
bajar:	lower
empezar:	begin
Tenemos:	Have
mediodía.:	average.
proximidad:	proximity
acortan:	shorten
naturales:	natural
obeliscos:	obelisks
sombras:	shadows
cayado.:	crook.
hombro:	shoulder
ligero:	light
dándome:	giving me
contemplación:	contemplation
alucinada:	hallucinated
casi:	almost
arranca:	starts
hombres...:	men...
bocas:	mouths
contorno:	contour
cobraron:	they charged
nombrados:	named
jamás:	never
ignorados:	ignored
crear:	create
inhábiles:	unskilled
nuestros:	our
anteriores:	previous
—obra:	-work
Palabra:	Word
recreadas:	recreated
nombradas:	named
planeta:	planet
desaparecerán:	will disappear
espesor:	thickness
tremendo:	tremendous
hundirme:	inside
arrojarme:	throw me
acabaría:	would end
existía:	existed
fascinar:	fascinate
dejara:	will leave
sé:	see
abismos;:	abysses;
vértigo:	vertigo
invadido:	invaded
demoníaco:	demonic
caldero:	cauldron
Inclinado:	Leaning
Terrenal:	Earthly
Paraíso:	Paradise
rodeaba:	surrounded
diabólica:	diabolical
vegetación:	vegetation
«Esta:	"This
árbol.:	tree.
parar:	to stop
siglo:	century
medio:	half
demoran:	delay
contrario:	contrary
horas:	hours
germinan:	germinate
semillas:	seeds
arrojando:	throwing
año:	year
ritmos:	rhythms
cuyos:	whose
humanos:	humans
tiempos:	time
fecha:	date
viviendo:	living
sigue:	go on
pero:	but
hulla:	corpse
vetas:	veins
petrificado:	petrified
duerme:	sleep
hueso:	bone
pinta:	surface
fósil:	fossil
partes:	parts
otras:	others
contemplar:	contemplate
estupor:	stupor
mudo:	period
Prehistoria.»:	Prehistory.”
últimos:	last
ocultarse:	hide
desiertos:	deserts
saltaron:	they jumped
cordilleras:	mountain ranges
escalaron:	they climbed
ríos:	rivers
atravesaron:	they crossed
alimento:	food
servirle:	serve you
negadas:	denied
rebeldes:	rebels
fraile—.:	friar-.
comienzo:	beginning
huido:	fled
han:	he
«Estas:	"It is
formas.:	shapes.
confusión:	confusion
suprema:	supreme
orgiástico:	orgiastic
mostruoso:	monstrous
acoplamiento:	coupling
posesión:	possession
movimiento:	motion
anuda:	knot
enmaraña:	entangles
enrevesa:	convoluted
abajo:	below
tallo.:	three.
conocer:	know
desgarre:	tear
erupción:	rash
bordes:	edges
salen:	the hall
sanguinolentos:	bloody
pistilos:	pistils
larvas:	larvae
mazorcas:	cobs
colgados:	hung
faroles:	lanterns
bulbosas:	bulbous
madrépora:	madrepora
texturas:	textures
submarina:	underwater
abiertas:	open
tentáculo.:	tentacle.
brazo:	arm
redondez:	roundness
mórbida:	morbid
tienen:	have
ramas:	remaining
cuyas:	whose
membranosas:	membranous
110
:	110
gramíneas:	grasses
yerbas.:	herbs.
pavorosas:	dreadful
medran:	they grow
fondo:	bottom
ámbito:	scope
cráter:	crater
montaña:	mountain
lado:	side
muestra:	sample
Signos:	Signs
extremo:	extreme
otro:	other
lleva:	carry
Ahora:	Now
está...:	this...
marcado:	marked
firmemente:	firmly
dejándolo:	leaving it
herramientas:	tools
atacar:	attack
pudieran:	could
talladores:	carvers
ejército:	army
levantara:	will lift
gigantesco:	gigantic
andamiaje:	scaffolding
erigir:	erect
imposible:	impossible
explicarnos.:	explain to us.
acertamos:	we got it right
mediante:	through
cincel:	chisel
ciclópeo:	cyclopean
ahí:	there
cavado:	dug
alguien:	someone
estrellas:	stars
lunas:	remedy
figuraciones:	figurations
bestias:	beasts
seres:	beings
serpientes:	snakes
figuras:	figures
cambio:	change
Aquí:	Here
arribo.:	arrival.
siglos:	ages
fijada:	fixed
rúbrica:	rubric
dejaron:	they left
egipcios:	egyptians
Noés:	Noah
Noé:	Noah
Pero:	But
nacimiento:	birth
espaldas:	backs
arrojó:	daring
patas.:	paws.
maíz:	corn
mazorca:	cob
hubo:	was
retirarse:	withdraw
comenzaron:	they started
embate:	clash
sordo:	deaf
encalló:	ran aground
llegó:	arrive
mundo.:	world.
este:	it is
abajo.:	below.
habitantes:	inhabitants
primitivos:	primitives
oídos:	ears
llegado:	arrived
tradición:	tradition
repoblador:	repopulator
Diluvio:	Flood
vencedor:	winner
atribuyen:	attribute
dibujos:	drawings
cavados:	dug
aparecen:	appear
alzo:	I get up
aún:	still
habla:	speaks
aniquilan:	annihilate
sublevados:	uprisings
enrabecidos:	enraged
perros:	dogs
ladridos:	barking
atruenan:	I'm sorry
apocalipsis:	apocalypse
pavoroso:	dreadful
mismas:	themselves
moler:	grind
ollas:	pans
platos:	dishes
comales:	eat you
tinajas:	jars
muerte;:	death;
dan:	And
rebelan:	they rebel
ayuda:	aid
usados:	used
inventados:	invented
enseres:	equipment
Creación:	Creation
inicial:	initial
capítulo:	chapter
cuenta:	account
endurecer:	harden
suyo:	his
debió:	should have
estudioso:	scholar
lenguaje:	language
sorprendiéndome:	surprising me
Brujo.»:	Sorcerer."
Aprendiz:	Apprentice
tragedia:	tragedy
máquina:	machine
amenaza:	threat
presentido:	sensed
cosmogonía:	cosmogony
única:	unique
creo:	believe
aún::	still:
adivinación:	guessing
trágica:	tragic
ya:	of
fraile—:	friar-
—afirma:	—states
quitchés:	quitches
antiguos:	ancient
sagrado:	sacred
texto:	text
«En:	"In
desconocido.:	a stranger.
llamado:	called
libro:	book
leído:	read
pregunta:	ask
nuestros.:	our.
coincidente:	coincident
gentes:	people
cosmogonías:	cosmogonies
dificultad:	difficulty
acerca:	about
opinión:	opinion
fácil:	easy
emito:	young ones
revelación:	revelation
Admirado:	Admired
conocido.:	acquaintance.
rituales:	rituals
festivas:	festive
vestimentas:	garments
juego:	game
flautas:	flutes
ornamentos:	ornaments
Tenochtitlán:	Tenochtitlan
emperadores:	emperors
plumas.:	feathers.
adorna:	adorns
cuanto:	how much
mitologías:	mythologies
centro:	center
están:	are
emplumada:	feathered
serpiente:	snake
volante:	steering wheel
advocación:	dedication
bajo:	low
puso:	heart
perfil:	profile
toro:	visiting
caballo:	horse
signo:	sign
marcadas:	marked
tuvieron:	they had
otros:	others
Así:	So
armaduras.:	armor.
hombres:	men
girasoles»:	sunflowers»
«indianos:	«Indians
llamados:	called
conocido:	acquaintance
pincel:	brush
hechos:	facts
tantos:	so many
catalnicas:	catalan
pericos:	parakeets
comadreos:	gossips
arriba:	above
asustados:	scared
techos:	roofs
metidos:	stuck up
desorden:	disorder
alborotoso:	rowdy
oscuro:	dark
listados:	listed
carpinteros:	carpenters
laboriosidad:	industriousness
percutiente:	striking
conocimos:	we met
alzando:	raising
noche;:	evening;
vestidos:	dresses
paujíes:	paulie's
fosforescente:	phosphorescence
suspensión:	suspension
vertiginosa:	vertiginous
inmóviles:	motionless
colibríes:	hummingbirds
Vimos:	We saw
hombre—.:	man-.
solicitan:	request
mejor:	better
pensamientos:	thoughts
malos:	bad
crepúsculo:	dusk
hora:	time
te:	the
¡Dios:	God
gritado::	yelled:
teológico:	theological
—el:	-he
cabeza:	head
soldado:	soldier
luciendo:	showing off
mirar:	look
tucán:	toucan
rosadas:	pink
cotorras:	parrots
fastuosos:	lavish
guacamayos:	macaws
escoltaron:	escorted
109
:	109
florecidos—:	flowered—
orquídeas:	orchids
ricos:	rich
limpios:	clean
caminos:	roads
—por:	-by
jornadas:	days
atravesado:	crossed
hemos:	we have
llegar:	arrive
cuarzo:	quartz
aventada:	suggested
arrojados:	thrown
hubiesen:	they would have
paletadas:	paddles
recogidos:	collected
alud:	avalanche
desprendido:	detached
hubieran:	they would have
bizantinos:	Byzantines
mosaicos:	mosaics
hacen:	do
gravas:	it matters
escorias:	slag
molidas:	ground
calcedonias:	chalcedony
azufre:	sulfur
hecho:	made
parece:	it seems
montañas:	mountains
esqueleto:	skeleton
desnudo:	naked
milenaria:	millennial
erosión:	erosion
obra:	work
aridez:	aridity
grandiosa:	great
cuya:	whose
teratología:	teratology
arcano:	arcane
rompe:	breaks
sacrilego—:	sacrilegious-
decir:	say
intruso:	intruder
poco:	bit
—un:	— and
inquieto:	restless
vagamente:	vaguely
nieblas.:	fogs.
manantiales:	springs
helada:	frost
arrojo:	daring
surca:	furrow
conduce:	lead
terraza:	terrace
destinado:	intended
remoto:	remote
fieltro:	felt
recortadas:	cropped
vegetaciones:	vegetations
escombros:	debris
ruinas:	ruins
derribados:	knocked down
todos:	all
viento:	wind
erguidas:	erected
negras:	black
peñas:	rocks
accidentado:	hilly
esquistos:	shales
suelo:	floor
descansamos:	we rest
petroglifos:	petroglyphs
ascendido:	promoted
evasión.:	evasion.
llaves:	keys
pagado:	paid
habré:	there will be
pongan:	put
bultos:	lumps
torturarme:	torture me
correo.:	mail.
descender:	descend
hacerles:	make them
suya:	to the water
hermana:	sister
encargará:	will order
Allí:	Over there
uso.:	use.
mucho:	a lot
dañado:	damaged
enser:	alike
reponer:	replenish
indispensables:	essential
remedios:	remedies
proveerse:	provide
acostumbrado:	used to
viaje:	journey
haga:	do
Adelantado:	Advanced
meses:	months
algunos:	some
Anunciación:	Annunciation
enviaré:	I will send
solución:	solution
demora:	delay
razón:	reason
cuento:	tale
ceño:	frown
desarrugar:	unwrinkle
comprender.:	grasp.
dolida:	hurt
aleja:	move away
brusco:	abrupt
gesto:	gesture
aparto:	apart
tinieblas:	darkness
caído:	fallen
bramido:	bellow
suena:	sounds
botija:	cylinder
cañas:	white hair
sopla:	blows
resquemores.:	resquemores
desconfianza:	distrust
llena:	full
venido:	come
ausente:	absent
tuve:	I had
tanto:	both
desertado:	deserted
asiento:	seat
vuelto:	turned
hacerlo:	do it
puedo:	I can
restos:	remains
enterrar:	bury
romperlos:	break them
sacar:	withdraw
Debería:	Ought
vitrinas.:	showcases.
fichas:	chips
reclamo:	claim
perpetuo:	perpetually
piezas:	parts
hallaran:	cases
hamaca:	hammock
cabecera:	head
junto:	together
plácidamente:	placidly
usurarios.:	usurers
préstamos:	loans
sacrificios:	sacrifices
empeños:	pawns
entregaron:	they delivered
fondos:	funds
devolviendo:	returning
defección:	defection
responsabilidad:	responsibility
seguramente:	surely
aceptará:	will accept
Curador:	Curator
digo:	I say
fiador.:	guarantor.
desde:	from
evadirme:	evade
Por:	By
pertenecen.:	they belong.
estos:	these
debo:	I must
dinero:	money
mujer:	women
hallé:	I found
fardo:	burden
solté:	I blurted out
selvas:	jungles
presencia.:	presence.
acusadora:	accuser
olvidar:	forget
castigados:	punished
niños:	children
arrinconarlos:	corner them
sirvió:	served
nada:	nothing
objetos-acreedores:	creditor-objects
rodeado:	surrounded
suelo.:	floor.
sonajeras:	rattles
funeraria:	mortuary
jarra:	jug
rodar:	rotate
echando:	of winter
atiesaron:	migraines
humedad:	humidity
hinchadas:	swollen
éstas:	are
protectoras:	protective
esteras:	mats
sujetaban:	they held
desaté:	let go
días:	days
Cuando:	When
dolorosa.:	painful
acompañó:	accompanied
resonante:	resonant
principio:	principle
estudio:	study
confesar:	confess
preciso:	necessary
choza:	hut
está:	this
tambor-bastón-de-ritmo:	drum-rhythm-stick
sugerida:	suggested
fue:	was
instrumento:	instrument
fabricación:	manufacturing
mí.:	my.
ideado:	devised
sonará:	will sound
campanas:	bells
espadaña:	bulrush
ahuecado:	hollow
tronco:	stem
Colgamos:	We hang up
premonición:	premonition
lejanías:	distances
curvas:	curves
líneas:	lines
encuentro:	meeting
repetido:	repeated
quebrado:	broken
gótica:	gothic
figuración:	figuration
tuviesen:	had
había:	there was
milenios:	millennia
plantas:	plants
les:	THE
hojas:	leaves
proceso:	process
enormes:	huge
lugar:	place
regresado:	returned
vasto:	vast
mundo:	world
hondamente:	deeply
paredón:	wall
eso:	that
generación:	generation
ser:	to be
ese:	that
mismo:	same
cuyo:	whose
hallar:	cases
objetos:	objects
él:	he
dios:	God
El:	He
civilizaciones:	civilizations
nombre:	name
insectos:	insects
pájaro:	bird
esmalte:	enamel
Tierras:	Land
árboles:	trees
cada:	each
durante:	during
allá:	there
presencia:	presence
pensar:	think
siento:	I feel
nubes:	clouds
esta:	this
parecen:	they seem
modo:	way
filos:	edges
ahora:	now
día:	day
haya:	these
dentro:	within
dar:	but
enojo.:	anger.
le:	the
Para:	To
conciencia:	awareness
acaso:	chance
esos:	those
esas:	those
sería:	I would be
atando:	tying
estoy:	I'm
golpe:	blow
prueba:	proof
La:	The
suerte:	luck
falta:	lack
pues:	well
dioses:	gods
Estamos:	We are
demiurgo:	demiurge
veo:	I see
plumas:	feathers
fueron:	were
pájaros:	birds
sido:	been
hombre:	man
algo:	something
entre:	between
hasta:	until
algún:	some
alguna:	some
tal:	of
instrumentos:	instruments
ni:	in
todo:	all
ojos:	eyes
donde:	where
si:	and
porque:	why
De:	Of
antes:	before
aquel:	that
estas:	is
dos:	of the
cuando:	when
para:	to
sobre:	on
más:	further
vez:	time
aquí:	here
sus:	their
como:	as
su:	are
se:	with
una:	a
del:	of the
por:	by
un:	and
el:	he
la:	the
en:	in
que:	what
de:	of
