19
:	19
siempre.:	always.
perdido:	lost
modos:	modes
haberlos:	have them
—como:	-as
añoraba:	longed
estío:	state
añorarían:	they would long
preguntaba:	I asked
olmo.:	elm.
sombreado:	shading
departir:	depart
veíase:	looked
abierta:	open
caldero:	cauldron
liebre:	hare
fámula:	fable
escaldaba:	scalded
brasa:	ember
síndico:	receiver
Encendía:	turned on
bodegones.:	still lifes
cocinas:	kitchens
vastas:	answered
época:	era
devolvió:	returned
18
:	18
Cronos:	Chronos
abajo...:	below...
infinito:	infinite
sideral:	sidereal
vértigo:	vertigo
asomándose:	peeking out
primitivos:	primitives
posible:	possible
límite:	limit
sintiéndome:	feeling
fascinado:	fascinated
detenía:	stopped
sílex:	flint
cuchillos:	knives
hachas:	axes
rascadores:	scratchers
vitrinas:	showcases
así:	So
celo.:	even.
sudor:	sweat
boñigas:	bad boy
cardadas:	cardiac
asadas:	roasted
reses:	recess
oliente:	smelly
toda:	all
clasicismos:	classicisms
propios:	own
aventurera:	adventuress
Grecia:	Greece
pesadas:	heavy
alfarerías:	potteries
sepulcrales:	sepulchral
Micenas:	Mycenae
espumajeantes:	foaming
famosas:	famous
fieras:	beasts
ratas:	wheel
migraciones:	migrations
caminos:	roads
tierras:	land
profundas:	deep
merovingia:	Merovingian
llevaban:	they carried
martilladas:	hammered
púas:	barbs
erizada:	bristling
corona:	crown
bárbara:	barbaric
confesor.:	confessor.
absolución:	absolution
pecar:	sin
venia:	was coming
puestas:	set
mozas:	girls
alegres:	happy
lascivas:	playful
semblante:	countenance
ceroso:	waxy
ribaldas:	ribald
escote:	neckline
mano:	thousand
metían:	they put
pelear:	fight
flamencos:	flamingos
gallos:	roosters
echaban:	they threw
chamuscadas:	singed
tetas:	tits
lechones:	piglets
trinchaban:	they carved
donación—:	donation-
constancia:	constancy
—para:	-to
donada:	given
pintar:	clever
especies:	species
tragaban:	they swallowed
abundosamente:	abundantly
medievales:	medieval
burgueses:	bourgeois
convivir:	live together
Agradábame:	Please me
banderolas.:	banners.
afestivadas:	festive
mármol:	marble
cabalgan:	they ride
condottiero:	leader
retrato:	portrait
Renacimiento:	Renaissance
pleno:	full
labriegos:	peasants
descanso:	rest
jolgorio.:	revelry.
disfraces:	costumes
borrachos:	drunk
penitentes:	penitents
inquietantes:	disturbing
máscaras:	masks
Sardina:	Sardine
Entierro:	Burial
seguirlo:	follow him
Dos:	Of the
combates:	fighting
asistir:	watch
románticas:	romantic
estampas:	prints
cementerios:	cemeteries
jardines:	grounds
ópera:	opera
tiendas:	stores
visitaba:	visited
Eran:	Were
museos.:	museums.
ventanas—:	windows-
—casi:	-almost
Lugares:	Places
profanación:	desecration
frustrado:	frustrated
peregrino:	pilgrim
decepcionado:	disappointed
viajero:	traveler
congoja:	grief
aliviar:	relieve
lejanos:	distant
llevó:	he took
misteriosa:	mysterious
familia:	family
impresionista:	impressionistic
Ninfa:	Nymph
universalidad:	universality
súbito:	sudden
Arte.:	until
Historia:	History
estudiantes:	students
destinado:	intended
yeso:	and so
vaciados:	emptied
fotográficas:	photographic
reproducciones:	reproductions
agrado:	please
Observé:	Observed
Congreso:	Congress
Filosofía:	Philosophy
Facultad:	Faculty
Decano:	dean
saludar:	greet
Biblioteca:	Library
aguardara:	wait
suplicó:	begged
larga:	long
arreglo:	arrangement
rapidez:	speed
aturdido:	stunned
Algo:	Something
confiada.:	confident
principales:	main
puntos:	points
detallaban:	they detailed
pliego:	sheet
contrato:	contract
firmar:	sign
despacho:	dispatch
llevado:	carried
despertar.:	wake up.
administrado:	management
droga:	drug
adivinaba:	guessed
decisión:	decision
felicitarme:	congratulate me
cierta:	true
ciencia:	science
supiera:	knew
«¡Enhorabuena:	"Congratulations
gafas.:	glasses.
encima:	on
mirándome:	looking at me
delantal:	apron
compañía:	company
reparación:	repair
temprano:	early
levantado:	up
consulares:	consular
trámites:	procedures
corría:	ran
atenuado:	attenuated
ocre:	ocher
trazos:	strokes
dibujados:	drawn
figuras:	figures
señalando:	pointing
regresar:	go back
verme:	don't give
«Este:	"It is
factura:	bill
17
:	17
pedidos:	orders
salvajes.:	wild.
suma:	addition
habría:	there would be
delito:	crime
bien:	GOOD
sospechoso:	suspicious
tesoraban:	they treasured
museos:	museums
Si:	And
presente.:	present.
primitiva:	primitive
técnica:	technique
debidos:	due
objetos:	objects
obras:	works
descritos:	described
engaño.:	deception.
percataran:	they will notice
directo:	straight
contacto:	contact
envejecidos:	aged
eruditos:	scholars
miraba:	looked
desembolsaría:	would disburse
capacidades.:	capabilities.
valoración:	valuation
exagerada:	exaggerated
responsable:	responsible
venido:	come
Todo:	All
propuesta.:	proposal.
misión:	mission
desdeñada.:	disdained
sentimiento:	feeling
corrieran:	they ran
amargadas:	bitter
serían:	they would be
emprender:	undertake
breves:	brief
vacío:	empty
pensando:	thinking
poste:	afterwards
barrotes.:	bars.
cincuenta:	fifty
dedos:	fingers
rozaría:	would rub
reja:	NEW
acera:	pavement
subir:	rise
iluminada:	illuminated
fríamente:	coldly
atravesar:	cross
tendría:	would have
Más:	Further
rotos.:	broken.
espolvoreados:	sprinkled
vestíbulos:	lobbies
largos:	long
pisos:	flats
cines:	cinemas
rejas:	bars
Cerrábanse:	They closed
bajas.:	lows.
nubes:	clouds
caídas:	falls
gotas:	drops
alfilerazos:	pinpricks
irisaciones:	iridescence
difuminando:	blurring
aceras:	sidewalks
alzaba:	raised
cercanos:	nearby
muelles:	springs
surgida:	arisen
bruma:	Hoar
juez.:	judge.
basalto:	basalt
preferir:	prefer
desollado:	desolate
hombro:	shoulder
montaba:	rode
Sísifo:	Sisyphus
arrojaba:	threw
carga:	load
promovía:	promoted
verano:	summer
propiciaba:	propitiated
aislantes:	insulators
materias:	materials
revestidos:	coated
nuevos:	new
acomodar:	accommodate
sincronización:	synchronization
revisar:	review
necesidad:	need
cenizas.:	ashes
vaciarme:	empty myself
barroco:	baroque
horas:	hours
aparecer:	to appear
visto:	view
amargas:	bitter
razones:	reasons
reproches:	reproaches
lleno:	full
umbral:	threshold
esperarme:	wait for me
sacado:	taken
encontrarme:	find me
despertar:	wake up
sonara:	will sound
teatro.:	theater.
olores:	smells
almohada;:	pillow;
huella:	fingerprint
partida;:	match;
desorden:	disorder
indeciso.:	undecided.
detuve:	I stopped
llovido.:	rained
asfalto:	asphalt
estaño:	tin
coladas:	glued
ponían:	they put
focos:	foci
llaves:	keys
buscaban:	they were looking
hora:	time
pensaban:	they thought
desertados:	deserted
lunes:	Monday
angustias:	anguish
temerosa:	fearful
triste:	sad
particularmente:	particularly
portazo.:	bang.
dando:	giving
burla:	derision
hiriente:	hurtful
desenfado:	abandon
recuento:	count
haciendo:	doing
ropas:	clothes
desenvolviendo:	developing
envolviendo:	wrapping
maletas:	suitcases
arrastrando:	dragging
ajetreo:	hustle
júbilo.:	jubilation.
recibida:	received
nuestro:	our
Regresó:	Return
escuchaba.:	I listened.
largamente:	widely
Hablé:	I spoke
inmundicias.:	filth
arrojar:	throw
invitaran:	they invited
blancas:	white
templo:	temple
majestad:	majesty
mente:	mind
irguió:	erected
rechacé:	I rejected
proposición:	proposition
resultó:	it turned out
denigrante:	degrading
sucia:	dirty
semanas.:	weeks.
él:	he
envejecida:	aged
ejecutada:	executed
venta:	sale
máxima:	maximum
faena:	task
rajaduras:	cracks
insectos:	insects
picadas:	bites
desdorados:	disdorados
siglo:	century
catalanas:	Catalan
vírgenes:	virgins
tallaba:	a beggar
estilos:	styles
vivía:	lived
reproducción:	reproduction
artesanía:	handicraft
trabajos:	jobs
hábil:	skillful
diabólicamente:	diabolically
primitivas:	primitive
medidas:	measures
bocetos:	sketches
acuerdo:	agreement
ejecutados:	executed
irreprochablemente:	irreproachably
fidedignos:	trustworthy
científicos:	scientists
—cabales:	—cables
«primitivos»:	«primitives»
entregaría:	would deliver
honra:	honor
quedar:	meet
colección.:	collection.
impuesto:	tax
itinerario:	itinerary
seguía:	continued
estaría:	would be
Nadie:	Nobody
16
:	16
dinero.:	money.
alcanzara:	will reach
gratamente:	pleasantly
dejándonos:	leaving us
excursión:	excursion
alguna:	some
permanecer:	remain
trataba:	tried
vida:	life
colorido:	colorful
playas:	beaches
hermosura:	loveliness
intento:	tried
fuéramos:	we were
menester:	need
funeraria:	mortuary
tambor-
bastón:	drum-
cane
vivían:	they lived
adonde:	where to
ocurrencia::	occurrence:
repentina:	sudden
explicó:	explained
teníamos:	we had
echó:	threw
despecho:	spite
expresión:	expression
cobraron:	they charged
desagradable:	disgusting
gastos:	bills
sufragado:	suffrage
remotas;:	remote;
pagarle:	pay him
suficiente:	enough
disponía:	had
notar:	uses
hice:	I did
pensado:	thought
«¡Pudiste:	«You could
exclamó.:	he exclaimed.
cretino:	cretin
absolutamente:	absolutely
«¡Pero:	"But
aprovechar:	leverage
escapado:	escaped
atajé:	foreigner
Ebrio.:	Drunk.
Floridas:	Florida
Increíbles:	Incredibles
Flechados:	Arrowed
Sirgadores:	Skimmers
tono:	application
fortuitos:	fortuitous
encuentros:	meetings
llamada:	call
evasión:	evasion
anhelo:	longing
tópicos:	topics
entregó:	delivered
equívoco:	misconception
darme:	give me
traslado.:	transfer.
éxito:	success
inequívocamente::	unequivocally:
significaba:	meant
azafrán:	saffron
plumaje:	plumage
volando:	flying
reciente:	recent
vaticinio:	prophecy
corroboraba:	corroborated
clamando:	crying out
abrazó:	hug
mía:	tight
tarde.:	late.
conversación:	conversation
abruptamente:	abruptly
cambié:	I changed
elogio:	praise
acercó:	approached
realizado:	carried out
finalidad:	purpose
irrisorio:	paltry
satisfecho:	satisfied
obra.:	work.
propia:	own
alcanzado:	reached
buscando:	searching
pasado:	past
zarandear:	from Zaran
acerca:	about
emitidas:	issued
paradojas:	paradoxes
realizar.:	accomplish.
acogido:	welcomed
entusiasmo:	enthusiasm
engañar:	cheat
escena:	scene
impresionado:	impressed
beneficio.:	benefit.
cantidad:	amount
estos:	these
cansaban:	they tired
realizada.:	carried out.
problemático:	problematic
penurias:	hardships
hambre:	hunger
padeciendo:	suffering
materiales:	materials
bienes:	estate
renunciando:	resigning
ascetismo:	asceticism
forma:	shape
cumplían:	they fulfilled
moderna:	modern
urbe:	city
ordenación:	ordering
grandiosos.:	grandiose.
hirvientes:	boiling
prometía:	promised
les:	THE
Poderes:	Powers
fascinados:	fascinated
licor:	liqueur
felices:	happy
distinta:	different
fuerza:	force
sentía:	felt
exentas:	exempt
necias:	foolish
diversiones:	amusements
ganado:	cattle
gastar:	to spend
sabían:	they knew
cuales:	which
negociantes:	dealers
mercaderes:	merchants
problemática.:	problematic.
odiosos.:	hateful
hubieran:	they would have
desórdenes:	disorders
muchos:	many
cultura:	culture
acrobacia:	stunt
mentales:	mental
gimnasias:	gymnastics
lenguaje.:	language.
elíptico:	elliptic
proceso:	process
vertiginoso:	vertiginous
cuán:	how
demostraría:	would demonstrate
fijación:	fixation
mueble:	furniture
debajo:	below
oculto:	hidden
dispositivo:	device
grabar:	gravedigger
incluso:	even
acupuntura.:	acupuncture.
platonismo:	platonism
isabelino:	Elizabethan
teatro:	theater
trascendental:	transcendental
saltos:	heels
gallinas:	chickens
cría:	creates
salvado:	bran
cuantos:	how many
Oeste:	West
granja:	farm
instalar:	install
pretendía:	intended
Angustia:	Distress
Kábala:	Kabbalah
pasaban:	they passed
tornasol:	litmus
15
:	15
desaforado:	unbridled
reuniones:	meetings
divertido:	fun
alzaban:	raised
chimeneas:	chimneys
fábrica:	factory
veraniego:	summer
hollín:	soot
enanos:	dwarves
tilos:	it is forbidden
limpiado:	cleaned
terraza:	terrace
cuerdas:	ropes
tallos:	stems
seda:	this
papeles:	papers
lápices:	pencils
vidrio:	glass
trozos:	pieces
poniendo:	putting
sonoridad:	sonority
marxismo:	Marxism
boxeo:	boxing
entrecruzamiento:	crossover
Aturdido:	Stunned
imposición:	imposition
jaqueca:	migraine
súbita:	sudden
bailarina:	ballerina
curar:	heal
procedía:	came
proposición.:	proposition.
ocultaba:	hid
sonrisa:	smile
casualidad:	chance
prisa:	hurry
eterna:	eternal
multitud:	crew
dentro:	within
anonimato:	anonymity
dureza:	hardness
manuscrito:	manuscript
rechazo:	rejection
descontento:	discontent
fracaso:	failure
congojas:	anguish
desaliento:	discouragement
defenderse:	fend
diariamente:	daily
bebía:	drank
problemáticos:	problematic
resultaban:	they turned out
poderes:	powers
adquirir:	acquire
ello:	it
pretendían:	they intended
amigos:	friends
«matras».:	"mattress".
espiraciones:	exhalations
inspiraciones:	inspirations
respirar:	breathe
haciéndonos:	making us
asamas:	osmosis
emparentadas:	related
prácticas:	practices
más.:	further.
cuántas:	how many
tibetanos:	Tibetans
pitagorismo:	Pythagoreanism
orientales:	oriental
místicas:	mystical
juicio:	judgment
enredaban:	entangled
atrayentes:	attractive
planteamientos:	approaches
cuyos:	whose
enseñanza:	teaching
astrológicos:	astrological
aspectos:	aspects
entusiasmado:	enthusiastic
vocación:	vocation
existencia».:	existence".
esencia:	essence
automático:	automatic
«modo:	"way
actuaba:	acted
común:	common
filosófico:	philosophical
principio:	principle
propio:	own
uso:	use
Invirtiendo:	Investing
fueran.:	were.
éstos:	these
nimios:	too many
presentes:	gifts
nuestros:	our
análisis:	analysis
conciencia:	awareness
estado:	state
ponernos:	put on
«despertarnos»:	"wake up"
apellido:	last name
transformado:	transformed
pronunciación:	pronunciation
llamábamos:	we called
—nunca:	-never
ejercicios:	exercises
tantos:	so many
uno:	a
suspenso.:	suspended.
quedado:	left
ademán:	gesture
frase:	phrase
concluyó:	concluded
Sonó:	rang
rodean.»):	surround.»)
Dormido:	Asleep
dormido.:	asleep.
conciencia.:	awareness.
encender:	light
recordado:	remembered
caja.:	box.
esmeril:	emery
rascar:	scratch
Iba:	Different
diván.:	divan.
sentado:	sitting
Estoy:	I'm
arsis:	burned
detenidos:	detained
Unos:	Some
humo.:	in it.
bocanada:	puff
devolver:	return
aliento:	breath
pronunciada:	pronounced
palabra:	word
esbozado:	sketched
figura:	figure
inmovilizó:	immobilized
entrada:	Prohibited
arrojado:	thrown
enérgico:	energetic
hablábamos:	we were talking
tema:	him
conseguirse:	get
mostrar:	show
arrojando:	throwing
grabador:	engraver
asistente:	assistant
frecuencias»:	frequencies»
especulación:	speculation
verdadera:	true
música:	music
época.:	era.
espíritu:	spirit
simbolizarían:	would symbolize
volumen»:	volume"
anatómicas:	anatomical
«planchas:	«irons
platos:	dishes
bandejas:	trays
pasar:	market
pensaba:	thought
desollados:	skinned
lisiados:	cripples
dibujos:	drawings
mostraba:	showed
dispersarse.:	scatter.
Como:	As
equipos.»:	teams.”
será:	it will be
futuro:	future
equipos;:	equipment;
debe:	has to
equipo;:	equipment;
auténtico:	authentic
Schild:	Sign
und:	and
est:	East
der:	the
Gott:	good
«Como:	"As
publicidad.»:	advertising."
religiosa:	religious
«Toda:	«All
emergían:	emerged
nuevas:	new
voces:	you
abstracto.:	abstract.
amaba:	or
arquitecto:	architect
publicidad»:	advertising"
mosaicos:	mosaics
cerámica—.:	ceramics-.
óleo:	oil
ruso:	Russian
14
:	14
adivinando:	guessing
—gritó:	-shout
evolucionan:	evolve
«¡Donde:	"Where
proyector.:	projector.
cabezas:	heads
Llegaba:	arrived
rojos...:	reds...
terciopelos:	velvets
olientes:	smelling
atosigada:	actsigada
generación:	generation
—radiaba:	—radiated
Orvietano.:	Orvieto.
pregoneros:	town criers
murallas:	walls
empapeladores:	wallpaper machines
paisajes:	landscapes
afeadores:	ugliers
cómplice:	accomplice
consideraría:	I would consider
hojaldres.:	puff pastries
corruscantes:	corruscant
anuncio:	announcement
meridiana:	meridian
salivación:	salivation
dibujo:	drawing
magistral:	highway
provocar:	provoke
humo:	in it
letras:	lyrics
trazar:	draw
equipararse:	equate
considerando:	considering
mío:	mine
hombros:	shoulders
encogido:	shrunken
ejemplo:	example
Eclesiastés:	Ecclesiastes
prosa:	prose
sabía:	knew
amarga:	because
oportunidad.:	chance.
cualquier:	any
aplicándola:	applying it
sentencia:	judgment
contarse.»:	tell yourself.”
falto:	short
torcido:	crooked
Escrituras::	Scriptures:
citar:	quote
viudez:	widowhood
sonaba:	it sounded
oír:	hear
peces.:	pieces
multiplicación:	multiplication
tras:	after
promover:	promote
capaz:	able
actividad:	activity
recursos:	resources
Alacenas:	Cupboards
Altas:	Highs
público:	public
cierto:	TRUE
atención:	attention
atraer:	attract
único:	single
celuloide:	celluloid
lograr:	achieve
oscuras:	dark
extenuado:	exhausted
artistas:	artists
técnicos:	technicians
equipo:	equipment
Un:	And
cooperativas.:	cooperatives.
trabado:	stuck
Pesquero:	Fishing
Consorcio:	Consortium
empleaba:	employed
encargada:	in charge
parido:	given birth
colaboradores:	collaborators
coordinación:	coordination
oficio:	job
alardes:	boasting
encarnizado:	bitter
primera::	first:
satisfacción:	satisfaction
envenenaba:	poisonaba
hecho.:	made.
orgulloso:	proud
menos:	less
ejemplar:	copy
colofón:	colophon
servía:	served
algas:	started
floreado:	flowered
alcanzaban:	they reached
revisión:	revision
tercera.:	third.
rogó:	begged
invitados:	guests
proyección:	projection
segunda:	second
pasara:	passed
pidiendo:	asking
congratularon:	congratulated
encenderse:	light
demás.:	others.
coreaban:	they chanted
oscuridad.:	darkness.
mismo.:	same.
crítica:	criticism
supervisión:	supervision
montaje:	mounting
género.:	gender.
antología:	anthology
figurar:	figure
digno:	worthy
nuestra:	our
especialistas:	experts
vigilancia:	surveillance
oceanógrafo:	oceanographer
colaboración:	collaboration
poeta:	poet
joven:	young
texto:	text
sorprendente.:	surprising.
resultado:	result
enojos:	anger
experimentos:	experiments
perplejidades:	perplexities
discusiones:	discussions
Aquello:	That
combate.:	fight.
secuencia:	sequence
percusión:	percussion
xilófono:	xylophone
desenfreno:	wildness
arpas:	harps
oleaje:	surf
fluidos:	fluids
portamenti:	bearings
arpegios:	arpeggios
líquidos:	liquids
partitura:	score
mejores:	best
Volvían:	They came back
bien.:	GOOD.
trabajado:	worked
Habíamos:	we had
acorazados.:	battleships.
dragones:	dragons
espantables:	frightening
langostas:	lobsters
agrandada:	enlarged
hábilmente:	skillfully
crustáceos:	crustaceans
batalla:	battle
alucinante:	hallucinatory
corales:	corals
anzuelos:	hooks
caracoles:	snails
muertas:	dead
naturalezas:	natures
aquellas:	those
Sargazos.:	Sargasso.
cobrizo:	copper
viñedo:	vineyard
vasto:	vast
anguilas:	eels
llegada:	arrival
pulpo;:	octopus;
desperezo:	I stretch
envolvente:	immersive
oquedades:	cavities
asomadas:	peeking out
lampreas:	lampreys
negras;:	black;
barcas:	boats
cercados:	fenced
peces:	pieces
exasperado:	exasperated
atún:	tuna
pesca:	fishing
ojos::	eyes:
renacían:	were reborn
apagadas:	erased
Ahora:	Now
inmediato:	immediate
determinado:	determined
aceptación:	acceptance
calurosa:	hot
víspera:	eve
presentada:	presented
proyector:	projector
montado:	mounted
quedó:	remained
riendo.:	laughing.
anunció:	advertisement
sorpresa»:	surprise"
«Traemos:	«We bring
palmadas.:	slaps.
ritmos:	rhythms
meros:	heritage
aquellos:	those
preparaba:	prepared
danzarina:	dancer
mujeres:	women
demás:	others
torno:	lathe
fisgoneando:	snooping
13
:	13
decoradora:	decorator
cenar:	have dinner
bebido:	drunk
gente.:	people.
llenó:	full
abrieron:	opened
romántico;:	romantic;
concierto:	concert
furia:	rage
ataqué:	I attacked
espera:	wait
Hastiado:	Jaded
atontado.:	trimmed.
distensión:	distension
causando:	causing
árboles:	trees
escasos:	scarce
—esos:	-those
cerraba:	closed
apetecido:	desired
género:	gender
conocía:	knew
lograba:	achieved
esto:	this
Cuando:	When
físico.:	physical.
nervioso:	highly strung
pasándola:	passing it
fatiga:	fatigue
carácter:	character
tenía:	had
animalidad:	animality
egoísta:	selfish
exigente:	demanding
necesaria:	necessary
regresaba:	was returning
desplantes:	rudeness
enternecía:	moved
siguiente:	following
volver.:	return.
ánimo:	cheer up
huir:	flee
hacía:	toward
discusión:	discussion
estéril:	sterile
cervecerías:	breweries
actitudes:	attitudes
dogmático:	dogmatic
exasperaba:	exasperated
menudo:	slight
ataba.:	he won't be.
deleite.:	treat.
agudo:	sharp
surgiera:	arose
lenguaje:	language
hez:	to
términos:	terms
iguales:	equal
ramera:	harlot
adoptaba:	adopted
hablar:	talk
comedida:	restrained
recibido.:	received.
crudas:	raw
transformando:	transforming
cuerpos:	bodies
reconciliación:	reconciliation
injurias:	insults
intercambiaban:	they exchanged
caras:	guys
abrazarnos:	hug us
tremenda:	tremendous
Reñíamos:	we quarreled
cariño.:	dear.
frases:	phrases
pocas:	few
nosotros:	us
lecho:	litter
terminaran:	they will finish
iniciaran:	they will start
noches:	nights
profesionales:	professionals
ausencias:	absences
tantas:	so many
años:	years
inspiración.:	inspiration.
originalidad:	originality
imprenta—:	printing-
tinta:	ink
debida:	due
primaria:	primary
sobreestimación:	overestimation
desengañado:	disillusioned
estatuas:	statues
monstruos:	monsters
fotomontajes:	photomontages
ilustrada:	illustrated
plaquette:	brochure
dejados:	left
palabras:	words
hacerla:	do it
intentos:	attempts
únicos:	unique
poesía:	poetry
constelaciones.:	constellations.
nombres:	names
bellos:	beautiful
barajando:	shuffling
provecho:	advantage
surrealista:	surreal
baratillo:	dime store
intelectualmente:	intellectually
formado:	formed
velado:	veiled
rostro:	face
videntes:	seeing
creía:	believed
auríspices.:	aurispices.
cayado:	crook
vuelo:	flight
observar:	notice
sacrificadas:	sacrificed
bestias:	beasts
entrañas:	bowels
leer:	file
falta:	lack
adivinatorias:	divinatory
viejas:	old
remozando:	renovating
signo:	sign
borrajas:	borage
angustiarse:	get distressed
escritura:	writing
hebras:	strands
líneas:	lines
aplicación:	application
astrólogos:	astrologers
interrogar:	question
veces—:	times-
—pensaba:	-thought
estar:	be
debían:	they had to
asustados:	scared
Muy:	Very
latines:	Latin
Prognosticum:	Prognostic
Fisonomiea:	Physiognomy
Coeleste:	Heaven
solemnizar:	solemnize
ayudado:	helped
Zodíaco:	Zodiac
signos:	signs
país:	country
localidades:	locations
remotas:	remote
viajaban:	they were traveling
Destinos:	Destinations
Mapas:	Maps
tinteros:	inkwells
aguada:	gouache
sacaba:	took out
tratados:	treaties
curiosos:	curious
adoctrinada:	indoctrinated
Saturno:	Saturn
Cáncer:	Cancer
Júpiter:	Jupiter
Así:	So
gravedad.:	gravity.
regocijante:	hilarious
solicitado:	requested
bastante:	quite
consulta:	consultation
otorgando:	granting
dueña:	owner
correspondencia:	correspondence
manejaba:	drove
horóscopos:	horoscopes
negocio:	business
rendimiento:	performance
inclinarme:	lean
tenido:	had
astrológica:	astrological
competencia:	competence
mofarme:	in mofarm
singularidad:	singularity
útil:	useful
darían:	would give
Hidra:	Hydra
12
:	12
figuraciones:	figurations
esbozadas:	sketched
definirse:	define yourself
resonancia:	resonance
caja:	box
fresca.:	fresh.
Olía:	Oil
octava.:	octave.
última:	last
combinando:	matching
teclas:	keys
jugar:	play
puse:	side
esperara.:	I would wait.
dicho:	saying
papel:	paper
Había:	There was
fotografías:	photographs
adornadas:	adorned
cercano:	nearby
este:	it is
interesaba:	interested
Sólo:	Only
beber.:	to drink.
escapar:	escape
oportunidad:	chance
Aproveché:	I took advantage
cristales.:	crystals.
recio:	tough
percutía:	percutated
contigua:	contiguous
habitación:	room
abrigo:	shelter
aquiescente:	acquiescing
Engañado:	Cheated
rehusar:	refuse
válida:	valid
quedaba:	remained
aserrín:	sawdust
portentoso:	portentous
remontar:	reassemble
privar:	deprive
cuestión:	question
término:	term
llevada:	carried
encomendada:	ordered
razonablemente::	reasonably:
oponer:	oppose
argumento:	argument
apeló:	appealed
ir:	and
alguno:	some
enviarme:	send me
empeñado:	pawned
parecía:	it seemed
tocados.:	touched.
resonar:	resonate
morfológica:	morphological
evolución:	evolution
basados:	based
clasificación:	classification
métodos:	methods
últimos:	last
desconocía:	I didn't know
Afirmé:	I affirmed
intelectual.:	intellectual.
alejamiento:	remoteness
ignorancia:	ignorance
invocando:	invoking
amable:	gentle
Quise:	I wanted
tuve:	I had
absurda:	absurd
espera»:	wait"
tratantes.:	traffickers.
exploradores:	explorers
recientes:	recent
señalado:	indicated
continuidad:	continuity
implicaba:	implied
fraile:	friar
testimonio:	testimony
ritualmente:	ritually
bramar:	bellow
hiciera:	did
pervivencia:	survival
organográfica:	organographic
colección:	collection
ninguna:	none
moribus:	behavior
barbarorum:	of barbarians
descrito:	described
funerarias:	funeral homes
ceremonias:	ceremonies
indios:	indians
caña:	cane
embocaduras:	embouchures
ignoraban:	they ignored
bastón:	cane
injerto:	graft
singulares:	singular
idiófonos:	idiophone
traer:	bring
firmemente:	firmly
confiaba:	I trusted
advertí:	I warned
joven.:	young.
estatura:	stature
crecer:	grow
expuesta:	exposed
Cada:	Each
infancia.:	childhood.
Además:	Besides
especialistas.:	experts.
harto:	fed up
acceso:	access
búsqueda:	search
llevar:	carry
permitiría:	would allow
probada:	proven
física:	physical
resistencia:	endurance
subrayaba:	underlined
pericia:	expertise
hincapié:	emphasis
documentos—.:	documents—.
abundancia:	abundance
única:	unique
pesar:	weigh
incompleta:	incomplete
—todavía:	-still
América:	America
aborígenes:	aborigines
faltaban:	were missing
piezas:	parts
unas:	nails
conseguir:	get
indicado:	indicated
colector:	collector
presentaba:	presented
mí.:	my.
oí:	I heard
alzar:	raise
atreverme:	dare
creciente:	growing
Organográfico.:	Organographic.
edificio:	building
llamando:	calling
teléfono:	telephone
tomó:	took
lentamente:	slowly
levantó:	rose
absolución.:	absolution.
imposible:	impossible
esbozó:	outline
amargura.:	bitterness.
alargarse:	lengthen
dejó:	let
volvió:	came back
apagarse:	go out
telón:	curtain
Hubo:	Was
corpa.:	body
Representazione:	Presentation
adrede:	ready
título:	title
Penitencia:	Penance
Salmos:	Psalms
volúmenes:	volumes
becerro:	calf
estampaba:	stamp
renacentistas:	renaissance
músicos:	musicians
rincón:	corner
pasadas:	passed
épocas:	eras
peldaño:	step
fui:	I went
artesanos:	artisans
hacia:	toward
desierta:	deserted
peso:	weight
personaje:	character
sería:	I would be
cabeza:	head
cuarto:	room
columnas:	columns
falsificar:	falsify
vivir:	live
selvas:	jungles
allá:	there
hacían:	they did
dinero:	money
Le:	The
noticia:	news
contándole:	telling him
equipos:	teams
algunas:	some
trabajaba:	worked
justificación:	justification
algún:	some
proyectos:	projects
orilla:	bank
tarde:	afternoon
salí:	I went out
desconocido:	a stranger
encontraban:	they found
simplemente:	simply
contando:	counting
maneras:	ways
logrado:	accomplished
cosas:	things
sabría:	would know
demasiado:	too much
imponernos:	impose
mandato:	mandate
fósforo:	match
medio:	half
tenían:	they had
cual:	which
desde:	from
gritos:	shouting
cómo:	as
dados:	data
botellas:	bottles
parte:	part
«La:	"The
dejado:	left
pensamiento:	thought
lado:	side
publicidad:	advertising
atravesaban:	they crossed
sombras:	shadows
palcos:	stages
también:	also
quien:	who
ese:	that
enderezar:	straighten
puede:	can
voz:	voice
propósito:	purpose
publicitaria:	advertising
cuentas:	accounts
elección:	choice
dominio:	domain
vez:	time
llegaban:	they arrived
después:	after
nuevamente:	again
maestra»:	teacher"
«Una:	"A
empresa:	enterprise
escrito:	written
meses:	months
tres:	three
costado:	side
parecían:	they seemed
hervor:	out
comienzo:	beginning
copia:	copy
quienes:	who
asistentes:	assistants
apartamento:	apartment
puertas:	doors
eso:	that
iniciales:	initials
año:	year
regreso:	return
sueño:	dream
perenne:	perennial
modificar:	modify
conocidas:	known
momentos:	moments
esos:	those
podían:	they could
cercanas:	nearby
decían:	they said
conocido:	acquaintance
cuanto:	how much
olor:	smell
libros:	books
espejo:	mirror
además:	besides
tener:	have
técnicas:	techniques
contemplar:	contemplate
Después:	After
Cabellera:	Hair
Sagitario:	Sagittarius
Navio:	Ship
comenzaban:	they started
fondo:	bottom
pintura:	paint
borde:	should
objeto:	object
acordes:	chords
caballos:	horses
Tenía:	Had
lluvia:	rain
oferta.:	offer.
verdad:	TRUE
apego:	attachment
posibilidad:	possibility
tarea:	task
nada:	nothing
quería:	wanted to
modo:	way
empeño:	endeavor
presente:	gift
buscar:	look for
reír.:	laugh.
ganas:	desire
repente:	suddenly
«El:	"He
fechas:	dates
hábito:	habit
aunque:	although
tratado:	treated
Servando:	Serving
jarra:	jug
famosa:	famous
ritmo:	rhythm
dándome:	giving me
imaginación:	imagination
razón:	reason
idioma:	language
viejos:	old
regiones:	regions
mundo:	world
galería:	gallery
alabanzas:	praise
mirada:	look
cuyo:	whose
poder:	can
hizo:	those
gesto:	gesture
caer:	fall
di:	Of
puesto:	position
allí:	over there
todavía:	still
mañana:	tomorrow
esta:	this
encuentro:	meeting
cambio:	change
En:	In
esas:	those
mismos:	themselves
sí:	Yeah
caso:	case
decir:	say
solía:	used to
recién:	newly
otro:	other
Luego:	Then
conversaciones:	conversations
ciertas:	certain
gente:	people
hombre:	man
Siempre:	Always
dado:	given
semanas:	weeks
aquel:	that
Una:	A
aquella:	that
todos:	all
decía:	said
mismo:	same
imágenes:	images
película:	movie
aquí:	here
esperaba:	I expected
llegaba:	arrived
hallaba:	found
hasta:	until
mucho:	a lot
estudio:	study
momento:	moment
fue:	was
le:	the
vacaciones.:	vacation.
buen:	good
manera:	manner
pareció:	it seemed
según:	according to
ciertos:	some
miedo:	fear
hacerme:	make me
debía:	should
sido:	been
difícil:	difficult
hecho:	made
hacer:	do
grandes:	big
sorpresa:	surprise
encontraba:	found
pensar:	think
raro:	down
junto:	together
llegado:	arrived
trabajo:	job
obra:	work
siempre:	always
bajo:	low
estaba:	was
pero:	but
días:	days
ojos:	eyes
sólo:	only
noche:	evening
mientras:	while
luego:	then
veces:	times
durante:	during
antes:	before
habían:	had
tal:	of
tanto:	both
unos:	some
otra:	other
Por:	By
dejaba:	left
estaban:	were
llegar:	arrive
pues:	well
La:	The
dijo:	said
otros:	others
silencio:	silence
luces:	lights
algo:	something
viaje:	journey
arte:	until
cada:	each
pintor:	painter
poco:	bit
hombres:	men
cuyas:	whose
tiempo:	time
todo:	all
hubiera:	had
dos:	of the
mí:	my
ya:	of
instrumentos:	instruments
De:	Of
eran:	were
El:	He
día:	day
cuya:	whose
ahora:	now
podía:	could
muy:	very
iba:	others
si:	and
entre:	between
ser:	to be
cuando:	when
Pero:	But
más:	further
sobre:	on
donde:	where
Curador:	Curator
Mouche:	Fly
como:	as
sus:	their
para:	to
había:	there was
su:	are
se:	with
una:	a
por:	by
del:	of the
un:	and
que:	what
el:	he
en:	in
la:	the
de:	of
