151
:	151
Jenofonte.:	Xenophon.
Anábasis:	Anabasis
admiraba:	admired
solamente:	only
apuntar:	aim
faltó:	short
siquiera.:	even.
modificado:	modified
viajaba:	was traveling
minero:	miner
preciosas.:	precious.
yacimientos:	deposits
alientan:	encourage
Responden:	Respondent
viajero:	traveler
Hechicero.:	Sorcerer.
venezolano—:	Venezuelan-
archivos:	files
fonográficamente:	phonographically
grabó:	recorded
shirishanas:	srishanas
descritos:	described
Autana.:	Autoana.
piaroa:	pair
fisonomía:	physiognomy
descubrieron:	discovered
franceses:	French
famosos:	famous
geográfica—:	geographic—
ubicación:	location
—aún:	-still
poblaciones:	populations
nacido:	born
tumultuoso:	tumultuous
Brasil:	Brazil
viniéndose:	coming
ascensión:	rise
incipiente:	incipient
acceder:	access
Uarirén:	The Uariren
Capítulos:	Chapters
distintos:	distinct
Sabana:	Sheet
trocado:	exchanged
gótica.:	gothic.
catedral:	cathedral
Muerto.:	Dead.
Raudal:	Torrent
paraje:	place
oculta.:	hidden
atracadero:	dock
Caño:	Spout
confluencia:	confluence
exactamente:	exactly
América:	America
descrito:	described
fotografiados:	photographed
conocidos:	acquaintances
precisas:	accurate
visiones:	visions
ciñe:	cinema
legítima:	legitimate
aclarar:	clarify
países:	countries
comunes:	common
integran:	integrate
prototipos:	prototypes
provincianas;:	provincial;
latinoamericana:	latin american
ubicación::	location:
capítulos:	chapters
NOTA:	USE
150
:	150
enero:	January
cuchillo:	knife
Corteza:	Crust
aclara:	clarify
ocre:	ocher
escamado:	flaky
próximas:	nearby
mueren:	they die
dulces:	sweets
algas:	started
rocosos:	rocky
espolones:	dewclaws
erizan:	bristle
sumergidas:	submerged
lajas:	slabs
Reaparecen:	They reappear
notablemente:	notably
descendido:	descended
Sísifo.:	Sisyphus.
vacaciones:	vacation
aguarda.:	wait.
Cómitre:	Committee
martillazos:	hammer blows
privado:	private
ensordecido:	deafened
seré:	I will be
Falta:	Lack
—oficio:	-job
sitúa:	situates
historia.:	history.
tangibles:	tangible
testimonios:	testimonials
representado:	represented
adelantarse:	get ahead
desligarse:	disengage
impedida:	prevented
difíciles.:	difficult.
amores:	loves
Romanticismo:	Romance
umbrosas:	shady
mansiones:	mansions
transcurre.:	passes.
ofrecen:	offer
época.:	era.
escapar:	escape
mienten:	they lie
ignorarse:	ignore
rodean.:	surround.
cumplido:	compliment
ardidos:	burning
Navegaré:	I will sail
Manatí.:	Manatee.
embarcar:	embark
pasaje:	passage
tiende:	tends
fui.:	I went.
cenizas:	ashes
devolvió:	returned
trunco—:	trunk
—ahora:	-now
torcido:	crooked
enderezar:	straighten
neumas.:	I don't know.
ordenación:	ordering
lista:	list
contrapuntista:	contrapuntist
exigua:	little
realidades:	realities
Oficios:	Offices
Inventores:	Inventors
portento:	portent
convivencia:	coexistence
recóndita:	hidden
pasé:	happens
edades;:	ages;
viajado:	traveled
actuando:	acting
potencias:	powers
trabada:	stuck
légamo:	let's go
destinos:	destinations
forjan:	forge
costumbres:	traditions
abrigar:	shelter
conversión:	conversion
zozobras:	anxiety
esfuerza:	strive
Apocalipsis.:	Apocalypse.
hacedores:	doers
Prefieren:	They prefer
otra.:	other.
llevadera:	bearable
creen:	believe
intelectual;:	intellectual;
convicción:	conviction
Quienes:	Who
explicados.:	explained.
vividos:	lived
mundos:	worlds
alguna.:	some.
febrilmente:	feverishly
dirigía:	directed
Recuerdo:	Memory
Detenido.:	Arrested.
Tiempo:	Time
Visitador:	Visitor
prestado.:	provided.
Fui:	I went
creído:	believed
agobiadora:	overwhelming
varón...»:	male..."
Naturaleza:	Nature
149
:	149
marido.:	husband.
Mujer:	Women
compasión::	compassion:
retroceder:	back
pretende:	intend
implorante:	imploring
Sacado:	Taken
destruirlo.:	destroy it.
compareciendo:	appearing
estuviese:	was
apelación:	appeal
justificarse:	justify
externas:	external
razones:	reasons
adquiridos:	acquired
derechos:	rights
balbuciente.:	stammering
protesta:	protest
intenta:	try
gaznate:	fizzy
lacerado:	lacerated
gime:	moans
ordenara.:	would order.
echaría:	would throw
movería:	would move
horruras:	horrors
aliento:	breath
recupero:	recovery
desgarradas.:	torn.
toses:	you cough
tragar:	swallow
derramo:	i spill
Lleno:	Full
quemadura.:	burn.
dentro.:	within.
alfileres:	pins
eriza:	hedgehog
ensordecido.:	deafened
Quedo:	I stay
recién...»:	newly..."
griego—.:	Greek-.
«Mujer:	"Women
hace.:	does.
diga:	say
hable:	speak
Agarro:	Grab
fusil.»:	gun."
matarme:	kill me
trabajar::	work:
sacan;:	they take out;
estúpida;:	stupid;
Gente:	People
idiota:	idiot
«Gente:	"People
desconocida:	unknown
viniendo:	coming
sospechado::	suspected:
anunciadores:	announcers
recogió:	picked up
confidencias:	confidences
finge:	pretends
hallazgo:	find
interesarme:	be interested
Adelantado;:	Advanced;
conocí:	I met
hermano:	brother
llamándome:	calling me
aparatosamente:	spectacularly
explotación.:	exploitation.
ofrezco:	I offer
buscarme:	look for me
dejará:	will leave
codicia—.:	greed-.
—cosa:	-What
aguardaré:	wait
dilación::	delay:
resigno:	I resign
Despechado:	Dismissed
escuchen.:	listen.
temiendo:	fearing
piensa:	think
dialogar:	dialogue
zarpar:	set sail
Manatí:	Manatee
avisa:	newspaper
salgamos:	let's go out
difiera:	differ
suplico:	I beg
responde—.:	responds.
«Sí:	"Yeah
preocupa.:	worries.
imponerle:	impose
interesa.:	interest
mapa.:	map.
encontrado.:	found.
tropiece:	tropie
obsesionante:	haunting
denuncio:	complaint
descubrimiento;:	discovery;
desasosegado:	uneasy
Utre.:	Tomorrow
alucinado:	hallucinated
buscados:	wanted
tesoros:	treasures
renuncian:	resign
sesos:	brains
trastornado:	deranged
kilates:	cheilitis
gema:	echo
sueña:	sounds
grandes.»:	big.”
ahogada—.:	drowned.
confía:	trust
catorce:	fourteen
«Diamantes:	«Diamonds
portentoso.:	portentous.
hundió:	sank
busca.:	search.
centinelas:	sentinels
ahumado.:	smoked.
148
:	148
vidrio:	glass
cristalitos:	crystallites
comprimidos:	pills
tubo:	profit
lámpara:	lamp
asegura:	assures
llave:	key
habitación.:	room.
lleve:	carry
ruega:	beg
conspirador:	conspirator
hacía.:	toward.
detenerse:	stop
vacila:	hesitate
atropella:	runs over
hilvanada.:	in the hilvana.
nervioso:	highly strung
nada.:	nothing.
desconfiados:	suspicious
inquietos:	restless
penetrante:	penetrating
griego::	Greek:
rasgos:	traits
cambiado:	changed
semanas.:	weeks.
incisión.:	incision.
penetramos:	we penetrate
anegado;:	waterlogged;
interesa::	interest:
afectuosa:	affectionate
tónica:	tonic
andanzas:	wanderings
halagador:	flattering
avellanado.:	countersunk.
escapara:	will escape
temiera:	feared
agarro:	grab
camisa.:	shirt.
envolviéndome:	involving me
conozco:	know
estalla:	explodes
pegar.:	to take.
retuerzo:	twist
broma:	joke
necia:	foolish
exclamación:	exclamation
brutalidad:	brutality
doblándome:	bending
espinazo:	spine
afinca:	affina
rodilla:	knee
vigorosas:	vigorous
calleja:	quiet
llego:	arrive
reproducción.:	reproduction.
ritos:	rites
Alianza:	Alliance
resignadamente:	resignedly
llegan:	they arrive
importunar:	pester
escudillas:	bowls
lamen:	hand
escuchan:	they listen
taburetes:	stools
acuestan:	they lie down
inconfundible.:	unmistakable.
determinada:	determined
idéntico:	identical
Hace:	Does
Sur.:	On.
sobrecogiera:	would overwhelm
podrían:	could
sistemáticas:	systematic
grabaciones:	recordings
Descubiertas:	Discovered
jaurías.:	packs
perro-chamán:	shaman-dog
misterioso:	mysterious
más—:	further-
—nunca:	-never
invariablemente:	invariably
termina:	ends
duración:	duration
observado:	observed
rocas:	rocks
esucho:	Written by S.
aullidos:	howls
cántico:	chant
entonan:	they intone
vecindario:	neighborhood
picado:	chopped
agudo:	sharp
diapasón:	diapason
ladra:	thief
mandato:	mandate
apaga:	turn off
invertido:	invested
ruidos:	noises
relevo:	relief
espesuras:	thickets
posaran.:	they will put
manzana:	apple
acariciable:	caressable
mutación:	mutation
volumen:	volume
intermitencias:	intermittencies
adelgaza:	lose weight
hincha:	fan
conservando:	preserving
espuma:	foam
esculturas:	sculptures
aislado:	isolated
fragor:	roar
tragantes:	swallowers
estremecidas:	trembling
viaje—.:	journey-.
proseguir:	pursue
—preocupado:	—concerned
esfuerzos:	efforts
aguzado:	sharpened
crítico:	critical
147
:	147
tediosa.:	tedious
resulta:	result
seria:	he would be
fijar:	set
lentitud:	slowness
transcurren:	pass
Simón.:	Simon.
caños:	pipes
invitaciones:	invitations
tentadoras:	tempting
desoyendo:	ignoring
permanezco:	I remain
simientes:	seeds
urgido:	urged
abrigo:	shelter
«También:	"Also
guía.:	guide.
regresará»:	will return"
regresará...:	will return...
promueve:	promotes
dueños:	owners
útiles:	useful
conocedor:	connoisseur
Dicen:	They say
Anunciación.:	Annunciation.
inmovilizado:	immobilized
ratos:	rats
sacándome:	taking me out
burlar:	cheat
Titán:	Titan
irregulares—:	irregular—
estrofas:	stanzas
Voces:	You
ocupo:	I occupy
inicia:	starts
magníficamente:	magnificently
quitado:	taken
carácter:	character
arrumbado:	tidy
árboles.:	trees.
zumbantes:	buzzing
espesan:	thicken
plagas:	pests
llenando:	filling
angustia.:	distress.
semblante...:	countenance...
mudado:	changed
informadores:	informants
barridos:	swept
trastocados:	upset
paisajes:	landscapes
serlo:	be
excepcional:	exceptional
andado:	walked
desandar:	unravel
comete:	commit
demás—.:	others.
negado:	denied
—dueño:	-owner
proponga:	propose
hazaña:	feat
repetir:	repeat
privilegios:	privileges
envanecido:	conceited
repartido:	distributed
trillado:	trite
vivirlo::	live it:
inconscientemente:	unconsciously
excepcionales:	exceptional
entender:	to understand
Buscando:	Searching
aleja.:	move away
adormecida.:	asleep.
darían:	would give
advertida:	warned
misteriosamente:	mysteriously
secuestrado:	kidnapped
sospechar:	suspect
Neolítico:	Neolithic
vuelo.:	flight.
expresarme:	express myself
faltaban:	were missing
cuello:	neck
audífonos:	earphones
146
:	146
Mandatarios:	Representatives
despachado:	dispatched
regresar.:	go back.
tentación:	temptation
decisiva::	decisive:
sometido:	lost
nocturnos:	nocturnal
terrores:	terrors
estrecha:	narrow
apelación.:	appeal.
poniéndome:	putting me
podamos:	we can
demorando:	delaying
creciente.:	growing.
respeto»:	I respect"
«por:	"by
Riendo:	Laughing
entender.:	to understand.
Digo:	I say
desbordado:	overflowed
momentos.:	moments.
alcanzaban:	they reached
recordaba:	I remembered
algo.:	something.
descompuesto:	decomposed
volvemos:	we return
machetazos.:	machetes
afincarse:	settle
mide:	stomach
encontrarla::	find it:
podremos:	we can
mojarse:	get wet
vara:	be
echar:	throw
apoyo:	support
hunde:	dogs
proa:	bow
meterse:	get in
borda:	edge
caigo:	I fall
sentencioso:	sententious
«Posible:	"Possible
posible»:	possible"
idénticos:	identical
mansedumbre.:	meekness.
considerando:	considering
contratiempo.:	setback.
últimamente:	lately
marchado:	left
augurio.:	best wishes.
parecería:	it would seem
percance:	mishap
mañana.:	tomorrow.
tengamos:	we have
caiga:	fall
inverso:	reverse
remando:	rowing
lleno.:	full.
comenzamos:	we start
marca.:	mark.
hoias.:	hoya
dintel:	lintel
estrecha.:	narrow
jambas:	jambs
erguidos:	erected
Eran:	Were
fuerza.:	force.
advertirla:	warn her
valla:	municipality
seguimos:	we follow
troncos.:	trunks.
examinando:	examining
sigo:	I continue
ironía:	irony
imagino:	I imagine
navegado.:	navigated.
virar:	to turn
recordaría:	I would remember
espolón:	spur
Navegamos:	We sail
encontrarlas.:	find them.
habremos:	we will have
borra:	drill
existen:	there are
superpuestas.:	overlapping.
aparecido:	appeared
ninguno:	none
absurdo::	absurd:
mareo.:	dizziness.
iguales:	equal
afianzando:	strengthening
apartarla:	put it away
chistar.:	joke
indicaciones:	indications
rayo:	ray
segundos;:	seconds;
145
:	145
distraído:	distracted
cuenta;:	account;
darme:	give me
asaltan:	assault
tronco.:	stem.
fatigan:	exhausting
adelante.:	forward.
Seguimos:	We follow
interroga.:	question.
despacio:	slowly
infinito.:	infinite.
alargarse:	lengthen
verticalmente:	vertically
superpuestas:	overlapping
lenta:	level
acercamos:	we approach
mirada.:	look.
alcanza:	reaches
señalo:	I point out
revueltas:	revolts
bochorno:	embarrassment
proseguimos:	we continue
Culcán...:	Culcan...
emplumadas::	feathered:
triada:	triad
presididos:	chaired
lanzados:	launched
Guacamayos-
Bólidos:	Macaws-
Racing cars
Cóndores-Mensajeros:	Condors-Messengers
Pájaros-Soles:	Birds-Suns
Águila-Rocío:	Eagle-Dew
Pájaro-Trueno:	Thunder-Bird
majestades:	majesties
desfile:	parade
montañas—:	mountains-
mirarlos:	look at them
dibujados:	drawn
pintados:	painted
ornadas:	ornate
aquellas:	those
empinado:	prancing
graznar:	grazier
esquimales:	eskimos
Pájaro-Espíritu:	Spirit-Bird
Pájaro:	Bird
desempeñados:	performed
pluralidad:	plurality
espantos:	frights
poniendo:	putting
omnipresencia:	omnipresence
concierto.:	concert.
alborotar:	disturb
espesura:	thickness
garzas:	herons
bandada:	flock
triángulo:	triangle
aplausos.:	applause.
abofetean:	in the palm of your hand
plomizas:	leaden
aletas:	fins
erizando:	erizing
encima:	on
atropellan:	run over
chocan:	they collide
saltan:	they jump
peces:	pieces
cardumen:	shoal
oscurecido:	darkened
migraciones:	migrations
azufre.:	sulfur.
sacarlo:	take it out
enjambres:	swarms
pegar:	to take
bastaría:	would be enough
moverse:	move
apretadas:	tight
mariposas:	butterflies
miríadas:	myriads
revolotean:	they flutter
húmeda:	wet
riberas:	banks
estación:	season
llovido:	rained
anegado.:	waterlogged.
estuvo:	was
caudalosa:	mighty
particularmente:	particularly
crecida:	spate
fibras:	fibers
podrida:	rotten
abrieron:	opened
levantaron:	they lifted
adentro:	inside
crecidas:	floods
literalmente:	literally
reventado:	busted
apoderarse:	seize
Han:	He
abandonada.:	abandoned.
atracamos:	we dock
asomarse:	lean out
Acaba:	It's over
144
:	144
quiero.:	wanna.
afinco:	hard
servirlos—.:	serve them.
galeras:	guys
espaldero:	espalier
bogavante:	lobster
dilema::	dilemma:
excluye:	excludes
Mundo:	World
Reino:	Kingdom
plantea:	poses
partes.:	parties.
Pruebas;:	Evidence;
consciente:	conscious
amanecidos.:	dawns.
albor:	dawn
macerar:	macerate
recogiendo:	picking
Rúbricas:	Rubrics
ostenta:	boasts
escapé:	exhaust
Sonrío:	I smile
apremio.:	pressure.
dolorosos:	painful
embates:	clashes
duro:	stand
corto:	short
vellón:	fleece
pálpito:	palpito
sopesar:	balance
tiñe:	dyes
circunda:	surrounds
volverme:	come back
torrentes:	torrents
muslos;:	thighs;
cierne.:	hovers.
hablan:	they talk
inútiles:	useless
Huyo:	That one
hago:	do
bolge.:	area.
tenazas:	tongs
Miedo:	Fear
miedo::	fear:
asalta:	assault
edición.:	edition.
imponga:	impose
buscar;:	look for;
canse:	get tired
alejarlo:	push it away
conjurarlo:	conjure it
superstición:	superstition
vaga:	vacancy
cumplir:	achieve
precaución:	caution
elección:	choice
umbrales:	thresholds
laberinto.:	maze.
abrió:	opened
romántico:	romantic
falso:	false
acierto:	success
zanjado:	ditched
agüero.:	omen.
tejen:	save
alivio.:	relief.
deliciosa:	delicious
Seguro:	Insurance
aldea...:	village...
siguiendo:	following
desprendo:	I detach
Llegado:	arrived
agarrara:	will grab
brújula:	compass
ramas.:	remaining.
abovedado:	vaulted
pasadizo:	anecdote
identificación:	ID
incisa:	engraved
Buscaré:	I will search
cordel:	string
trazada:	traced
muralla:	wall
—aquella:	-that
tenemos:	have
guiarlo:	guide him
comprometo:	I commit
contrafuertes:	buttresses
navegado:	navigated
rumbo.:	course.
remeros:	rowers
seguiré:	I will continue
tambores:	drums
colección:	collection
destinados:	intended
encontré:	I found
llevarme:	take me
143
:	143
mayores.:	older.
patronas:	cartridges
Inés:	Agnes
Otro:	Other
sembraba:	sowed
levantaba:	lifted
inexplorados:	unexplored
revela:	reveals
repiten:	they repeat
puestas.:	set.
bragas:	panties
barbudos:	bearded
Carpintero:	Carpenter
así»:	So"
caño.:	spout.
buitres:	vultures
encontrara:	will find
curiara:	court
pusieron:	they put
dominios:	domains
hollar:	cases
pretendieron:	they intended
aviso:	Notice
hermanos:	siblings
tórax:	chest
flechas:	arrows
respuestas:	answers
trueque.:	barter.
mercancías:	goods
navegados:	navigated
remontar:	reassemble
Aguinaldos:	bonuses
zapatero:	shoe
aindiado:	further
lento:	this
ataúdes:	coffins
medía:	average
carpintero:	carpenter
manatíes:	manatees
Pescador:	Fisherman
Ahí:	There
rato—.:	mouse-.
comensales:	diners
vasos:	vases
Pido:	I ask
cenizas.:	ashes
grisura:	torn
arrugada:	wrinkled
vejez:	old age
resplandeciente:	resplendent
rescoldo:	ember
sabiduría:	wisdom
ardorosa:	ardent
lumbre:	fire
desconocidas.:	unknown.
bellotas:	acorns
danta:	interest
pernil:	ham
chisporrotea:	sizzles
chimenea:	chimney
vainilla:	in vain
terrateniente.:	landowner.
poseedor:	holder
ello;:	it;
rezando:	praying
proclama:	proclamation
hato:	there
horcones:	forks
cobija:	blanket
tomarlo::	take it:
deslindes.:	demarcations.
cercados:	fenced
innato:	innate
mudar:	to change
estuario:	estuary
inmensas.:	immense.
transporte:	transport
precarios:	precarious
cultivado:	cultivated
sustos:	scares
enrolladas:	rolled up
largas:	long
echándose:	laying down
consideran:	consider
naturalidad:	naturalness
doce:	sweet
solteras:	single
compró:	bought
siglo.:	century.
frascos:	jars
medicinas:	medicines
aceites:	oils
bálsamos:	balms
pólvora:	gunpowder
latas:	cans
estantes:	bookshelves
rincones:	corners
rollos:	rolls
mixta:	mixed
comedor:	dining room
transformada:	transformed
catedral.:	cathedral.
resonancia:	resonance
tinaja:	jar
matas;:	fed;
142
:	142
viejos.:	old
cromos:	trading cards
cándido:	candid
habitaciones:	rooms
alejándose:	moving away
correas:	straps
reventarles:	burst them
llenan:	fill
pesaran:	retirement
empila:	stacked
mozos:	guys
maletas:	suitcases
agarra:	grab
importancia.:	importance.
acercado:	approached
enorme:	huge
mecidas:	measures
tejado:	roof
sorpresa::	surprise:
dolorosa:	painful
detuve:	I stopped
guiaba:	guided
muchacho:	young guy
derrota:	defeat
vencido:	won
retarla:	challenge her
mismo::	same:
otorgarse:	be granted
mejillas.:	cheeks.
nariz:	nose
desfiguro:	disfigure
detener:	arrest
invocando:	invoking
morían:	they died
muertes:	deaths
causaron:	caused
cuerpo.:	body.
impuestas:	imposed
mutilaciones:	mutilations
sangrientas:	bloody
ablaciones:	ablations
Puedo:	Can
desmenuzado:	crumbled
escuadrado:	squared
castrado;:	castrated;
Tal:	Of
viejísimo:	very old
remembranza:	remembrance
arrancado:	torn off
pedernal:	flint
flacas:	skinny
costillas:	ribs
levantando:	lifting
flecharlo:	arrow it
desnudado:	stripped
aduanas:	customs
almacenes:	warehouses
caminando:	walking
seguí:	I continued
crucé:	crossing
amaneció:	it dawned
Incapaz:	Unable
dormidos.:	asleep
hospitales:	hospitals
funerarias:	funeral homes
desiertas:	deserted
lonjas:	markets
anduve:	I walked
regresaría:	I would return
huí:	I fled
vestí:	I dressed
advertencia.:	warning.
horrenda:	horrible
llegara:	will arrive
echada:	cast
Asunción:	Assumption
artículo—:	article-
—decía:	—he said
Petroglifos.:	Petroglyphs.
emprendido:	undertaken
entrecana.:	grey-haired
lucía:	lucia
tomada:	outlet
él.»:	he."
retrato:	portrait
conocimos;:	we met;
«Creo:	"Believe
barato:	AFFORDABLE
impreso:	printed
boletín:	bulletin
Abriendo:	Opening
verdadero.:	TRUE.
suscripción:	subscription
aceptado:	accepted
sorteando:	raffling
compartiera:	would share
monja:	only
religiosa:	religious
pequeña:	small
velador.:	pedestal table.
hallaba:	found
publicación:	publication
tomó:	took
141
:	141
favorables.:	favorable.
recobrado:	recovered
sintió:	felt
tomarse:	take
amenazadoramente:	threateningly
cerraba:	closed
asimilaba:	assimilated
cortada:	cut
espíritu::	spirit:
sorprendente:	surprising
cobraba:	charged
tuviera—:	had—
personificándose:	personifying
conjunto:	set
Sagitario:	Sagittarius
consultas.:	consultations.
preferible:	preferable
pago:	pay
poseída:	possessed
prostituta:	prostitute
Cualquier:	Any
desprecio.:	contempt.
volvía:	came back
triste:	sad
envuelve.:	wraps
une:	a
definitiva:	definitive
sorpresas:	surprises
decepción:	disappointment
inhabitual:	unusual
abstinencia:	abstinence
quiso:	wanted
accedí:	I agreed
manejó:	management
hábilmente:	skillfully
comprometería:	would compromise
afirmó:	stated
consecuencia;:	consequence;
privarme:	deprive myself
necio:	foolish
trató:	deal
holgadas:	baggy
ponerse:	put on
permiso:	permission
llenó:	full
terminadas.:	finished.
astrológicas:	astrological
consultas:	queries
temprano:	early
alevosía:	treachery
entereza:	fortitude
socavar:	undermine
arreglarse:	get ready
moderación.:	moderation.
cuidando:	caring
miseria:	misery
crédito:	credit
seducción:	seduction
intentos:	attempts
frustrar:	frustrate
decidido:	decided
margarina;:	Margarine;
hedor:	stench
alumbrada:	lighting
compañía:	company
toleraba:	tolerated
abrazado:	embraced
fiebre:	fever
verdaderos.:	true.
magnánimamente:	magnanimously
atribuyéndolo:	attributing it
enfermara:	nurse
echaba:	threw
rectamente—.:	uprightly-.
mentir:	lie
confianza:	trust
inocente:	innocent
Nicolás.:	Nicholas.
rojizo:	reddish
remozado:	renovated
lujuria.:	lust.
pecado:	sin
castigan:	punish
llagas:	sores
humores:	moods
siguientes:	following
arrepentimiento:	repentance
preparándose:	getting ready
plegaria:	prayer
unía:	united
juntos:	together
reñido:	close
desamparo.:	helplessness.
dejando:	leaving
cedería:	would give in
tocador:	dresser
mármol:	marble
revueltos:	scrambled
afeites:	you leave
percibir:	perceive
calados:	silent
cintas:	ribbons
cubrecama:	bedspread
rezaba:	prayed
amenazaba:	threatened
Dios:	God
agarrarse:	hold
aterrorizada:	terrified
sufrimientos::	sufferings:
indecibles:	unspeakable
producía:	produced
desdoblamiento:	unfolding
140
:	140
impedirlo.:	prevent it.
luchaba:	fought
burdel:	brothel
condujera:	would drive
parecida:	similar
aquiescencia:	acquiescence
afirmada:	asserted
definido:	defined
escozor:	stinging
muslos:	thighs
conocida:	known
apesadumbra.:	sorrow
discutir.:	to discuss.
escucharla.:	listen to it.
hablarle.:	talk to him
fuera.:	out.
nueve:	nine
Siete:	Seven
haré:	I will
consulta:	consultation
«Si:	"And
voz::	voice:
libro.:	book.
socarronamente:	slyly
cercano.:	nearby.
librarse.»:	get free."
circunstancias:	circumstances
vinculada:	linked
Psicoanálisis::	Psychoanalysis:
afecto.:	keen.
ningún:	none
desea:	want
perspectiva:	perspective
ocultas::	hidden:
Ciencias:	Sciences
posición.:	position.
Egipto::	Egypt:
«CÁRCEL.:	"JAIL.
sueños::	dreams:
interpretación:	interpretation
hojear:	leaf through
librería:	bookshop
entro:	within
Carceri:	Prisons
di:	Of
Invenzioni:	Inventions
aguafuerte:	etching
colorido:	colorful
caballo.:	horse.
sonaba:	it sounded
subterráneos:	underground
frente.:	forehead.
desviación:	deviation
ligera:	light
lontananza:	distance
multiplicaban:	they multiplied
suplicio:	torture
mecían:	rocked
pilares:	pillars
catedrales:	cathedrals
naves:	ships
prisión:	prison
soñé:	I dreamed
Anoche:	Last night
augurios:	omens
Busco:	I'm looking
prensa.:	press.
horóscopos:	horoscopes
excelente.:	excellent.
vitrina;:	showcase;
expuesta:	exposed
agüero:	omen
araña:	spider
presagios:	omens
imposibilidad:	impossibility
Abetos:	Fir trees
Contemplo:	I contemplate
resuello.:	wheeze.
asomaba:	appeared
fogatas:	campfires
mojadas:	wet
leñas:	firewood
tacto:	touch
Algunas:	Some
aplacamiento.:	appeasement.
procura:	search
adormilan:	sleepy
otoño:	autumn
herrumbrosos:	rusty
conducen:	drive
caminatas:	walks
interminables:	endless
emprendo:	I undertake
encaja:	fits
viene.:	he comes.
Tarda:	Afternoon
suspende:	suspend
¡Ay:	Yes
alusiones::	allusions:
lacerantes:	tearing
cargarse:	load
tierna:	tender
encontrarme:	find me
amargura:	bitterness
fortuitos—.:	fortuitous.
asombrosa:	amazing
trastocaron:	disrupted
—día:	-day
casualidad:	chance
misteriosa:	mysterious
abriera:	would open
hagiografía:	hagiography
iniciales:	initials
estampan:	stamp
encuadernado:	bound
139
:	139
Servando:	Serving
maravilladas:	amazed
lecturas:	readings
anunciando:	advertising
moblaje:	furniture
paquete:	package
cazuela:	casserole
armarios.:	wardrobes.
cocinan:	they cook
fuman:	they smoke
agujereadas:	perforated
suelas:	soles
nieve:	snow
camisa:	shirt
lavan:	stage
acercando:	approaching
lanzado:	launched
masa:	time
cordeles:	twine
entretejen:	interweave
calles:	streets
ir.:	and
semana.:	week.
cobrarlos:	charge them
desgana:	reluctance
ejecuto:	I execute
instrumentación:	instrumentation
encargos:	charges
pequeños:	small
cuantía:	amount
necesito:	need
divorciado:	divorced
aspirantes:	aspirants
infructuosamente:	vainly
buscado:	sought
estudios.:	studies.
asistente:	assistant
antiguo:	ancient
publicitaria:	advertising
perdona:	sorry
Tampoco:	Neither
derramadas.:	spilled.
margarinas:	margarine
alfombras:	rugs
Catorce:	Fourteen
estudiantes:	students
experto:	expert
advirtiendo:	warning
recibe:	receive
luminosos.:	luminous.
anuncios:	advertisements
aceras:	sidewalks
encontrándome:	finding me
firmar:	sign
firmo:	the company
secretarios:	secretaries
interrogo:	I ask
aguardo:	I wait
puertas:	doors
viajo:	I travel
esquinas:	corners
doblo:	doublo
eliminada:	eliminated
antes.:	before.
embrollo:	imbroglio
negaba—.:	he denied.
procedimiento:	procedure
amoralidad:	amorality
tornear:	turn
plenamente:	fully
darse:	give
sacrificando:	sacrificing
vacilado:	hesitated
santuario:	sanctuary
impuesta:	imposed
cotidiano:	everyday
torturara:	will torture
Secesión:	Secession
escenario:	scenery
vendimia.:	vintage.
viña:	came
edifica:	build
Escrituras:	Scriptures
despreciable:	negligible
gravidez.:	pregnancy.
indicio:	indication
explota:	explode
enredado:	tangled
simplificar:	simplify
alarma.:	alarm.
embarazo:	pregnancy
nación.:	nation.
jueces:	judges
herida:	wound
representando:	representing
empeñada:	pawned
carmín:	carmine
vestida:	dressed
encarnizada:	fierce
difuminar:	blur
internacional:	International
vil:	will
Tuve:	Had
abominación.:	abomination.
transgresor:	offender
considerarme:	consider me
Pastores:	Shepherds
alboroto:	riot
gastado:	spent
perdonaba:	forgave
instancia:	instance
trampa:	trap
tembloroso.:	trembling.
dejándome:	leaving me
dobló:	folded
reportaje:	reportage
devueltas:	returned
138
:	138
octubre):	October)
cómitre.:	comitre
mazo:	the small
Hombre-Ninguno:	Man-None
Hombre-Avispa:	Wasp-Man
condición:	condition
acepto:	I accept
Génesis.:	Genesis.
luminarias:	luminaries
intacto;:	intact;
nacido.:	born.
envejece:	gets old
cansa:	tired
contemplarlo;:	contemplate it;
futuro.:	future.
pretérito:	past tense
barajado:	shuffled
posibles—.:	possible—.
Icarias:	Ikarias
permitidas:	permitted
Utopías:	Utopias
—del:	-of the
porvenir:	future
acordándome:	remembering
lugar::	place:
componían:	they composed
limón:	lemon
recio:	tough
sabor:	flavor
dividido.:	divided.
contado:	counted
laberintos:	labyrinths
laberinto:	maze
espacio.:	space.
lanzadas:	thrown
frases:	phrases
cornisas:	cornices
pregonados:	heralded
títulos:	titles
expuestas:	exposed
cubiertas:	covers
anuncia::	announces:
lugares—.:	places—.
muevan:	move
islas:	islands
higos:	figs
caigan:	fall
Sello:	Seal
Sexto:	Sixth
apertura:	opening
devuelto:	returned
ocurrir.:	occur.
frutas:	fruits
simiente:	seed
publicidad;:	advertising;
tensos:	tense
interpelaciones:	interpellations
servidumbres;:	easements;
colectividad:	community
reprimenda:	reprimand
miedo.:	fear.
atajado:	shortcut
impulso:	impulse
rebeldía:	rebellion
profunda:	deep
apetencia:	appetite
destinos.:	destinations.
forjarse:	forge
humano:	human
propuesta:	proposal
máxima:	maximum
biblioteca.:	library.
yacían:	lay
profundo:	deep
esencias:	essences
fortuitos:	fortuitous
resueltos:	resolved
llevaban:	they carried
reflexiones:	reflections
Estas:	It is
creadores.:	creators.
imitando:	imitating
Occidente:	West
renovar:	renew
Querían:	they wanted
perseguida.:	persecuted.
cartesiano:	Cartesian
cogitante:	thinking
calificador:	qualifier
colocaban:	they placed
«bárbaras»:	«barbarians»
calificadas:	qualified
—
cosas:	—
things
cumplían:	they fulfilled
bárbaras:	barbarians
barbarie:	barbarism
Buscaban:	They were looking
Método:	Method
Discurso:	Speech
clavos:	nails
137
:	137
erizados:	bristling
fetiches:	fetishes
africanos:	Africans
blandían:	the mixture
risible:	laughable
resultaba:	it turned out
razón.:	reason.
debieran:	should
fervores:	fervor
savias:	swordfish
rejuvenecerse:	rejuvenate
cansada:	tired
veinte:	twenty
Durante:	During
primitivos—.:	primitives—.
batería:	battery
instintivas:	instinctive
energías:	energies
perdida:	lost
pintores:	painters
interrogaban:	they interrogated
terribles:	terrible
enigmáticos:	enigmatic
adoradores:	worshipers
vaciados:	emptied
difuntos:	deceased
ídolos:	idols
exhiben:	exhibit
pintura:	paint
vitrina:	showcase
plazas:	places
bosta:	they will be
zócalos:	sockets
magistralmente:	masterfully
cubriendo:	covering
monumentos:	monuments
soñando:	ringing
apisonar—.:	अपिसोनार—.
comunica:	communicate
seda:	this
barreras:	barriers
contactos:	contacts
abrazos:	hugs
propiciando:	enabling
apagan:	turn off
rítmicos.:	rhythmic.
reducido:	reduced
compás:	compass
movida:	moved
ingredientes:	ingredients
encajados:	embedded
intríngulis:	intrigued
rodea.:	surrounds
Reconocido:	Recognized
filtraciones.:	leaks.
bóveda:	vault
remeda:	remedy
raso:	satin
burgués»—.:	bourgeois"-.
«espíritu:	"spirit
llamaba:	called
reciente:	recent
fiel:	fell
—aunque:	-although
rancios:	stale
locura:	craziness
nada—:	nothing-
—muniqueses:	—muniques
rococós:	rococo
castillos:	castles
panorámicas:	panoramic
vistas:	views
Hornig:	Horny
cochero:	coachman
Baviera:	Bavaria
agrandadas:	enlarged
gruta:	cave
intermitentemente:	intermittently
rozados:	rubbed
pezones:	nipples
giratorio:	rotary
montados:	mounted
móvil:	mobile
anatómicas:	anatomical
hipocampos:	hippocampi
iluminadas:	illuminated
grutas:	caves
ahondan:	they delve
trozos:	pieces
estuco:	stucco
construcción:	construction
montado:	mounted
estrado:	platform
astrágalo.:	astragalus.
vestidas:	dressed
cornisa:	cornice
clepsidra:	hourglass
metrónomo:	metronome
hormigas:	ants
comido:	eaten
costillar:	rib
exangüe:	bloodless
Gorgona:	Gorgon
ignorar:	ignore
desollados:	skinned
desesperanza:	hopelessness
agobiados:	overwhelmed
pétreos:	stony
falos:	will fall
muletas:	crutches
ciclistas:	cyclists
bicicletas:	bicycles
osamentas:	bones
áridas:	arid
llanuras:	plains
escenografías:	scenery
sótano:	basement
divertirse:	enjoy
góticos.:	goths.
caracteres:	characters
luminosa:	bright
veníamos:	we came
próximo:	next
fatigados:	fatigued
desamparados:	helpless
hora—:	time—
fuguen:	the fugue
tampoco:	neither
fuerzas:	forces
repondrán:	will replenish
Vivieron:	They lived
nutricias.:	nutricies.
empresas:	companies
vendieron:	they sold
extenuados:	exhausted
ahogar:	drown
circundante:	surrounding
culturas:	cultures
retazos:	scraps
fachadas:	facades
136
:	136
encrespamiento:	inking
ocurrencia:	occurrence
estilo.:	style.
sustituirlos:	replace them
arquitectura:	architecture
secarse:	dry up
acaban:	end
Renacimiento:	Renaissance
acantos:	acanthus
ejecutados:	executed
clásicos:	classics
entablamentos:	entablatures
agonizantes:	dying
edificios:	buildings
enfermas:	sick
tenidas:	had
colgaba:	hung
coagulada:	coagulated
pringoso:	catch
trofeo:	trophy
edades:	ages
ornamento:	ornament
aplicado:	applied
arquitecto:	architect
bucráneo:	bucranium
triglifos:	triglyphs
antiguo::	ancient:
asienta:	nods
implicaciones.:	implications.
luciferada:	luciferated
propiciatoria:	propitiatory
percusión:	percussion
reto:	challenge
alianza:	alliance
gaje:	grows
baño:	bathroom
enmascarado:	masked
purificación:	purification
desconozca::	don't know:
siglos.:	ages.
inscripciones:	registrations
desconocido:	a stranger
reducidas:	reduced
tradiciones:	traditions
conservar:	keep
enjoyaron.:	they bejeweled
almendra:	almond
abeto:	fir
cubren:	cover
bautismo:	baptism
almendras:	almonds
llevan:	they carry
Epifanía:	Epiphany
Buscan:	They search
gestos.:	gestures.
simbólica:	symbolic
ignorantes:	ignorant
arroz:	rice
puñados:	handfuls
reciben:	receive
anillos:	rings
intercambian:	they exchange
casan:	feet
hacen.:	do.
misterio:	mystery
asisten:	assistant
inconsciencia:	unconsciousness
advierto:	I warn
lengua:	language
canta:	sing
congregados:	congregants
forasteros:	outsiders
extraños:	strangers
percatarme:	notice
acompaña.:	accompanies
escucharse:	listen
hombres::	men:
mayoría:	most
ininteligibilidad:	unintelligibility
nostri.:	our.
Dei:	Of the
atris:	black
—plantatus:	- planted
multiplicatur::	is multiplied:
Libani:	Lebanon
cedrus:	cedar
—
Sicut:	-
Like
florebit::	will bloom
gregoriano::	Gregorian:
muertas.:	dead
repleto:	full
foso:	pit
ensancha:	widens
fieles:	faithful
malentendido.:	misunderstanding.
escuelas:	schools
latín:	Latin
ajena.:	foreign
sacerdote.:	priest.
entiende:	understand
nocturno:	night
congregado:	congregated
cirios::	candles:
amarillor:	yellower
oficiante:	officiant
deambulatorio.:	ambulatory
litúrgicos:	liturgical
resuenan:	resonate
profundos:	deep
órgano.:	organ.
invitan:	invite
incienso:	incense
ahumadas:	smoked
dormido:	asleep
zapatos:	shoes
tiembla:	trembles
socavón:	sinkhole
comprada;:	purchased;
raído:	raido
gabán:	overcoat
ladrillo:	brick
garita:	sentry box
avanzado:	advanced
hornacina:	niche
paradas.:	stops.
momias:	mummies
aturdidos:	stunned
soldadas:	welded
escaparates:	escapes
resguardados:	sheltered
espacios:	spaces
angostos:	narrow
Descubro:	I find out
prisa.:	hurry.
inválidos:	invalid
135
:	135
comercios:	shops
pegado:	glued
progresar:	to progress
ajustarme:	adjust
logro:	achievement
semáforo.:	traffic light.
semáforo:	traffic light
agitación:	agitation
restablece:	resets
reinante;:	reigning;
pulsación:	pulsation
constancia:	constancy
tranvía:	tram
cruzar:	cross
permite:	allows
encenderse:	light
esquina:	corner
corresponde:	corresponds
orgánicas.:	organic.
voluntades:	wills
acera:	pavement
vienen:	they come
descubrir:	discover
costumbre:	habit
adquirido:	acquired
tarde):	late)
(Más:	(Further
peldaños:	steps
escaleras.:	stairs.
bajé:	I went down
necesitado:	needy
Cansado:	Tired
sí.:	Yeah.
cerrando:	closing
levantó:	rose
remoto;:	remote;
fijó:	fixed
calmada:	calm
gemidos.:	moans.
adolorida:	sore
mirarme:	look at me
infantil:	children's
humilde:	humble
rompió:	broke
avilantez:	degrade
defenderla:	defend her
naciendo:	being born
doblándose:	bending
desolado:	bleak
abrazó:	hug
Temis:	It was
embarazo.:	pregnancy.
pregunté:	I asked
Justicia.:	Justice.
encarnación:	incarnation
Poder:	Can
femenina:	feminine
majestuosa:	majestic
estatua:	the state
Parecía:	It seemed
Átala.:	Atala.
ridiculizante:	ridiculous
término:	term
designaba:	designated
impedir:	prevent
embrolladas:	muddled
tramitaciones:	procedures
pérfidos:	perfidious
lazos:	ties
confundiría:	would confuse
sinuosos:	sinuous
enredados:	tangled
atado:	tied
advirtió:	warned
modelarla:	with models
vestido:	dress
negrura:	blackness
atiesada:	Atisara
Helada:	Frost
fiscales.:	prosecutors.
abogados:	lawyers
registro:	record
bajó:	low
cayeron:	they fell
paroxismo...:	paroxysm...
ascendía:	ascended
monólogo:	monologue
furia:	rage
lacerarse:	lacerate
aplazados:	postponed
dramáticas:	dramatic
inhibiciones:	inhibitions
Sospecho:	I suspect
justeza.:	fairness.
apoyando:	supporting
inmóvil:	still
delgados:	thin
gestos::	gestures:
impresionó:	impressed
escenario.:	scenery.
alzó:	raised
Entonces:	So
inquebrantable.:	unwavering.
expone:	exposes
alterado:	changed
repetí:	I repeated
atención.:	attention.
escuchar:	listen
colocó:	placed
amenazada:	threatened
viéndose:	seeing each other
distensión:	distension
serpiente.:	snake.
rastreada:	tracked
plantando:	planting
prestaban:	they lent
134
:	134
desconcierto:	bewilderment
aumentar:	increase
divirtiendo:	having fun
aposento:	chamber
caballería.:	chivalry.
secretos:	secrets
callaban:	they were silent
callarse:	shut up
debían:	they had to
pruebas:	evidence
prestigios:	impressive
comunes;:	common;
asidero:	handle
pintaba:	painted
llaves.:	keys.
requería:	required
incomprensible:	incomprehensible
imprevisto:	sudden
presentando:	presenting
saqué:	I took out
decisivo:	decisive
asestar:	deal
enfriar.:	cool.
puestos:	positions
vinos:	wines
departamento:	department
dispuesta:	willing
delicada:	delicate
conclusión:	conclusion
reconfortante:	comforting
faltaría:	would be missing
previsto:	predicted
abrazo:	hug
anticipación:	anticipation
suyas:	his
colocadas:	placed
pantuflas:	slippers
velador:	pedestal table
mejores:	best
sábanas:	bed sheets
arreglada:	fixed
magnánimo.:	magnanimous.
sollozante:	sobbing
vendría:	would come
castigada:	punished
comprensión:	comprehension
endulzando:	sweetening
aceptar.:	accept.
generosa:	generous
compasión:	compassion
mejor.:	better.
verdad—.:	TRUE-.
moradas:	purple
devuelta:	returned
regresara:	will return
—desde:	-from
engañosas:	misleading
falacias:	fallacies
significaban:	they meant
desprecio:	contempt
vicios:	vices
desprendimiento:	detachment
Sigue.»:	Go on."
Sigue...:	Go on...
«Sigue...:	"Go on...
operación:	operation
queriendo:	wanting
gimiente:	moaning
estertor:	rattle
acertaba:	was right
dibujadas:	drawn
jadeante:	panting
desplomada:	collapsed
físico.:	physical.
impudor:	impudence
juvenil:	youth
astrales:	astral
adornado:	decorated
hablé:	I spoke
injustificada.:	unjustified.
aparentemente:	apparently
ruptura:	rupture
acarrea:	carries
trastornos:	disorders
cumple:	meets
transformado:	transformed
distante;:	distant;
detalle:	detail
hincada:	kneeling
revelado:	revealed
añadir:	add
vindicativa:	vindictive
llevado:	carried
séptimo:	seventh
fornicación:	fornication
reducida:	reduced
antepuesta:	anteposed
Culpé:	Culpe
dinero.:	money.
innegable:	undeniable
abyecta:	abject
asistiera:	would attend
largando:	letting go
precipité:	precipitate
contenerse:	contain
cólera:	anger
estallido:	pop
adelantarme:	get ahead
apretar:	squeeze
hundido:	sunken
crispadas:	tense
mucho—:	a lot-
ocultaba:	hid
defecto:	flaw
dientes:	teeth
dejaba:	left
sardónica:	sardonic
mueca:	grin
trágicas:	tragic
yesosa:	of sauce
palabras;:	words;
miraba:	looked
ridículo.:	ridiculous.
oportunidad.:	chance.
pérfida:	perfidious
evidenciado:	evidenced
equívoco:	misconception
querida.:	dear.
133
:	133
nación:	nation
ironía::	irony:
malvada:	evil
vislumbrar:	glimpse
impostura.:	imposture.
atribuir:	assign
vengando:	avenging
entender::	to understand:
entiendan:	understand
interesados:	interested
basta:	it just is
regresando:	returning
derribara:	would knock down
voluntariamente:	voluntarily
abandonó:	abandonment
Completa:	Complete
primitivos.:	primitives.
cosmogónicas:	cosmogonic
confiada:	confident
aprovecha:	take advantage
astrología:	astrology
estudiosa:	studious
relaciones.:	relations.
índole:	nature
justificar:	justify
erudición:	erudition
falsa:	false
despliegue:	deployment
evidentemente:	evidently
debidos:	due
Pitágoras:	Pythagoras
nombra:	name
indostánicos:	Hindustani
cita:	dream
movimientos;:	movements;
sinfonía:	symphony
lluvia»:	rain"
especialista:	specialist
risibles:	laughable
errores:	errors
cometiendo:	committing
aterradora:	terrifying
intrepidez:	fearlessness
planetaria.:	planetary.
jerarquía:	hierarchy
relacionaron:	related
astrológico:	astrological
enfoque:	approach
organográfico:	organographic
estudiaba:	I studied
colaboradora:	collaborator
sorpresivo:	surprising
declaró:	declared
amante.:	lover.
tenida:	had
relata:	reports
revelaciones:	revelations
despreciable—:	negligible-
tabloide:	tabloid
—tomado:	-taken
artículo:	article
escándalo.:	scandal.
explotación:	exploitation
coloquio:	colloquium
fotografía:	photograph
trozo:	piece
encendidos:	on
violento:	violent
ademán:	gesture
decirle:	tell
temidos:	feared
retarda:	slows down
distracción:	distraction
alegro:	glad
deslizado:	slipped
vecino:	neighbor
recorte:	cutout
inclinado:	inclined
entrar:	to enter
vez...:	time...
devuelve:	returns
maravillas.:	wonders.
falsas:	fake
arsenales:	arsenals
producido:	produced
sutil:	subtle
literatura:	literature
Toda:	All
muerto.:	dead.
entrepaños:	shelves
alineados:	aligned
aquello.:	that.
Ninguno:	None
otro.:	other.
entrara:	will enter
potestad:	power
arrogarse:	assume
atreviera:	dared
indignado:	indignant
extrañamente:	strangely
miré:	Look
reposo»:	repose"
«Tómese:	«Take
empresa::	enterprise:
candilejas.:	footlights.
apagar:	to switch off
telón:	curtain
Ayuntamiento:	City hall
impresión:	impression
vestido.:	dress.
modelado:	modeling
escalinata:	staircase
entendidos:	understood
guiños:	winks
tribulaciones:	tribulations
fatiga:	fatigue
persuasivamente:	persuasively
Protagonista:	Hero
relumbre:	glare
quitar:	remove
reiteración:	reiteration
agotarse:	run out
presiente:	present
engrandecida:	enlarged
Griseldis:	in Griseld
lecho:	litter
hablarle:	talk to him
Penélope:	Penelope
bodas;:	white;
ración—:	ration-
desflo:	deflo
—esta:	-this
estremecida:	extremecidal
132
:	132
aplaudir.:	applaud.
ganas:	desire
dicha:	bliss
ofrecerse:	offer
artimañas:	tricks
atenta:	attentive
admirar:	admire
dándose:	giving
insinuante:	insinuating
diversa:	different
matizada:	nuanced
actuación:	performance
actualidades:	news
camarógrafo:	cameraman
esbelta:	slender
próxima:	next
acompañará:	will accompany
declaración:	declaration
breve:	brief
citó:	cited
coloca:	put
sorprendido;:	surprised;
íntimo:	intimate
golosina:	candy
cartera;:	briefcase;
oportuna:	timely
oblea:	wafer
importante:	important
jaqueca:	migraine
alivia:	relieve
acecha;:	stalks;
fotógrafo:	photographer
entona:	gas
inasible;:	ungraspable;
ubicua:	ubiquitous
resurgir:	resurface
desaparece:	disappears
desliza:	slide
partes;:	parts;
Está:	This
bailarina.:	ballerina.
movilidad:	mobility
ama:	or
usurpa:	usurp
iniciativa:	initiative
quitando:	removing
gravitación:	gravitation
eje:	axis
arabesco:	arabesque
desenredando:	unraveling
enredando:	getting tangled up
vida::	life:
retratos:	portraits
Ayuntamiento.:	City hall.
encamino:	on the way
espectros:	spectra
Escoltado:	Escorted
decían.:	they said.
desaparecen:	disappear
obligada:	obligatory
concurrencia:	concurrence
común:	common
estrechamente:	tightly
olvidado::	forgotten:
surgir:	to emerge
envuelven:	they wrap
ya—.:	of—.
—completamente:	-completely
públicas:	public
relaciones:	relations
comisionado:	commissioner
sincronización:	synchronization
finalmente:	finally
bailarina:	ballerina
cerámicas:	ceramics
pintor:	painter
municipalidad:	municipality
gobierno:	government
funcionarios:	officials
Facultades;:	Faculties;
Decanos:	Deans
encabezada:	headed
delegación:	delegation
emocionado;:	thrilled;
aeródromo.:	aerodrome.
atardecer:	sunset
rotos:	broken
relámpagos:	lightning
cegado:	blind
hombro.:	shoulder.
prorrumpir:	break out
viste:	showed
tejido:	tissue
reconozco:	I recognize
flancos;:	flanks;
abrigos:	shelters
escalerilla:	ladder
dejo:	let
señalen:	point out
librar:	librate
adversario:	adversary
repudio.:	repudiation.
acallan:	silence
desarman:	disarm
humildad:	modesty
ternura:	tenderness
asistidos:	assisted
amada:	loved
ejercer:	exercise
tiranías::	tyrannies:
combatir:	combat
Siento:	I feel
mí—.:	my-.
deserción:	desertion
brusca:	abrupt
explicaría:	would explain
—gravidez:	-pregnancy
agravarse:	get worse
remordimientos.:	regrets.
plantearé:	I will raise
treinta:	thirty
Cobraré:	I will charge
relato.:	report.
veracidad:	veracity
sucedidos:	successful
indígenas:	indigenous
refiriéndose:	referring
precisan:	they need
suramericano:	south american
escritor:	writer
famosa:	famous
encontraron.:	they found.
«misión»:	"mission"
llegué:	I arrived
hambriento:	hungry
kilómetros:	kilometers
131
:	131
atravesando:	passing through
fugarme:	run away
logré:	I managed
desconfiada:	suspicious
tribmás:	tribmore
viaje::	journey:
venderé:	I will sell
inspiran:	inspire
plantado:	planted
apartado:	apart
«misión:	"mission
reportes:	reports
refirieron:	they referred
visitantes:	visitors
equivaldría:	would be equivalent
ahora—.:	now-.
—ya:	—of
innumerables:	countless
exclusividad:	exclusiveness
reservarle:	reserve
acepté:	I accepted
meses.:	months.
rito:	here
rutinario:	routine
acoplado:	coupled
desventura:	misfortune
suspenso:	suspended
pulso:	pulse
quedé:	I stayed
emergido:	emerged
inteligible:	intelligible
parasitarios:	parasitic
entrecortada:	choppy
despedida:	farewell
tomaría:	would take
permaneciera:	would remain
grité:	I screamed
rogativas:	prayers
incluían:	included
hispánicas:	hispanic
antesala:	anteroom
traería:	would bring
Aterrado:	Grounded
conmigo.:	with me.
expresiones:	expressions
decirme.:	tell me
entendí:	understood
reía:	laughed
Lloraba:	I cried
teléfono.:	telephone.
hemisferio:	hemisphere
venida:	coming
Kappelmeister:	Bandmaster
Estaba:	Was
embuste.:	scam.
arrumba:	rumba
embustero.:	liar.
aplaudir:	applaud
aplaudirme:	applaud me
disponen:	they have
mías.:	mine
pendientes:	earrings
orbe:	the world
ciernen:	hover
guerras:	wars
capaces:	capable
Millones:	Millions
cornadas.:	gored.
toreo:	bullfighting
albur:	dace
riesgos:	risks
elegido:	elected
libremente:	freely
desempeño:	performance
bárbaros:	barbarians
enternece:	internecially
hacinados:	overcrowded
fríamente:	coldly
soportar:	endure
sobrecoge:	overwhelms
entera.:	whole.
familias:	families
holgada:	baggy
irritado.:	irritated.
avergonzado:	ashamed
enterando:	finding out
evoquen:	evoke
Ana:	Well
Crónica:	Chronicle
Pequeña:	Small
vean:	see
normas:	norms
infringir:	infringe
talento:	talent
regazo:	lap
científica:	scientific
investigación:	investigation
mártir:	martyr
mí::	my:
refieren:	refer
artículos:	articles
persistente:	persistent
temática:	thematic
ejemplar.:	copy.
lectores:	readers
presentarme:	introduce myself
empeña:	pawn
congraciarse:	ingratiate
aviadores:	aviators
premiar:	reward
generosamente:	generously
sobremanera::	exceedingly:
130
:	130
conyugal.:	conjugal.
cuadro:	chart
trazado:	having sex
mimetismo-mágico-rítmico:	magic-rhythmic mimicry
absurda:	absurd
á:	on
soldados:	soldiers
uniforme:	uniform
Jesús:	Jesus
regañadientes—:	reluctant—
aceptada:	accepted
incluso:	even
publicadas:	published
nacional.:	national.
desaparición:	disappearance
geográfica:	geographical
inexplorada:	unexplored
hallara:	to cases
exigiera:	demanded
colmo:	full
luego—:	then-
sanguinarias:	bloodthirsty
tribus:	three
sabios:	wise
viajeros:	travelers
evocaron:	evoked
realmente:	really
tarde—:	afternoon—
fuere:	was
—quien:	-who
comienzos:	beginnings
mías:	mine
revelando:	revealing
diario:	diary
redacción:	wording
saliendo:	leaving
réplica:	replica
sollozar:	sob
Rompió:	Broke
corazonada.:	hunch.
cuentan—:	count—
estando:	standing
mapa:	map
Organográfico:	Organographic
silueta:	silhouette
irguiendo:	erecting
periodistas:	journalists
recortes:	clippings
mostraron:	showed
envidiarme::	envy me:
atracción:	attraction
contrasentido:	contradiction
desarrollarse.:	develop.
tendrán:	they will have
preparando:	preparing
humos:	fumes
esposa.:	wife.
papel::	paper:
interpretar:	interpret
clima.:	climate.
cronologías:	chronologies
escaparon:	they escaped
dilatación:	dilatation
pasmosa:	astonishing
calendarios:	calendars
cálculo:	calculation
opresión:	oppression
angustiosa:	distressing
alegran:	they rejoice
Mientras:	While
ventanillas.:	windows.
cristales:	crystals
paseando:	strolling
luminosas:	luminous
geometrías:	geometries
ubicar:	locate
divierten:	have fun
Algunos:	Some
encenderse.:	light.
humo—:	in it—
colosos:	colossi
carcomidos:	eaten away
truncos:	trunks
manso:	meek
atravesar:	cross
Acabamos:	We're done
sueños:	dreams
viviendo.:	living.
SEXTO:	SIXTH
CAPITULO:	CHAPTER
129
:	129
alcanzando.:	reaching.
vamos:	let's go
altitud:	altitude
aturdido:	stunned
visibilidad:	visibility
volaremos:	we will fly
Avisado:	Warned
aisla:	isolate
niebla:	fog
ascendemos:	we ascend
bonanza:	see them
buitres.:	vultures.
revuelo:	stir
cayó:	fell
Lejos:	Far
viuda.:	widow.
olfato—:	smell—
deleitosamente:	delightfully
—dividida:	—divided
cuelga:	hanging
advertir:	warn
alzar:	raise
camina:	walk
128
:	128
cogollo.:	heart.
sacude:	shake
molinetes:	pinwheels
vecinos.:	neighbors.
invadida:	invaded
giramos:	we turn
Meseta:	Plateau
rasando:	rage
abajo;:	below;
quedan:	remain
copas:	glasses
fangoso.:	muddy.
ruedas:	wheels
encajar:	fit
trepidante:	trembling
inmovilidad:	immobility
seguida:	followed
explanada;:	esplanade;
motores:	engines
metálica:	metallic
seña.:	sign.
cabina:	cabin
jubilosa.:	jubilant
prorrumpen:	they break out
avión.:	plane.
acariciado.:	caressed
abrazaban:	they hugged
rápido:	fast
zafa:	they died
beso:	kiss
mirarme.:	look at me
rencoroso:	rancorous
llevar»:	carry"
puedes:	can
valiosa:	valuable
entrego:	I deliver
despectiva.:	derogatory
encogiéndose:	shrinking
decidir.:	decide.
explico:	I explain
imperativo.:	imperative.
nombrando.:	naming.
Adán:	Adam
mirara:	will look
mirara.:	would look
acababa:	ended
liberador.:	liberating.
mensaje:	message
sabía.:	knew.
aplauso—:	applause-
huera:	hula
envanecerme:	get puffed up
Aunque:	Although
torceduras.:	sprains.
curaran:	curan
inventar:	inventory
creyera:	believed
respecto:	regard
curado:	cured
ejucutándola:	ejucutandola
entenderían:	they would understand
destinada:	intended
directores:	directors
correo:	mail
quedando:	staying
producida:	produced
estaría:	would be
conocía:	knew
obstaculizar:	hinder
comprendiera:	would understand
Aceptaría:	I would accept
malograda.:	ill-fated
ataba:	he won't be
rotura:	rip
cumplimiento:	compliance
exigía:	demanded
brusca;:	abrupt;
adaptación:	adaptation
Comprendo:	Understand
lealmente:	loyally
explicarle:	explain
comunicado:	statement
enviado:	sent
común.:	common.
requieren:	require
legítimo:	legitimate
gobierna:	governs
adoctrina:	doctrine
Caza:	Hunt
cumplen:	they comply
Todos:	All
demás.:	others.
necesarias:	necessary
iré:	I will go
decisión::	decision:
aluminio.:	aluminum.
cabaña.:	cabin.
turbaban:	they were disturbing
presencias:	presences
librarán:	will free
envueltos:	wrapped
127
:	127
deberían:	should
sube:	go up
apremiarme.:	urge me
enérgicamente:	strongly
apetecer:	feel like
colocan.:	place.
Cuadernos:	Notebooks
denegación:	denial
hongos.:	fungus.
importa.:	matters.
demostrar:	demonstrate
altiva:	haughty
míos:	mine
evitan:	they avoid
disgusto:	disgust
expresa:	express
aquí...:	here...
bombonas:	candy
botellas:	bottles
pomos:	snitches
expresadas:	expressed
tinta::	ink:
carecer:	lack
brasa.:	ember
asadas:	roasted
roer:	stir
limpiado:	cleaned
simplificación:	simplification
llegando:	arriving
innecesario:	unnecessary
lastre:	plates
aficiones:	hobbies
tiempos::	time:
prescindir:	dispense with
palabras::	words:
resumen:	summary
carezco:	I lack
ánimo.:	cheer up.
desplaza:	move
jorth.:	Jorath.
poema::	poem:
despierta:	wake up
piloto.:	pilot.
imperioso:	imperious
libros.:	books.
Recomienza:	Restart
poderosa:	powerful
denegación.:	denial.
arrancar:	start up
meseta:	plateau
suelte:	release
marcharme:	leave
recoja:	pick up
encontrara.:	will find
dondequiera:	wherever
alcanzarme:	reach me
inaplazable:	unavoidable
convocatoria:	call
expresado:	voiced
suceder:	happen
emplea::	uses:
infinito:	infinite
atronador.:	thunderous.
cascadas:	waterfalls
hablarme:	talk to me
ajenos;:	aliens;
telones:	curtains
frondosos.:	leafy.
espesarse;:	thicken;
precioso:	precious
habitado.:	inhabited.
deshabitado:	unoccupied
ablanda.:	softens
desconcierta:	baffles
ardiente:	burning
líquido:	liquid
miope—.:	short-sighted—.
lentes:	glasses
sanos:	healthy
coincidir:	coincide
aciertan:	they get it right
litografía:	lithography
tiro:	number
movidas:	moved
incómodamente:	uncomfortably
superponemos:	we overlap
estampa;:	print;
ajustarse:	conform
agitarse:	shake
Conservatorio.:	Conservatory.
hurtadillas:	sneaking
fumaba:	I smoked
tabaco:	tobacco
126
:	126
cigarrillos:	cigarettes
renace:	reborn
cigarrillo:	cigarette
hielo.:	ice.
vinagre:	vinegar
marisco:	seafood
apio:	celery
té:	has
apremiantes:	pressing
llamadas:	calls
paladar.:	palate.
tragan:	swallow
celosa:	jealous
olvidadas.:	forgotten.
apetencias:	desires
lúcida:	lucid
envuelve:	wraps
sorbo:	sip
probado:	tried
beber.:	to drink.
desenrosca:	unscrew
aparta:	separate
capuchino.:	cappuccino.
vendas:	sales
cuchillos:	knives
conservas:	preserves
medicamentos:	medicines
entregan:	deliver
aterrizaje:	landing
habérseme:	have me
paracaídas:	parachute
impermeables:	waterproof
bulto:	bulk
sacan:	they take out
Romanticismo.:	Romance.
Conquista:	Conquest
presente—:	present—
identifican:	identify
regresándose:	returning
ochenta:	eighty
cifra:	cipher
Génesis:	Genesis
recta.:	straight.
línea:	line
fraguas:	forges
buscaban.:	they were looking for
agitar:	shake
pensaron:	they thought
huella:	fingerprint
suelos:	floors
otear:	otter
aglomeración:	agglomeration
divisar:	spot
asombraron:	they amazed
turbonada.:	turbo nada.
esquivar:	dodge
apartarse:	depart
buscar.:	look for.
dispersión:	dispersion
orientados:	oriented
rescate.:	rescue.
cuantioso:	large
reactualizando:	updating
publicados:	published
torturado.:	tortured.
insidiosa:	insidious
creado:	created
sanguinarios.:	bloodthirsty
quién—:	who-
buscando.:	searching.
aviones:	airplanes
nombre.:	name.
aparato::	device:
impulso.:	impulse.
frena:	brake
oportuno:	timely
viraje:	turn
peligroso:	dangerous
suelo;:	floor;
bajo.:	low.
vacilando:	hesitating
desciende:	descends
despejar:	clear
apartarlos:	separate them
alborotando:	rioting
saltando:	jumping
acuden:	they come
contagioso:	contagious
regocijo:	joy
explanada:	esplanade
señal.:	sign.
Advierto:	I warn
titubeo:	hesitation
paralelamente:	in parallel
hélice:	propeller
removido:	removed
explosión;:	burst;
un.:	and.
125
:	125
aferrada:	clinging
separan:	separate
nuevamente;:	again;
romperse:	break
prestas:	lend
gente.:	people.
«cosa:	"What
pasmados:	stunned
miran:	another
Gobierno:	Government
Neolítico.:	Neolithic.
aterrorizados:	terrified
huyen:	Huyen
gira:	tour
volteo.:	I turn.
precipitación:	precipitation
acunado:	cradled
encima.:	on.
fusil.:	gun.
llevaba:	wore
noche.:	evening.
arreció:	escalated
mojada.:	wet
terminó:	term
derritiendo.:	melting.
cerosa:	waxy
escurría:	drained
desintegraba:	disintegrated
encarnada:	red
humano.:	human.
perdiendo:	losing
emborronando:	blurring
desdibujando:	blurring
seguía:	continued
mirar::	look:
forcé:	strength
estampido:	stamped
rebotando:	bouncing
confundieron:	confused
disparos:	shots
Sonaron:	They sounded
derecho.:	right.
perdigones:	shot
izquierdo:	left
cañón:	canon
habías:	had
atreven:	dare
arrancó:	started
colérico:	choleric
Ejecutor.:	Executor.
iniciaría:	would start
deslindes:	demarcations
levantan:	they lift
siempre.:	always.
cambiar:	change
gatillo:	trigger
apretara:	will squeeze
resistía:	resisted
rapiña.:	rapine.
anulado:	annulled
suprimido:	deleted
contaminándola:	contaminating it
destrozado:	destroyed
indignante:	outrageous
inmundo;:	unclean;
Apagar:	To switch off
apagarlos.:	turn them off.
dependía:	it depended
mirando.:	looking.
seguían:	they followed
párpados:	eyelids
ahí::	there:
apuntar.:	aim.
Volví:	I returned
cura:	treatment
—apremió—.:	-pressure-.
«Dispara:	«Shoot
volví:	I returned
morir.:	to die
pedía:	asked
Bajé:	I went down
onjejión».:	objection".
onjejión...:	objection...
«onjejión...:	"objection...
como::	as:
ininteligible:	unintelligible
gatillo.:	trigger.
decidía:	decided
puse:	side
Levanté:	Levant
«Apunta:	«Aim
mirándonos:	looking at us
detuvo::	stopped:
rastreador:	tracker
Avanzamos:	We move forward
llovida.:	rained
maleza:	evil
trillo:	trill
concertábamos:	we arranged
leproso.:	leper.
estábamos:	we were
oscurecer:	darken
Anduvimos:	We walked
huellas.:	footprints.
encorvado:	curved
pasas:	passes
Unos:	Some
sucias:	dirty
holladas:	trampled
violación:	rape
Llegamos:	we arrived
manatí.:	manatee.
hinchado:	swollen
124
:	124
arrastraban:	they dragged
fangosas:	muddy
turbulentas:	turbulent
echamos:	we cast
paños:	cloths
Envolvimos:	We get involved
seguirlo.:	follow him.
índice:	index
Poniendo:	putting
técnicas:	techniques
perdurar:	endure
armeros:	gunsmiths
troquel:	die
cañones:	cannons
larguísimos:	very long
fusiles:	rifles
brazo::	arm:
deslizó:	slipped
puños:	cuffs
apretaba:	squeezed
agresiva.:	aggressive
consentida:	consented
repugnante:	disgusting
culpables:	guilty
fuésemos:	we were
indecible::	unspeakable:
indignación:	indignation
sublimado.:	sublimate.
ungüento:	ointment
frota:	fleet
entrepiernas:	of the enterprises
telarañas:	cobwebs
tapón:	plug
selváticos:	jungle
latente.:	latent.
reproche:	reproach
encerrara:	closed
aquí»:	here"
alrededores.:	surroundings.
batida:	beat
garrotes:	clubs
armados:	armed
hilachas:	threads
hemorragia:	hemorrhage
restañando:	stagnating
desgarrándole:	tearing him
violarla:	rape her
supo:	knew
aclaración:	clarification
lograron:	they managed
horrorizado:	horrified
rodillas.:	knees.
ensangrentada:	bloody
atroz::	atrocious:
aguacero.:	downpour.
echa:	cast
arropada:	clothed
Capitán.:	Captain.
caserío:	hamlet
sucedido:	happened
corno:	horn
trompa:	trunk
detenido:	arrested
imaginaciones:	imaginations
sorprendo:	I surprise
dedos...:	fingers...
ensalivarse:	ensalivate
antebrazo:	forearm
doblar:	fold
sopesarlo:	weigh it
Puse:	Party
oído.:	ear.
mujeres»:	women"
empreñadas:	engaged
llovía:	it was raining
cobrar:	charge
volvimos:	we came back
deleite:	treat
abrazo.:	hug.
calores:	heats
adueñó:	took over
oyó:	heard
respiro:	breath
techumbres:	roofing
terminado.:	finished.
creímos:	we believed
verdor:	greenery
espárrago:	asparagus
nacen:	are born
estiércol:	manure
serosidades:	serosities
nacera:	had been born
orina:	urine
órganos:	organs
excreción:	excretion
vecindad:	neighborhood
engendrará:	will engender
engendrarse:	beget
maceración:	maceration
podre:	rotten
Llegaron:	They arrived
amenas.:	pleasant.
venenosa.:	poisonous.
culebra:	snake
garfios:	hooks
fundido:	cast
derecha:	right
blandido:	brandished
cortarse:	cut
enormemente.:	enormously.
aburriéndose:	getting bored
tejiendo:	knitting
pasan:	pass
anegada:	flooded
rastreado:	tracked
desaparecieron:	they disappeared
chinches:	bed bugs
123
:	123
lluvia.:	rain.
cumpliendo:	fulfilling
estuvieran:	were
cauce:	channel
pliegue:	fold
negras.:	black.
coladas:	glued
filtraciones:	leaks
farallones:	cliffs
Sobre:	On
podrida.:	rotten
criaturas:	creatures
numerosas:	numerous
sapos:	frogs
cantaron:	sing
treparon:	they climbed
multiplicaron:	multiplied
malangas;:	oily;
regocija;:	rejoices;
traidoras.:	traitors
cieno:	silt
llenos:	full
hoyos:	holes
hundiéndome:	sinking
lodo:	official
rodado:	wheeled
huele:	smells
fango.:	mud.
empellón:	shove
quebradas:	ravines
rotas:	routes
arrancadas:	sprints
diques:	discs
ahogados.:	drowned
podridas:	rotten
balsas:	the voice
acarreando:	carrying
sucios:	dirty
colores:	colors
necesitada:	needy
mantiene:	maintains
difuminado:	blurred
interminables.:	endless
escuece:	stings
negativa:	negative
matrimonio:	marriage
mentar:	ment
primeros.:	first.
guiones:	scripts
enmendando:	amending
papel—:	paper-
consumo:	consumption
decir::	say:
imaginativa:	imagination
maravillosa:	wonderful
temo:	theme
Casi:	Almost
están.:	are.
quedarán:	fall
llenadas:	filled
sesenta:	sixty
oportunas:	timely
siembras:	sowing
procederse:	proceed
reparar:	fix
pasarse:	go
quiera.:	want.
propone:	proposes
último.:	last.
advirtiéndome:	warning me
compadecido:	pitied
volvería.:	I would go back.
mulata:	mulatto
casara:	married
Mulato:	Mulatto
cantar::	sing:
carabelas—:	caravels—
bordo:	edge
sonó:	rang
compartir:	share
invito:	invitation
Horrorizado:	Horrified
sanciones.:	sanctions.
mayores:	older
atrevía:	dared
población.:	population.
venir:	come
olvidado.:	forgotten.
122
:	122
distante:	distant
enfermo:	sick
andando.:	going.
arrastrándose:	crawling
alforja:	saddlebag
arroja:	throws
separarlo:	separate it
horquillada:	bracketed
suavemente:	gently
empuja:	push
enojo—.:	anger-.
«¡Vete:	«¡Yourself
pavor.:	dread.
muda:	time
arrodillada:	kneeling
gesticula:	gestures
pesadilla:	nightmare
ceniza.:	ash.
señalando:	pointing
ronquido:	snore
tráquea:	windpipe
despide:	say goodbye
desintegración:	disintegration
licuarse:	liquefy
disolverse:	dissolve
prestos:	ready
endurecido:	hard
sujeta:	subject
escoria:	slag
piltrafa:	piltraf
residuo:	residue
gorro:	cap
selvas.:	jungles.
depositarios:	depositories
Levítico:	Leviticus
olvidada:	forgotten
clásica:	classic
lepra;:	leprosy;
apareció:	appeared
jadeo:	panting
falta...:	lack...
legalizado:	legalized
firmado:	signed
reunida.:	reunited.
indiada:	Indian
fórmula:	formula
pronunciar:	pronounce
aspira:	aspire
casarse;:	marry;
obligarla:	force her
inferioridad:	inferiority
humillado:	humiliated
réplica.:	replica.
campesina:	peasant
Confieso:	I confess
cuidado».:	Careful".
dé:	god
depende:	it depends
sentenciosa—:	judgmental—
unión:	union
mujeres.:	women.
Casarse:	Marry
desórdenes:	disorders
entronizado:	enthroned
marido:	husband
abandona:	abandon
guardias:	guards
mandar:	to send
alguno.:	some.
derecho:	right
valer:	worth
dejarlo:	leave it
abandonarlo:	abandon it
facultad:	faculty
descarría:	astray
asiste:	attend
defenderse:	fend
recurso:	resource
temen::	friend:
recóndito:	recondite
argumentación:	argumentation
dolido:	hurt
celoso:	jealous
matrimonio.:	marriage.
ninguna:	none
asombrado:	amazed
catecúmenos:	catechumens
protagonista:	hero
agarrar:	grab
casemos.:	let's get married
deseable:	desirable
preguntarle:	ask him
decido:	a decision
hable.:	speak.
observar:	notice
podrá:	will be able
humedad.:	humidity.
encender:	light
121
:	121
exigencia.:	requirement.
hamaca.:	hammock.
recuesto:	reclining
calmado:	calm
creer:	believe
hacérselo:	do it
totalmente:	fully
demostrarme:	show me
escribiré:	I will write
escribirlo:	write it
Debo:	I must
nunca.:	never.
ejecute:	run
importa:	matter
trombón.:	thrombo.
cornos:	horns
fagot:	bassoon
clarinetes:	clarinets
órgano::	organ:
libreta::	notebook:
quedará:	will remain
jurarme:	swear to me
risible.:	laughable.
insentato:	senseless
escuchada:	heard
esperado:	expected
audiencias.:	hearings.
vastas:	answered
especialmente:	especially
destina:	intended
ejecutada.:	executed.
cartas:	cards
escribiendo:	writing
exasperado:	exasperated
estúpido:	idiot
escollo:	stumbling block
toparse:	bump
menguado:	diminished
maniatado:	tied up
pequeño:	little
cohibe:	control
generosidad:	generosity
contraria:	contradicts
avara:	spacious
mezquina:	petty
preocupación:	worry
papel;:	paper;
milímetro:	millimeter
pendolista:	commuter
astucias:	cunning
Aprieto:	Fix
llueve:	it's raining
envolturas:	wrappers
extrañas:	strange
yutas:	Yuta
tejidos:	fabrics
pródiga:	prodigal
Alguna:	Some
problema.:	problem.
urgencia:	urgency
cuaderno.:	notebook.
apretado:	tight
voces...:	you...
sirviendo:	serving
—episodio:	-episode
lírico:	lyrical
introduciendo:	introducing
esfuerzo.:	effort.
lográndolo:	achieving it
concentrarme:	concentrate
cavilación:	rumination
acoso:	harassment
huir:	flee
inquebrantable:	unwavering
propuesto:	proposed
proceder:	proceed
rectitud:	rectitude
echará:	will cast
acepto—:	I accept—
mentira:	lie
plácida:	placid
falseándose:	falsifying
digo—:	I say—
mentir.:	lie.
dilema:	dilemma
disparadero.:	shooting
coloque:	put
actuará:	will act
tácticas:	tactics
probables:	probable
canalladas.:	scoundrels
impide:	prevents
Dios».:	God".
«marido:	"husband
atroz:	atrocious
posible—.:	possible-.
viviente:	living
albergar:	harbor
120
:	120
instinto:	instinct
atribuye:	attributes
engañarla:	cheat on her
subleva:	revolt
estimo:	esteem
atañe:	concerns
lealtad:	loyalty
mentira;:	lie;
sentirme:	feel
estafas.:	scams.
contentos.:	happy
quedarían:	would remain
pedida:	requested
ejemplar:	copy
prestarme:	lend me
delito:	crime
bigamia:	bigamy
importaría:	would matter
ya.:	of.
casado:	married
molesta::	bothers:
ocultar:	disguise
literarios:	literary
reacciones:	reactions
fáciles:	easy
burla:	derision
confesarme:	confess to me
tamborileo.:	patter.
malangas:	oily
anchas:	wide
temporalmente:	temporarily
calafateada:	the caulking
rajaduras:	cracks
salgo:	I'm on my way out
carcajada:	laugh
estampa.:	print.
consentido:	spoiled
hayamos:	let's have
bendita:	blessed
asperjar:	asparagus
Habrá:	There will be
tracen:	trace
uñas:	nails
gozarse:	enjoy
yacer:	lie
samaritano.:	Samaritan.
sayal:	skirts
escondidas:	hidden
ataduras:	restraints
relucir:	shine
decirle::	tell him:
guardando:	watching
encojo:	I shrink
golpea:	hits
Sorprendido:	Surprised
oyeran:	they would hear
recogerse:	pick up
rebaño:	herd
ovejas:	sheep
frase:	phrase
justificando:	justifying
legitimidad:	legitimacy
tolera:	tolerate
improperios:	expletives
profiere:	utters
insulta:	stroke
iracundo:	wrathful
tiempo;:	time;
hincharse:	swell
ministerio.:	ministry.
diciéndole:	telling him
aplomo:	aplomb
Repentinamente:	suddenly
Venados.:	Deer.
instaurarse:	establish
santificadas:	sanctified
uniones:	unions
casarme:	get married
Afirma:	states
evangelización:	evangelism
entorpecer:	hinder
sensatas:	sensible
cultas:	cultured
increpa:	rebukes
cuestión.:	question.
balbuceo:	babbling
concubinato:	concubinage
encara:	still
Casamientos.:	Marriages.
Registro:	Record
Entierros:	Burials
Bautizo:	Christening
llevarse:	take away
éste:	this
quejarme:	complain
Enojado:	Angry
pautados.:	ruled.
partituras:	sheet music
necesitan:	need
carabelas:	caravels
siendo:	being
plectro:	plectrum
tocadores:	players
arpistas:	harpists
músicas:	songs
relación:	relationship
establece:	establishes
Según:	According to
despecho:	spite
calmar:	calm
músicas.:	songs.
despilfarrarse:	waste
podían:	they could
utilidad:	utility
consignar:	record
actas:	minutes
destinaban:	they destined
explicándome:	explaining
último»:	last"
necesitaba:	I needed
expliqué:	explain
tragaba.:	swallowed
preguntó:	asked
pedir:	ask
desagradable:	disgusting
Acabo:	Just
119
:	119
estados:	states
duerma:	sleep
descifrar.:	decipher.
taquigrafía:	shorthand
reduciendo:	reducing
energía:	energy
brote:	outbreak
impulsado:	driven
jubilosa:	jubilant
escribo:	I write
ceñir.:	gird.
criticar:	criticize
tachar:	cross out
plomo:	lead
atrepellándose:	running over
llenaran:	will fill
bajadas:	descents
asombra:	amazes
invento:	invention
polémicas:	controversies
aburrimiento:	boredom
manifiestos:	manifestos
conciertos:	concerts
levantarse.:	get up.
pugnara:	fight
acallando:	silencing
asepsia:	asepsis
orden»:	order"
«regreso:	"return
impresionar:	impress
inventarse.:	invent
sonante:	resounding
contrapunto:	counterpoint
disimulada:	disguised
pobreza:	poverty
ricercare:	search
trepidaban:	trembled
contrarios:	opposites
martillados:	hammered
desencuadrados:	out of frame
redondas—:	round—
existido:	existed
corcheas:	eighth notes
movimientos:	movements
Concerti:	Concerts
autores:	authors
aquejado:	afflicted
locomotriz:	locomotive
juegos:	games
lentos:	boards
enjundia:	substance
olvidarlos:	forget them
olvidaban:	they forgot
actualizado:	updated
«desarrollar»—:	"develop"-
rectas:	straight
—
la:	—
the
legado:	legacy
calco:	cast
perdurabilidad:	perdurability
rispidos:	harsh
registros:	records
adrede:	ready
situados:	situated
asperezas:	roughness
disonancias:	dissonances
espíritu.:	spirit.
contrapuntísticas:	contrapuntal
recetas:	recipes
tomando:	taking
cantada:	sung
miércoles:	Wednesday
empezaba:	started
artesanal:	artisanal
Encadenado»:	Chained»
«Prometeo:	"Prometheus
«Preludio»:	"Prelude"
desventurado:	hapless
mañosa:	crafty
asemejaba:	resembled
invocación:	invocation
ensalmo:	I praise
homofónico:	homophonic
inscriben:	enroll
paralelas:	parallel
convergentes:	convergent
toscos:	rough
maravillado:	amazed
termino:	TERMS
olvidados:	forgotten
renacer:	be reborn
viendo:	seeing
apuntado:	pointed
imperiosa:	imperious
detengo.:	I stop.
anunciará:	will announce
órgano:	organ
entrando:	entering
edificio:	building
vosotros.»:	you."
remaba:	of father
despojos:	remains
desgracia.:	misfortune.
sepan:	know
quémame:	burn me
funerales;:	funeral;
lágrimas:	tears
abandones:	abandon
imploración::	entreaty:
preludio:	prelude
vocalización:	vocalization
interpretaré:	I will interpret
gemido:	moan
118
:	118
caminos».:	paths.
«su:	"are
llora:	cry
queja:	complaint
colocar:	to place
lanzas.:	spears.
bronce:	bronze
caídos:	fallen
guerreros:	warriors
enlutadas:	mourners
vírgenes:	virgins
estrofa:	stanza
imperceptiblemente:	imperceptibly
enternezca:	international
estructura:	structure
concibo:	I conceive
requerida:	required
duermen:	they sleep
sobras:	leftovers
derramado:	spilled
degollado:	beheaded
rebaños...:	flocks...
carnero:	SHEEP
daré:	I will give
sacrificaré:	I will sacrifice
Itaca:	Ithaca
prometo:	I promise
harina:	flour
Derramo:	I spill
libación:	libation
miel.:	Honey.
libaciones.:	libations.
«Hago:	"Do
solemne::	solemn:
evocación:	evocation
deseada.:	desired.
simplicidad:	simplicity
homérico:	Homeric
hojarasca:	leaf litter
aligerar:	lighten
sencilla::	simple:
bambú.:	bamboo.
retoño:	shoot
garrapatas:	ticks
limpiar:	clean
sienta:	feel
molestar:	annoy
ceño.:	frown.
obligado:	obliged
malos»:	bad»
«días:	"days
admitiendo:	admitting
preguntar:	ask
nervioso;:	highly strung;
alarma:	alarm
irritado:	irritated
Salgo:	I'm on my way out
peripecias.:	adventures
movido:	moved
Polifemo:	Polyphemus
releo:	reread
necesito.:	need.
género:	gender
resultaría:	would result
astucias».:	cunning."
vástago:	stem
Laerte:	Laertes
majestad»:	majesty"
Cronos:	Chronos
invocatorias:	invocatory
usar:	to use
niego:	him
descorazonarme:	dishearten me
vacilación:	hesitation
coincidencia:	coincidence
empastadas:	pasted
—Estos:	-These
Gramática:	Grammar
Epítome:	Epitome
francés;:	French;
secundarios;:	secondary;
estudios:	studies
alemán:	German
Sabía:	Knew
¿cuál:	which
profunda.:	deep
desierta:	deserted
poeta:	poet
resabios.:	aftertaste
sorprenderme:	surprise me
ejecutado».:	executed".
«verme:	«don't give
inconsciente:	unconscious
enoja:	angry
artístico.:	artistic.
ejecución:	execution
obstáculo:	obstacle
eterno:	eternal
constituiría:	would constitute
bíblico:	biblical
alejaría:	would distance
cristiana:	Christian
pareciéndose:	resembling
excelentes:	excellent
óperas:	operas
despoja:	strips
asunto:	affair
descubro:	I discover
Hojeando:	Browsing
Usualis:	Usual
Líber:	Bast
libros::	books:
117
:	117
tendré:	I will have
caldearse:	get hot
lije:	pours
furia.:	rage
ménade:	maenad
irrumpen:	break in
infierno»:	hell"
«perras:	«bitches
reinan:	reign
Dioses:	Gods
Madres:	Mothers
arcilla:	clay
siento.:	I feel.
tormentas::	storms:
coros:	choirs
directas::	direct:
admirablemente:	admirably
correspondido:	reciprocated
conforme:	according to
resurrección:	Resurrection
implícito:	implicit
asocio:	association
encadenado:	chained
liberación:	release
Segundo:	Second
Desencadenado:	Unchained
proyecto:	project
fidelidad:	fidelity
regla:	ruler
sirviéndome:	serving me
trazo:	I bring
libretas;:	notebooks;
corriendo:	in a hurry
transcurrida...:	elapsed...
transcurrida:	elapsed
Cobraba:	He charged
faltaba.:	was missing.
intuía:	I intuited
resto::	rest:
músico:	musician
embrión:	embryo
gruñir:	snarl
maneras:	ways
alternación:	alternation
mágica:	magic
reclamada:	defendant
nota:	use
necesitar:	need
transformaba:	transformed
exorcismo:	exorcism
palabra-célula:	word-cell
renació:	reborn
auténtico:	authentic
perros.:	dogs.
dejados:	left
roían:	gnawed
babeantes:	drooling
creían:	they believed
superioridad:	superiority
ufanarme:	weapon
hicieran:	they did
hombres;:	men;
lección:	lesson
orines.:	urine.
excrementos:	excrement
postrados:	prostrate
ponzoña:	poison
escuché:	listen
monstruos:	monsters
Paleolítico:	Paleolithic
crecer:	grow
semilla:	seed
resembrada:	reseeded
asombro::	astonishment:
reflexión.:	reflection.
deleitosa:	delightful
sorprende:	surprise
momento...:	moment...
aprovechados:	taken advantage of
empezaban:	they started
inexplotados:	unexploited
eclesiásticos:	ecclesiastics
habilidoso:	skillful
trombón:	trombone
contrabajo:	double bass
flautín:	piccolo
diálogos:	dialogues
sorprendentes:	surprising
116
:	116
citaba:	cited
especulando:	speculating
defenderme:	defend myself
incitaciones.:	incitements.
riesgosas:	risky
entrañaba:	entailed
reinvención:	reinvention
engendrados:	begotten
estilos:	styles
musicales.:	musicals.
implicaciones:	implications
palabra-
célula:	word-
cell
indiscutible:	indisputable
intrincada:	intricate
resultado:	result
presentada:	presented
simultaneidad:	simultaneity
percepción:	perception
oyente:	listener
prepararía:	would prepare
expresiva:	expressive
intensidad:	intensity
aumento:	increase
sinfónica:	symphonic
auténticas:	authentic
machihembradas:	mb lada s to town
concertadas:	concerted
armónico:	harmonic
polifónica:	polyphonic
coexistencia:	coexistence
contrapuntístico.:	contrapuntal.
enriquecimiento:	enrichment
entregarse:	surrender
compactado:	compressed
oposiciones:	oppositions
armónica:	harmonica
variación:	variation
vías:	ways
coloreaba.:	colored
diversificaba:	diversified
sonoros:	sound
constantes:	constants
creaba:	created
compostelano.:	compost it
femenino—:	female-
masculino:	masculine
—elemento:	-element
ordenaban:	they ordered
primicial:	first time
sucesivas:	successive
entradas:	entries
ondulante.:	wavy.
añadía:	added
dignidad:	dignity
severa:	severe
guirnalda:	wreath
salvaguardada::	safeguarded:
litúrgico:	liturgical
agregar:	add
decente:	decent
adornarla:	decorate it
firmus:	firm
cantus:	song
situada:	located
Catholici—:	Catholics
—Congaudeant:	- Let them rejoice
compostelano:	compost it
lejanos:	distant
impresionado:	impressed
posibles.:	possible.
aleaciones:	alloys
tenso:	tense
parche:	patch
cuerda:	rope
cobre:	copper
hecho::	made:
vibrante:	vibrant
intervenciones:	interventions
afirmándose:	asserting
recitado:	recited
normales:	normal
períodos:	periods
delimitar:	delimit
puntuación:	score
discretamente:	discreetly
entrarían:	they would enter
Transformado:	Transformed
palabra.:	word.
conditor—:	founder
rerum:	of things
—Aeterne:	-Eternally
ambrosiano:	ambrosian
himno:	hymn
centrado:	centered
así—:	So-
tuviera:	had
afirmarse:	assert
empezaría:	would start
estribillo:	chorus
medidas:	measures
sucesiones:	successions
irían:	they would go
verbo-génesis.:	verb-genesis.
adjetivo.:	adjective.
necesitaran:	they will need
sustantivos:	nouns
comenzara:	will begin
auditorio:	auditorium
adelantara:	will advance
latín.:	latin.
Illa:	Ill
Irae:	of anger
maravilla:	wonder
ocurrió:	occurred
prosodia:	prosody
escansión:	scansion
cantado:	sung
hablado:	spoken
pasara:	passed
impresionista—:	impressionistic-
estilización:	stylization
exageración:	exaggeration
115
:	115
desnuda:	naked
surgiera:	arose
interesaba.:	was interested
vienesa:	viennese
escuela:	school
logros:	achievements
llegándose:	arriving
modernos:	modern
preocupa:	worries
armónico;:	harmonic;
sostén:	support
liberarla:	free her
acompañamiento:	accompaniment
enredar:	entangle
cantando:	singing
recitar:	recite
profanas.:	profane.
litúrgicas:	liturgical
repasado:	reviewed
enfocar:	focus
acoplar:	couple
meditado:	meditation
mismo—:	same-
flaqueza:	frailty
alejado:	away
actividades:	activities
estúpidas:	stupid
Antes:	Before
sueño.:	dream.
impuesto:	tax
pensamiento::	thought:
concretar:	specify
torpezas:	clumsiness
subraya.:	underlines.
delimita:	delimit
enmienda:	amendment
tacha:	blemish
conciencia;:	awareness;
nutre:	nourishes
lucubración;:	lucubration;
delirante:	delusional
inició:	start
goteras:	leaks
lámpara.:	lamp.
sublimado:	sublimate
trabajadas:	worked
gotas:	drops
estéticas:	aesthetic
transferencias:	transfers
descabelladas:	crazy
invenciones:	inventions
adocenadas:	cobbled
fumado:	smoking
mortificante:	mortifying
lúcido:	lucid
salí:	I went out
adoptar.:	adopt.
incertidumbre:	uncertainty
proyectaba:	projected
Concierto:	Concert
vacilaciones:	hesitations
nacería:	would be born
pautado:	lined
droga:	drug
saliera:	came out
hecho.:	made.
atormentaban.:	they tormented
repentina:	sudden
trajo:	brought
intelectual:	intellectual
produjo:	produced
cuarta:	quarter
opio::	youth:
fumar:	smoke
Muchos:	Many
entendieran.:	they would understand
leyeran:	they would read
palparan:	squander
haciéndola:	doing it
inscrita:	registered
ordenación.:	ordering
asombrándose:	amazed
cerrados:	closed
«cosa»:	"What"
espíritu;:	spirit;
construido:	built
preciso.:	necessary.
cobran:	they charge
ordenarse:	order
dispersos:	scattered
disgregados:	disintegrated
compactación:	compaction
maduración:	maturation
trabajo::	job:
realizarse:	be realized
despierto:	awake
todavía—:	still-
—lejos:	-far
noches...:	nights...
arduas:	arduous
hubiésemos:	we would have
borrando:	erasing
doquiera:	everywhere
odioso.:	hateful.
pareciendo:	seeming
huraña:	swearing
114
:	114
atardecer.:	sunset.
llover:	rain
emergencia.:	emergency.
dictado:	dictation
terminar:	finish
ayudado:	helped
invectivas:	invectives
pésimo:	appalling
apuntalable:	propable
apuntalar:	shore
guayuco:	hang on co
cintura:	waist
anudado:	knotted
fraguado:	setting
llorar.:	cry.
llenaron:	they filled
fuegos:	fires
encendían:	they lit
lodo.:	official
rodeados:	surrounded
desconcertados:	bewildered
cobija.:	blanket.
colgarlos:	hang them
colectados:	collected
salvar:	save
comenzó:	began
torrente:	torrent
goteras.:	leaks.
mudando:	changing
resecas:	parched
retumbando:	rumbling
oquedades:	cavities
colándose:	sneaking in
parecieron:	they seemed
bajos:	bass
truenos:	thunder
obertura:	opening
poema.:	poem.
sabrá:	will know
falena:	moth
terciopelos:	velvets
pardos:	brown
alfabeto:	alphabet
descubrirán:	they will discover
creado.:	created.
consistirán:	they will consist
estética:	aesthetics
preguntarme:	ask me
euritmia:	eurythmy
coreografía:	choreography
Ninguna:	None
brisa.:	breeze.
bambúes:	bamboos
macizo:	solid
torbellino:	whirlwind
alborozan:	exult
vencimientos:	expirations
respiros:	breaths
pausas:	pauses
olas:	eggs
retornos:	returns
ascendente:	ascending
frondas;:	fronds;
estremecido.:	shuddered
retoños:	shoots
ligeras:	light
rondas:	rounds
organizan:	organize
poseen:	possess
bailar:	dance
Arboles.:	Trees.
fulgurante:	dazzling
raras:	rare
encienden:	turn on
acude.:	come
recobrada.:	recovered.
flecha:	arrow
disparar:	shoot
entesado:	entangled
incontenible:	irrepressible
llamada:	call
brota:	break
bien.:	GOOD.
desaparecido.:	missing.
plexo:	plexus
latidos:	beats
aprensiones:	apprehensions
desgracias:	misfortunes
presentimientos:	hunches
inmotivadas:	unmotivated
angustias:	anguish
sobresaltos:	shocks
flaccida:	flaccid
traía:	brought
malas:	lazy
estructura.:	structure.
ceñidos:	tight
músculos:	muscles
escueto:	short
esqueleto::	skeleton:
apretando:	squeezing
adelgazado:	slimmed down
pescado:	fish
mañoco:	mancoco
alimentación:	feeding
parca:	park
ruda:	brown
trabajos:	jobs
escrita—:	writing—
113
:	113
épico:	epic
gesta:	guests
jirones:	tatters
recoge:	collect
sorbido:	sordid
polvo:	dust
ritualmente:	ritually
emborracha:	drunk
alianzas:	alliances
memorables:	memorable
duelos:	duels
ardides:	ploys
inventos:	inventions
princesas:	princesses
raptos:	abducted
portentosa:	portentous
intervinieron:	they intervened
desviados:	diverted
portentosos:	portentous
héroes:	heroes
levantadas:	raised
victoriosa.:	victorious.
prodigios:	prodigies
arrasa:	rock
caribe:	Caribbean
migración:	migration
fragmentos.:	fragments.
reconstruyendo:	rebuilding
epopeya:	epic
descubrí:	I discovered
posible.:	possible.
anotarlo:	write it down
comprenderlo:	understand it
historiador:	historian
botánico:	botanical
geólogo:	geologist
naturalista:	naturalist
ansioso.:	anxious.
paladar:	palate
desconcertante:	disconcerting
habituarme:	get used to
pescar:	fish
holgarme:	relax
quemarme:	burn me
comparten:	share
reflexión:	reflection
destino—.:	destination-.
interesarse:	interest
puedan:	can
creerán:	will believe
—«por:	-"by
volverá:	will return
Buscador:	Seeker
Estado::	State:
Razón:	Reason
reticencias:	reticence
aceptan:	accept
adivino:	soothsayer
hijo;:	son;
fronterizo.:	frontier.
remacharon:	riveted
grillos:	irons
marcas:	brands
explicaciones:	explanations
descubierto.:	uncovered.
odio:	hatred
dócil:	docile
amistoso:	friendly
humillaciones:	humiliations
maltratos:	abuse
rencor:	rancor
acota:	abound
gente»:	people"
sitio:	place
responde.:	responds.
marcharse»:	leave"
daría:	would give
«La:	"The
fiebre.:	fever.
manchan:	stain
viese:	see
Pregunto:	Asked
víbora.:	snake.
encerrado:	closed
echado:	lying
parricida:	parricide
condenaban:	they condemned
espectacular:	spectacular
impresionante:	awesome
castigo:	punishment
instituya:	institute
hambre:	hunger
expulsado:	expelled
condenar:	condemn
vacilará:	will hesitate
pausado:	slow
vedada:	to carry
bestia:	beast
castigar:	punish
solemnemente:	solemnly
apoyarse:	lean
creando:	creating
sospecharlo:	suspect it
Hombre.:	Man.
jactanciosos:	boastful
bibliotecas:	libraries
escritos:	writings
cientos:	hundreds
instructivos:	instructions
poesía:	poetry
meditación:	meditation
motivo:	reason
solicitación:	solicitation
raudales—.:	torrents.
arrostrados:	faced
peligros:	dangers
Pobre:	Poor
remanso.:	backwater.
traidora:	traitor
podrido:	rotten
disfrazado:	disguised
artero:	cunning
caimán:	caiman
rugido:	roar
viajando:	traveling
fulminante:	fulminant
mordida:	bite
vampiros:	vampires
saurios:	saurians
112
:	112
cartógrafos:	cartographers
Incógnitas:	Unknowns
Terras:	Lands
comarcas:	regions
planteados:	raised
gravedad:	gravity
mayores.»:	older."
necesitarán:	will need
seamos:	let's be
reprobación:	reprobation
dirigirle:	direct you
castiga:	win
responde—:	respond—
instituir:	institute
horroroso:	horrible
inquieta:	restless
castigada»:	punished"
«será:	"it will be
infracción:	infraction
inmediatas:	immediate
realizar:	perform
capitular:	capitulate
reunión:	meeting
remontando:	reassembling
vigilar:	watch
apostar:	bet
cercado:	surrounded
acarreo:	haulage
tala:	story
anotadas:	noted
cuestiones:	issues
examen:	exam
concluye:	concludes
granos:	grain
conservación:	conservation
tajante:	cutting
urgencia.:	urgency.
debería:	ought
terminada:	finished
dónde.:	where.
moscas:	flies
invasión:	invasion
exasperante:	infuriating
agobia:	overwhelms
pesados:	heavy
sobrellevar:	endure
cargando:	charging
población:	population
movilizándose:	mobilizing
inicio:	start
ejecutar:	execute
conveniencia:	convenience
unanimidad:	unanimity
reconoce:	recognize
conjurado:	conjured
vertiente.:	slope.
narigón:	nose
trazando:	tracing
lograrse:	be achieved
demasiada:	too much
terrenos:	land
exige:	demands
cebolla:	onion
cultivo:	crop
realizado:	carried out
demanda:	demand
batey:	more
inundándose:	flooding
cercana:	close
vertiente:	slope
canalizar:	channel
tendrá:	will have
discutida:	discussed
orientación:	orientation
dirección:	address
aproxima:	approaches
Cabildo:	Council
Actas:	Minutes
Libro:	Book
asentada:	seated
respetar:	respect
hacerla:	do it
acatarla:	abide by it
juran:	legal
medida.:	measure.
justificándose:	justifying
mermado:	depleted
inconsiderada:	inconsiderate
manadas:	herds
emigración:	emigration
presentes.:	gifts.
criterio:	criterion
emergencia:	emergency
levantamiento:	lifting
hambruna:	famine
cervatillo:	fawn
hembra»:	female"
absoluta:	absolute
prohibición:	prohibition
instituye:	institutes
ciervas:	deer
cazado:	hunted
comprobado:	checked
Habiendo:	Having
escrito.:	written.
consignados:	consigned
dejarlos:	leave them
provecho:	advantage
número:	number
traseras.:	rear.
guardado:	saved
legislando:	legislating
acentuado:	accentuated
Pertenecientes:	Belonging
colegial:	schoolgirl
teniendo:	having
tendida:	lying
Sentado:	Sitting
111
:	111
mismas.:	themselves.
empañado:	tarnished
miraban:	they looked
crónica:	chronicle
conjuntivitis:	conjunctivitis
viejas:	old
pupilas:	pupils
pertenecerle:	belong to him
pintadas:	painted
sienes:	temples
pelos:	by the
llenas:	full
enmarañada:	tangled
arrugado:	wrinkled
Todavía:	Still
motivos:	reasons
causado:	caused
sentí:	I felt
resignada:	resigned
intensa:	intense
fijaron:	they fixed
inmensamente:	immensely
parajes.:	places.
aventurarse:	venture
consideración:	consideration
burlona:	mocking
permití:	I allowed
Creo:	Believe
Ningún:	No
regiones»:	regions»
sanguinarios:	bloodthirsty
perversos:	wicked
únicos:	unique
«Allí:	"Over there
nudoso::	nude:
sobrecogedora:	overwhelming
hostil:	hostile
sombría:	gloomy
quebrados:	broken
pizarrosos:	slaty
volúmenes:	volumes
respira:	breathe
detiene:	stops
descenso.:	descent.
nuestro:	our
iniciará:	will start
alcanzamos:	we reach
rúbricas:	rubrics
frías.:	cold
extraviados:	lost
veamos:	let's see
desciendan:	descend
cumbre:	summit
sorprenda:	surprise
Tenemos:	Have
proximidad:	proximity
acortan:	shorten
contemplación:	contemplation
alucinada:	hallucinated
hombres...:	men...
cobraron:	they charged
nombrados:	named
ignorados:	ignored
inhábiles:	unskilled
—obra:	-work
Palabra:	Word
recreadas:	recreated
nombradas:	named
planeta:	planet
desaparecerán:	will disappear
arrojarme:	throw me
acabaría:	would end
existía:	existed
fascinar:	fascinate
dejara:	will leave
abismos;:	abysses;
vértigo:	vertigo
invadido:	invaded
demoníaco:	demonic
caldero:	cauldron
Inclinado:	Leaning
diabólica:	diabolical
«Esta:	"This
parar:	to stop
germinan:	germinate
semillas:	seeds
hulla:	corpse
vetas:	veins
petrificado:	petrified
duerme:	sleep
fósil:	fossil
mudo:	period
Prehistoria.»:	Prehistory.”
desiertos:	deserts
saltaron:	they jumped
cordilleras:	mountain ranges
escalaron:	they climbed
atravesaron:	they crossed
servirle:	serve you
negadas:	denied
rebeldes:	rebels
fraile—.:	friar-.
huido:	fled
«Estas:	"It is
formas.:	shapes.
orgiástico:	orgiastic
mostruoso:	monstrous
acoplamiento:	coupling
anuda:	knot
enmaraña:	entangles
enrevesa:	convoluted
tallo.:	three.
desgarre:	tear
erupción:	rash
bordes:	edges
sanguinolentos:	bloody
pistilos:	pistils
larvas:	larvae
faroles:	lanterns
bulbosas:	bulbous
madrépora:	madrepora
texturas:	textures
submarina:	underwater
tentáculo.:	tentacle.
mórbida:	morbid
membranosas:	membranous
110
:	110
gramíneas:	grasses
pavorosas:	dreadful
medran:	they grow
cráter:	crater
Signos:	Signs
está...:	this...
dejándolo:	leaving it
herramientas:	tools
pudieran:	could
talladores:	carvers
ejército:	army
levantara:	will lift
gigantesco:	gigantic
erigir:	erect
explicarnos.:	explain to us.
acertamos:	we got it right
mediante:	through
cincel:	chisel
ciclópeo:	cyclopean
lunas:	remedy
arribo.:	arrival.
fijada:	fixed
rúbrica:	rubric
egipcios:	egyptians
arrojó:	daring
retirarse:	withdraw
comenzaron:	they started
embate:	clash
encalló:	ran aground
habitantes:	inhabitants
tradición:	tradition
repoblador:	repopulator
atribuyen:	attribute
dibujos:	drawings
cavados:	dug
alzo:	I get up
aniquilan:	annihilate
sublevados:	uprisings
enrabecidos:	enraged
atruenan:	I'm sorry
apocalipsis:	apocalypse
pavoroso:	dreadful
moler:	grind
ollas:	pans
platos:	dishes
comales:	eat you
tinajas:	jars
muerte;:	death;
rebelan:	they rebel
usados:	used
inventados:	invented
enseres:	equipment
Creación:	Creation
inicial:	initial
endurecer:	harden
suyo:	his
estudioso:	scholar
sorprendiéndome:	surprising me
Brujo.»:	Sorcerer."
Aprendiz:	Apprentice
presentido:	sensed
cosmogonía:	cosmogony
aún::	still:
adivinación:	guessing
fraile—:	friar-
quitchés:	quitches
sagrado:	sacred
desconocido.:	a stranger.
nuestros.:	our.
coincidente:	coincident
cosmogonías:	cosmogonies
emito:	young ones
Admirado:	Admired
rituales:	rituals
festivas:	festive
vestimentas:	garments
Tenochtitlán:	Tenochtitlan
emperadores:	emperors
plumas.:	feathers.
adorna:	adorns
emplumada:	feathered
toro:	visiting
caballo:	horse
marcadas:	marked
armaduras.:	armor.
girasoles»:	sunflowers»
«indianos:	«Indians
llamados:	called
pincel:	brush
catalnicas:	catalan
pericos:	parakeets
comadreos:	gossips
asustados:	scared
techos:	roofs
alborotoso:	rowdy
listados:	listed
carpinteros:	carpenters
laboriosidad:	industriousness
conocimos:	we met
alzando:	raising
noche;:	evening;
vestidos:	dresses
paujíes:	paulie's
fosforescente:	phosphorescence
suspensión:	suspension
inmóviles:	motionless
colibríes:	hummingbirds
Vimos:	We saw
hombre—.:	man-.
solicitan:	request
¡Dios:	God
gritado::	yelled:
teológico:	theological
soldado:	soldier
luciendo:	showing off
tucán:	toucan
rosadas:	pink
cotorras:	parrots
fastuosos:	lavish
guacamayos:	macaws
escoltaron:	escorted
109
:	109
florecidos—:	flowered—
orquídeas:	orchids
ricos:	rich
atravesado:	crossed
cuarzo:	quartz
aventada:	suggested
arrojados:	thrown
paletadas:	paddles
recogidos:	collected
alud:	avalanche
desprendido:	detached
bizantinos:	Byzantines
mosaicos:	mosaics
gravas:	it matters
molidas:	ground
azufre:	sulfur
esqueleto:	skeleton
desnudo:	naked
erosión:	erosion
aridez:	aridity
grandiosa:	great
teratología:	teratology
sacrilego—:	sacrilegious-
intruso:	intruder
vagamente:	vaguely
nieblas.:	fogs.
helada:	frost
arrojo:	daring
surca:	furrow
terraza:	terrace
fieltro:	felt
recortadas:	cropped
derribados:	knocked down
erguidas:	erected
peñas:	rocks
accidentado:	hilly
esquistos:	shales
descansamos:	we rest
llaves:	keys
pagado:	paid
pongan:	put
bultos:	lumps
torturarme:	torture me
hacerles:	make them
suya:	to the water
encargará:	will order
uso.:	use.
enser:	alike
reponer:	replenish
indispensables:	essential
proveerse:	provide
acostumbrado:	used to
enviaré:	I will send
ceño:	frown
desarrugar:	unwrinkle
comprender.:	grasp.
dolida:	hurt
brusco:	abrupt
aparto:	apart
bramido:	bellow
botija:	cylinder
cañas:	white hair
sopla:	blows
resquemores.:	resquemores
desconfianza:	distrust
desertado:	deserted
restos:	remains
enterrar:	bury
romperlos:	break them
sacar:	withdraw
Debería:	Ought
vitrinas.:	showcases.
fichas:	chips
reclamo:	claim
perpetuo:	perpetually
piezas:	parts
hallaran:	cases
plácidamente:	placidly
usurarios.:	usurers
préstamos:	loans
sacrificios:	sacrifices
empeños:	pawns
entregaron:	they delivered
fondos:	funds
devolviendo:	returning
defección:	defection
responsabilidad:	responsibility
aceptará:	will accept
fiador.:	guarantor.
evadirme:	evade
fardo:	burden
solté:	I blurted out
selvas:	jungles
presencia.:	presence.
castigados:	punished
arrinconarlos:	corner them
sirvió:	served
objetos-acreedores:	creditor-objects
echando:	of winter
atiesaron:	migraines
hinchadas:	swollen
protectoras:	protective
sujetaban:	they held
desaté:	let go
dolorosa.:	painful
acompañó:	accompanied
resonante:	resonant
principio:	principle
tambor-bastón-de-ritmo:	drum-rhythm-stick
sugerida:	suggested
ideado:	devised
sonará:	will sound
campanas:	bells
espadaña:	bulrush
ahuecado:	hollow
Colgamos:	We hang up
premonición:	premonition
curvas:	curves
repetido:	repeated
gótica:	gothic
tuviesen:	had
108
:	108
rematada:	finished
viguetería:	joists
moriche:	in chili
amplia:	wide
construir:	build
reunirme:	meet
ropa:	clothes
poca:	little
intelectual.:	intellectual.
quedarme:	stay
cavilaciones.:	overthinking.
entregado:	delivered
pentáfonas...:	pentagons...
gamas:	ranges
generalizada:	widespread
noción:	notion
destructoras:	destroyers
elementalidad:	elementality
bellos:	beautiful
cantos:	songs
librescas.:	bookish.
aferrados:	clinging
observaciones:	observations
levantarían:	they would lift
polvareda:	dust cloud
soñar:	dream
falaces:	fallacious
teorías:	theories
sonoro:	sonorous
interpretado:	interpreted
brotan:	sprout
fugas:	leaks
chapuzones:	dips
ronquidos:	snoring
rumores:	rumors
musical-estético:	musical-aesthetic
tuviese:	had
trino:	triune
gorjeo:	goryeo
imitar:	mock
sostener:	hold
dichas:	said
tonterías:	foolishness
originarse:	originate
alturas:	heights
alternar:	toggle
ensalmador:	salamander
obligaba:	forced
fingida:	feigned
cierto;:	TRUE;
originaba:	originated
monosílabo:	monosyllable
emprendía:	undertook
remota.:	remote.
hechicería:	sorcery
derivadas:	derivatives
pervivencia:	survival
arriesgadas:	risky
construyendo:	building
psicología:	psychology
tratados:	treaties
razonamiento:	reasoning
mágico.:	magical.
ultratumba.:	beyond the grave
sierpes:	wyrms
mordeduras:	bites
faraón.:	Pharaoh.
preservar:	preserve
heridas:	wounds
detienen:	stop
hijos:	children
persas;:	Persians;
emperador:	emperor
resucita:	resurrect
Esquilo:	Squirrel
Pude:	Could
asistí:	I attended
trote:	trot
remedar:	helper
fijación:	fixation
poderes:	powers
otorga:	grants
primitiva:	primitive
hermanar:	twin
Muy:	Very
nuestro.:	our.
contemporáneo:	contemporary
religiosas:	religious
curativas:	bandages
cotidiana:	everyday
instituciones:	institutions
albores:	dawn
pretenden:	intend
cuan:	how
absurda.:	absurd.
orígenes:	origins
cestería.:	basketry
trabajan:	they work
primogénito:	firstborn
sentados:	sitting
cálida:	warm
padecidos:	sufferers
vigilancias:	surveillance
prohibiciones:	prohibitions
fealdades:	ugliness
sustraerse:	subtract
inesperado:	unexpected
privilegio:	privilege
disfrute:	enjoyment
causan:	cause
servirlo.:	serve him.
ofrecerles:	offer them
felicidad:	happiness
compañeros:	companions
crueldad:	cruelty
molestado:	bothered
Siempre:	Always
naves.»:	ships.”
encadenarlos:	chain them
héroe—:	hero-
sollozantes:	sobbing
traerlos:	bring them
«Tuve:	"Had
olvidan:	they forget
107
:	107
fruta:	fruit
probar:	prove
lotófagos:	lotus eaters
despacha:	dispatch
sonreír::	smile:
párrafo:	paragraph
tropezando:	tripping
cabellos:	hair
desgaire:	disabled
laja:	intervene
Recostado:	lying down
inmensa:	immense
torceduras:	sprains
hembra:	female
hundiré:	interior
hoguera:	bonfire
repetirme:	repeat myself
hago.:	do.
mujer.:	women.
formación:	training
apegar:	attach
establecer:	establish
intelectuales:	intellectuals
acomodos:	accommodations
habituarse:	get used to
ciudades.:	cities.
hacinamiento:	overcrowding
vastedad:	vastness
prefiera:	prefer
mineros:	miners
lindero:	boundary
implica:	implies
determinación:	determination
varón.:	male.
reciba:	receive
recibirá:	will receive
docilidad:	docility
pregonero.:	crier.
menesteres:	necessities
encanallando:	plumbing
azada:	hoe
empuñar:	wield
Prefiero:	Prefer
inútil.:	useless.
agobiarse:	get overwhelmed
cargaba:	loaded
dejarán:	they will leave
tinieblas.:	darkness.
alambre:	wire
presa:	taken
ardilla:	squirrel
girar:	spin
profesiones:	professions
impuso:	imposed
Sísifo:	Sisyphus
sustraerme:	steal away
enseñan:	they teach
practican:	they practice
Trataré:	I will try
desierto...:	desert...
predicando:	preaching
enjuto:	lean
canas:	reeds
cubrir:	cover
bañarán:	will bathe
vendrán:	they will come
limalla:	with slime
gruesa:	gross
metiendo:	putting
helados:	ice cream
desembocan:	flow
matriz.:	headquarters.
integrarme:	integrate
límite:	limit
caladas:	quiet
pulsaciones:	pulsations
oscuras:	dark
latido:	beat
seminales:	seminal
conductos:	ducts
endurecen:	harden
nuca:	nut
axilas:	armpits
oscurece:	darkens
pectorales:	pectorals
revienta:	burst
trepa:	climb
testículos:	testicles
calienta:	heats
bañado:	bathed
nanadores:	nandores
muslo:	thigh
caderas:	hips
ennegrece:	blacken
expuesto:	exposed
grato:	grateful
asombrados:	amazed
travesura:	mischief
liberamos:	we release
vence:	wins
jadea:	gasp
desnudez:	nakedness
edénico:	edenic
alarde:	parade
ocre.:	ocher.
tiñen:	dye
tanino:	tannin
cauces:	channels
derramarse:	spill
encendidas:	lit
106
:	106
brotando:	sprouting
Pareja:	Couple
desnudos:	nudes
bañamos:	we bathe
espumas:	foams
pátina:	patina
plancton:	plankton
debiera:	should
especies:	species
palmo:	palm
complejo:	complex
minúscula:	lower case
vegetales:	vegetables
herrumbres:	rust
plateados:	silver
pigmentos:	pigments
líquenes:	lichens
oquedad:	cavity
Asomado:	Leaning
esmalta.:	enamel
cierzo:	north wind
leve:	live
sacuden:	shake
helechos:	ferns
diluirse:	dilute
paredones:	walls
recostadas.:	lying down
granito:	granite
acantilado:	cliff
aclaran:	clarify
adelgazan:	lose weight
velos:	fleeces
tendiendo:	tending
Amanece:	dawn
junio):	June)
excusa.:	excuse.
cebollas»:	onions»
sembrar:	sow
«Además:	"Besides
Henoch.:	Enoch.
erigirse:	stand up
comenzará:	will begin
rabioso:	rabid
nacieron:	were born
«Alguien:	"Someone
Redención::	Redemption:
agresivo:	aggressive
abruptamente:	abruptly
interrumpe:	interrupts
ramo:	branch
ajustado:	tight
objetar:	object
religiones:	religions
aprendí:	I learned
aprendan:	learn
cuentos:	stories
contarán:	count
distinguir:	distinguish
curas:	cures
viajaban:	they were traveling
naciente:	nascent
confió:	trusted
variante:	variant
hijos;:	children;
enseñar:	teach
volvió:	came back
despachó:	dispatch
cesado:	ceased
inundación:	flood
llovió:	it rained
canoa.:	canoe.
pareja:	couple
salvó:	except
subir:	rise
hinchara:	will swell
contemplábamos:	we contemplated
atónito:	amazed
dejó:	let
adolescente:	adolescent
Fundador—:	Founder-
escrúpulos::	scruples:
astrales.:	astral
escorpiones:	scorpions
dibujan:	they draw
tránsitos:	transits
izados:	hoisted
—artesanos:	—artisans
desconocidos:	unknown
artesanos:	artisans
jornada:	day
Autana:	Autoana
aldea:	village
efectivamente:	indeed
Signo:	Sign
Edad:	Age
fundación:	foundation
permanecer:	remain
incapaz:	unable
Penélope.:	Penelope.
diamantes:	diamonds
él.:	he.
inmenso:	immense
buscadores:	search engines
cuarzos:	quartz
contento:	happy
interesa:	interest
abril:	April
bajado:	lowered
creyendo:	believing
remos:	oars
ocurrido:	occurred
botador:	bouncer
bogar:	arcs
impaciencia.:	impatience.
corteza:	crust
incisión:	incision
continente:	continent
primero:	first
respondiendo:	responding
amarillas:	yellow
terminaron:	they finished
empuje:	push
disponer:	provide
trascendencia:	transcendence
fríos:	cold
ansioso:	anxious
finjo:	I pretend
griegos.:	Greeks.
dicen:	they say
comenta:	comment
estuve:	I have been
Conquistadores:	Pathfinders
dueño:	owner
tarda:	afternoon
navegar:	browse
hijas:	daughters
tienda:	store
cubierto:	covered
traspasado:	transferred
imaginar:	imagine
desollado:	desolate
tomé:	Thomas
Hasta:	Until
preguntas:	questions
matadores:	matadors
mutilado:	mutilated
recientemente:	recently
bravios:	brave
fuerte:	strong
Hidra:	Hydra
—en:	-in
Navio:	Ship
agorero:	doomsayer
pinturas:	paintings
salón:	salon
suficiente:	enough
hubiese:	would have
empeño:	endeavor
aturdirse:	stun
rápidamente:	quickly
enojado:	angry
Padrenuestro:	Our Father
enfermedades:	diseases
subirse:	get on
blandura:	softness
sobresalta:	startles
últimas:	latest
recuerdan:	remember
convergencia:	convergence
viajes:	trips
enteros:	whole
extremos:	extremes
colillas:	butts
estaré:	I will be
cien:	hundred
huelen:	take
albergue:	hostel
hastiado:	jaded
abro:	I open
terreno.:	land.
quedó:	remained
indefinidamente:	indefinitely
alarga:	lengthens
perder:	lose
abogado:	lawyer
corazón:	heart
figura.:	figure.
revista:	magazine
Sólo:	Only
podido:	could
Porvenir.:	Future.
Recuerdos:	Memories
taberna:	bar
corren:	they run
letras:	lyrics
Apocalipsis:	Apocalypse
fechas:	dates
grandeza:	greatness
transcurrido:	elapsed
abuso:	abuse
ennoblecidos:	ennobled
tristeza:	sadness
estrechez:	narrowness
meros:	heritage
consiste:	consists
cabezas:	heads
quieren:	they want
enseña:	teaches
Venusberg:	Venus mountain
precisamente:	precisely
vivirlo:	live it
cemento:	cement
órdenes:	orders
vivienda.:	dwelling.
jefe:	boss
pública:	public
vivienda:	dwelling
automatismo:	automatism
guirnaldas:	garlands
haba:	length
escucha:	listen
presentes:	gifts
penumbras:	shadows
descansan:	they rest
subterráneo:	underground
multitud:	crew
andan:	from the moment
ancha:	much
cruzan:	cross
leves:	light
llorar:	cry
plantada:	planted
tenerme:	have me
yeso:	and so
decoración:	decoration
tratar:	treat
habría:	there would be
indulgencia:	indulgence
escucharme:	listen to me
tránsito:	transit
engañados:	deceived
perenne:	perennial
encuentros:	meetings
precisa:	it needs
día.:	day.
separación:	separation
Comprendí:	I understood
Sus:	Their
inmovilizada:	immobilized
máscaras:	masks
situado:	situated
vasta:	only
paludismo:	malaria
afirmando:	stating
presenta:	presents
hábil:	skillful
lectura:	reading
biblioteca:	library
Entre:	Between
deseos:	wishes
aquí.:	here.
crueles:	cruel
espera.:	wait.
galería:	gallery
arañas:	spiders
observo:	noticed
recepción:	reception
sonido:	sound
conviven:	coexist
borracho:	drunk
presidente:	president
espejos:	mirrors
sollozos:	sobs
intimidad:	privacy
acude:	come
suelen:	they usually
leyendas:	legends
nombres:	names
centenares:	hundreds
misiones:	missions
misión:	mission
hallaron:	they found
peores:	worst
revelar:	reveal
vender:	sell
cuartillas:	quarters
Ese:	That
repasando:	reviewing
oír:	hear
creí:	I believed
reunirse:	meet up
abandonado:	abandoned
pista:	track
cautivo:	captive
explorador:	explorer
sufre:	suffer
estamos:	we are
sacarme:	take me out
apacible:	gentle
excusa:	excuse
conyugal;:	conjugal;
virtud:	virtue
familia:	family
hogar:	home
irrita:	irritates
plácido:	placid
elogios:	compliments
explicó:	explained
comunión:	communion
fotografías:	photographs
víspera:	eve
ignorada:	ignored
actualidad:	present
figura:	figure
patética:	pathetic
zona:	area
pidió:	asked
exploradores:	explorers
tuvo:	had
apartamento:	apartment
dramática:	dramatic
rodeada:	surrounded
publicaciones:	publications
rodea:	surrounds
creía:	believed
suburbios:	suburbs
seis:	six
vivido:	vivid
índices:	indexes
arcos:	bows
nacer:	be born
jarras:	jugs
mando:	command
hablo:	speak
callarme:	shut up
sentía:	felt
amigos:	friends
tocara:	will touch
llevaría:	would take
culpas:	blame
víctima:	victim
vínculo:	bond
haberme:	have me
regresaré:	I will return
Dentro:	Within
Adelantado.:	Advanced.
plena:	full
llevando:	carrying
ofrecida:	offered
recibir:	receive
maleta:	suitcase
indudable:	doubtless
angustia:	distress
cuadernos:	notebooks
tinta:	ink
expresar:	express
marchar:	leave
ponen:	they put
aguarda:	wait
acontecimiento:	event
hacerse:	become
sendero:	path
cierran:	they close
amarillo:	yellow
aluminio:	aluminum
cantimplora:	canteen
telas:	screens
cruzarse:	cross
Henoch:	Enoch
admiro:	admire
área:	area
pilotos:	pilots
premio:	award
ofrecido:	offered
incluye:	includes
prisionero:	prisoner
Alguien:	Someone
llaman:	they call
contacto:	contact
repite:	repeat
años.:	years.
pesado:	heavy
salido:	left
regresa:	come back
trueno:	thunder
pecho:	chest
ecos:	echoes
volaban:	they flew
seguidos:	followed
carga:	load
hiciera:	did
cipos:	cipes
muros:	walls
Dos:	Of the
salía:	went out
presión:	pressure
hundía:	sank
ojos.:	eyes.
arrodillado:	kneeling
Petroglifos:	Petroglyphs
marcaban:	they marked
seña:	sign
llamar:	call
actitud:	attitude
igualmente:	also
atropello:	run over
experiencia:	experience
dije:	said
emprende:	undertake
umbral:	threshold
brotado:	sprouted
acariciar:	stroke
ansias:	craving
buscamos:	we seek
cosas.:	things.
bruma:	Hoar
confundidos:	confused
muertas:	dead
fomento:	promotion
reglas:	rules
padecer:	suffer
desaforada:	unbridled
torrente.:	torrent.
Cada:	Each
pintan:	they paint
hongos:	fungus
cubiertos:	covered
naturaleza:	nature
agobio:	burden
aparece:	appears
aligerando:	lightening
acrece:	increases
usando:	using
excitación:	excitement
vuelva:	come back
pequeñas:	small
trabajando:	working
Sigo:	I continue
acabar:	end
ir:	and
terminen:	the semester
cortezas:	crusts
trataba:	tried
leproso:	leper
esperando:	waiting
caverna:	cave
guarda:	guard
¡Vete:	¡Alone
pedazos:	pieces
agitando:	waving
llanto:	crying
agujero:	hole
Bajo:	Low
horribles:	horrible
antigüedad:	antique
lepra:	leprosy
seguido:	followed
grito:	shout
Allá:	There
oyendo:	hearing
estampa:	print
mío.:	mine.
mueve:	moves
Frente:	Forehead
concepto:	concept
licor.:	liqueur.
engaño:	deception
hombre.:	man.
quita:	remove
atadura:	tie
casamiento:	marriage
orgullo:	pride
transforma:	transform
dominical:	Sunday
oportunidad:	chance
costado:	side
festiva:	festive
realmente.:	really.
consumado:	consummated
viajar:	travel
imagen:	image
quién:	who
pensé:	think
despecho.:	spite.
resquemante:	resequent
abandonar:	abandon
haciéndome:	making me
aprovechar:	leverage
fibra:	fiber
establecida:	established
pasará:	will pass
lamento:	I regret
sumamente:	extremely
arduo:	arduous
trato:	deal
zozobra:	anxiety
veré:	I will see
ánimo:	cheer up
temor:	fear
suscrita:	subscribed
alegría:	happiness
guardar:	keep
espectáculo:	show
aceptar:	accept
llevada:	carried
prohibido:	forbidden
comedia:	comedy
Podría:	Could
tribunales:	courts
principios:	beginning
desafiante:	challenging
prorrumpo:	I burst out
nupcial:	bridal
cromo:	chrome
personajes:	characters
abrazamos:	we hug
dedos:	fingers
cayado:	crook
dudas:	doubts
violencia:	violence
irónica:	ironic
reacción:	reaction
legales:	legal
obligación:	obligation
ejemplos:	examples
ajena:	alien
pienso:	I think
Libros:	Books
Medievo:	Medieval
conoce:	know
guitarra:	guitar
libretas:	notebooks
«Te:	"The
papel.:	paper.
cuaderno:	notebook
sorpresa.:	surprise.
tregua:	truce
Sé:	See
facilidad:	ease
geometría:	geometry
consignas:	slogans
inspiración:	inspiration
colocados:	placed
recuperar:	recover
espontaneidad:	spontaneity
salud:	health
ahora.:	now.
gráfica:	graphic
irregularmente:	irregularly
página:	page
lápiz.:	pencil.
acorde:	chord
discantus:	students
pondrá:	will put
levanta:	get up
traído:	brought
discurso:	speech
muerte.:	death.
vacas:	cows
regrese:	come back
Libación:	Libation
bastaba:	it was enough
rincón:	corner
arruga:	wrinkle
respondo:	answer
escándalo:	scandal
vueltas:	turns
lleno:	full
ponerme:	put on
opuesto:	opposite
«Hijo:	"Son
retórica:	rhetoric
morado:	purple
Vidas:	Lives
menudo:	slight
inglés:	English
confesión:	confession
Nunca:	Never
ministerio:	ministry
propios:	own
textos:	texts
rodean:	surround
versos:	verses
Ciertos:	Some
mentalmente:	mentally
tercio:	third
Prometeo:	Prometheus
pentagramas:	staves
esbozar:	outline
empiezo:	start
entrega:	delivery
—que:	-what
futuro:	future
contemplaba:	contemplated
—forma:	—shape
visión:	vision
cautivos:	captives
ennegrecido:	blackened
hechicero:	sorcerer
poblado:	populated
orillas:	shores
abre:	open
inteligentes:	smart
músicos:	musicians
pocos:	few
armonía:	harmony
referencia:	reference
desconfiar:	distrust
Había:	There was
confusa:	confused
concepción:	conception
lograr:	achieve
polifonía:	polyphony
puros:	cigars
pasaba:	was passing
sucesión:	succession
restaba:	remained
colgada:	hung
directamente:	directly
darle:	give
tropo:	trope
encuadrar:	frame
cercano:	nearby
sencillez:	simplicity
cuidado:	Careful
entonación:	intonation
elocuencia:	eloquence
reclamar:	complain
haciéndose:	making
buscaba:	I was looking for
paroxísticos:	paroxysmal
exasperados:	exasperated
compositores:	composers
inflexiones:	inflections
diciendo:	saying
recitativo:	recitative
problema:	problem
incitación:	incitement
título:	title
necesaria:	necessary
claridad:	clarity
traerá:	will bring
embriaguez:	drunkenness
semejante:	such
agujas:	needles
burbujeantes:	bubbly
sonidos:	sounds
imposibles:	impossible
resuelto:	resolved
imaginado:	imagined
siguiente:	following
molesta:	bothers
pluma:	feather
algunas:	some
tendría:	would have
creación:	creation
euforia:	euphoria
informes:	information
duermo:	I sleep
cariño:	dear
acontece:	it happens
abrazar:	embrace
vez.:	time.
hábito:	habit
humo:	in it
viviendas:	housing
húmedas:	wet
amanecer:	sunrise
sostienen:	hold
vigas:	beams
hamacas:	hammocks
pasamos:	we passed
socavones:	sinkholes
Hubo:	Was
Llueve:	It's raining
manchado:	stained
caracol:	snail
simplemente:	simply
superiores:	superiors
Llego:	Arrive
dibuja:	draw
prodigiosa:	prodigious
viento.:	wind.
descubierto:	uncovered
llamo:	called
cerca.:	fence.
descanso:	rest
apremio:	pressure
acerco:	approach
metida:	stuck up
ocurrir:	occur
demasiado.:	too much.
memoria:	memory
oscuramente:	darkly
huesos:	bones
encierran:	enclose
relatos:	reports
unidad:	unit
combates:	fighting
curso:	course
oscura:	dark
explicar:	explain
etnógrafo:	ethnographer
reposo:	repose
novedad:	novelty
horas.:	hours.
haberse:	have
creada:	created
posibilidad:	possibility
«Este:	"It is
aparecer:	to appear
haría:	would
cuero:	leather
asentado:	settled
acabará:	will end
fundado:	founded
mitos:	myth
inteligente:	intelligent
tormenta:	storm
crótalo:	crotalus
problemas:	problems
numerosos:	numerous
llegará:	will arrive
haciéndosele:	making him
«Hasta:	"Until
castigos:	punishments
hombrecito:	little man
ultimo:	last
latines:	Latin
inmediato:	immediate
recuerda:	remember
salidas:	Departures
palmos:	spans
valladar:	fence
respondía:	responded
explicaciones.:	explanations.
severamente:	severely
granos.:	grain.
almacén:	store
efecto:	effect
canteros:	stonemasons
públicas.:	public.
considerar:	consider
comarca:	district
fieras:	beasts
acción:	action
caza:	hunting
sometida:	subdued
disposición:	provision
«el:	"he
patas:	paws
sentado:	sitting
Responsable:	Responsible
portada:	front page
libreta:	notebook
horcón:	pitchfork
hechas:	made
enrojecidas:	reddened
desconcertado:	embarrassed
tristes:	sad
respuesta:	answer
ingratos:	ungrateful
inutilidad:	futility
viven:	they live
contempla:	contemplate
borde:	should
mediodía.:	average.
obeliscos:	obelisks
cayado.:	crook.
ligero:	light
dándome:	giving me
bocas:	mouths
anteriores:	previous
espesor:	thickness
tremendo:	tremendous
hundirme:	inside
Terrenal:	Earthly
Paraíso:	Paradise
rodeaba:	surrounded
vegetación:	vegetation
contrario:	contrary
arrojando:	throwing
humanos:	humans
fecha:	date
viviendo:	living
hueso:	bone
pinta:	surface
contemplar:	contemplate
milenios:	millennia
alimento:	food
colgados:	hung
montaña:	mountain
firmemente:	firmly
atacar:	attack
estrellas:	stars
bestias:	beasts
enormes:	huge
siglos:	ages
hubo:	was
mundo.:	world.
vencedor:	winner
aparecen:	appear
ladridos:	barking
dan:	And
debió:	should have
lenguaje:	language
máquina:	machine
trágica:	tragic
—afirma:	—states
«En:	"In
leído:	read
pregunta:	ask
opinión:	opinion
flautas:	flutes
ornamentos:	ornaments
mitologías:	mythologies
serpiente:	snake
volante:	steering wheel
advocación:	dedication
civilizaciones:	civilizations
tuvieron:	they had
oscuro:	dark
percutiente:	striking
vertiginosa:	vertiginous
insectos:	insects
pensamientos:	thoughts
malos:	bad
te:	the
pájaro:	bird
esmalte:	enamel
Tierras:	Land
limpios:	clean
jornadas:	days
hubiesen:	they would have
escorias:	slag
calcedonias:	chalcedony
milenaria:	millennial
arcano:	arcane
rompe:	breaks
—un:	— and
escombros:	debris
filos:	edges
viento:	wind
ascendido:	promoted
evasión.:	evasion.
correo.:	mail.
hermana:	sister
Allí:	Over there
dañado:	damaged
enojo.:	anger.
cuento:	tale
tinieblas:	darkness
venido:	come
ausente:	absent
asiento:	seat
seguramente:	surely
pertenecen.:	they belong.
acusadora:	accuser
niños:	children
rodeado:	surrounded
suelo.:	floor.
sonajeras:	rattles
funeraria:	mortuary
jarra:	jug
éstas:	are
fabricación:	manufacturing
líneas:	lines
figuración:	figuration
ventanas:	windows
puntiagudo:	pointed
cabaña:	cabin
zafarme:	get away
singulares:	singular
escalas:	scales
útil:	useful
También:	Also
oficio.:	job.
entendimiento:	understanding
código:	code
gritos:	shouting
concierto:	concert
constantemente:	constantly
halló:	found
práctica:	practice
repetición:	repetition
él;:	he;
tragedia:	tragedy
hipótesis:	hypothesis
llegaron:	they arrived
ésos:	those
dijeron:	they said
tesis:	thesis
confirma:	confirm
nacimiento:	birth
animales.:	animals.
galope:	gallop
debida:	due
representación:	representation
plástica:	plastic
ingeniosa:	ingenious
prehistórico:	prehistoric
situarse:	situate oneself
especulaciones:	speculations
vanas:	old
teoría:	theory
físico:	physical
encuentran:	find
irritación:	irritation
recompensa:	reward
relato:	report
bancos:	banks
alegría.:	happiness.
estará:	will be
entera:	whole
serán:	will be
claridades:	clarities
quedo:	stay
valores:	values
ahora—:	now-
entrañablemente:	endearingly
—pues:	-well
conocido.:	acquaintance.
distinto:	distinct
hermanas:	sisters
nacida:	born
comprendido:	understood
peso:	weight
ceniza:	ash
huyendo:	fleeing
vengo:	come
destino:	destination
simples:	simple
aprender:	learn
tomado:	taken
traje:	lasts
cueros:	leathers
mármol.:	marble.
añoranza:	yearning
buscan:	search
sudor:	sweat
columna:	column
conservan:	preserve
franja:	fringe
muere:	die
brisa:	breeze
distinta:	different
limpia:	clean
fingimiento:	pretense
estanque:	pond
cavado:	dug
hervor:	out
caída:	drop
árbol.:	tree.
disputan:	they dispute
distintas:	distinct
vegetaciones:	vegetations
abajo.:	below.
escala:	scale
musgos:	mosses
contemplo:	I contemplate
ocultarse:	hide
brumas:	mists
cimas:	tops
inmensas:	immense
refleja:	reflects
Formas:	Shapes
demoran:	delay
nieblas:	fogs
advierte:	warns
redonda:	round
menester:	need
nadie:	nobody
Noés:	Noah
Pensando:	Thinking
mismos:	themselves
«Ya:	«Yes
yerbas.:	herbs.
sabía:	knew
desconocidas:	unknown
regiones:	regions
consideraba:	considered
puesta:	putting
sabían:	they knew
patraña:	humbug
—por:	-by
patas.:	paws.
gigantesca:	gigantic
petroglifos:	petroglyphs
enseñado:	taught
narrarle:	narrate
—cuenta:	-account
explicación:	explanation
fueran:	were
cultura:	culture
andamiaje:	scaffolding
necesita:	needs
marca:	mark
navegación:	navigation
comprendo:	understand
caño:	spout
yacimiento:	deposit
explica:	explains
diciembre):	December)
Cabellera:	Hair
griegos:	greeks
andando:	going
descansar:	rest
destinadas:	intended
busco:	I'm looking for
avellanado:	countersunk
Alzo:	I get up
espejo:	mirror
caras:	guys
bóvedas:	vaults
lentamente:	slowly
colectivo:	collective
Si:	And
alivio:	relief
debilidad:	weakness
aspecto:	aspect
nuestras:	our
autor:	author
viaje.:	journey.
periodista:	journalist
gestos:	gestures
Parece:	It seems
conyugal:	conjugal
columnas:	columns
rostros:	faces
empresa:	enterprise
abraza:	hug
perdón:	sorry
pide:	ask
Tengo:	Have
rumbo:	course
mentiras:	lies
suma:	addition
conversación:	conversation
velado:	veiled
habíamos:	we had
ignoran:	they ignore
hallarse:	be
iniciar:	start
vitrinas:	showcases
volando:	flying
dejé:	I left
llamáis:	you call
acuesto:	I lie down
cabellera:	hair
estrépito:	crash
cierra:	close
joven:	young
capaz:	able
divorcio.:	divorce.
esfuerzo:	effort
destino.:	destination.
vocación:	vocation
tinta.:	ink.
admito:	I admit
Hago:	Do
vuelven:	they come back
planchas:	irons
beber:	to drink
raudales:	rapids
tempestad:	storm
acá:	here
minutos:	minutes
transcurre:	passes
cuarto:	room
rumbos:	directions
partida:	match
vuelo:	flight
novela:	novel
decirme:	tell me
semana:	week
cerrada:	closed
adelante:	forward
existencia.:	existence.
esto.:	this.
dedo:	finger
señaló:	pointed out
labios:	lips
rebozo:	shawl
diálogo:	dialogue
salidos:	exited
fría:	cold
izquierda:	left
admitir:	admit
espesas:	thick
rodillas:	knees
poner:	put
alfombra:	rug
encontró:	found
riendo:	laughing
pintado:	painted
nociones:	notions
oigo:	I hear
Algo:	Something
lápiz:	pencil
lugares:	places
evasión:	evasion
vanidad:	vanity
evidente:	obvious
tercera:	third
situación:	situation
firme:	firm
semejantes:	similar
verla:	see it
gravidez:	pregnancy
importancia:	importance
pasaron:	bird
libertad:	freedom
abierta:	open
ridículo:	ridiculous
edificante:	edifying
pueden:	they can
tenían:	they had
vivía:	lived
empiezan:	they start
esperaba:	I expected
da:	and
papeles:	papers
venidos:	come
siguen:	they continue
Todas:	All
fui:	I went
casos:	cases
dolor.:	pain.
inacabable:	unending
lados:	sides
respiración:	breathing
prisa:	hurry
frío:	cold
asegurar:	ensure
puntos:	points
orilla:	bank
tumba:	grave
llenado:	fill
varón:	male
Apenas:	Just
cuentas:	accounts
episodio:	episode
detengo:	I stop
pasajes:	tickets
mío:	mine
Vuelvo:	I'm back
propiciatorio.:	propitiatory.
hablaba:	spoke
verdadero:	TRUE
ésta:	this
peor:	worse
estilo:	style
Brabante:	Brabant
aullan:	howl
matriz:	headquarters
vida.:	life.
fuga:	leak
ofrece:	offers
pedirle:	ask
añadiendo:	adding
función:	function
ancianos:	seniors
Aún:	Still
recursos:	resources
último:	last
pensaba:	thought
invención:	invention
melismático:	melismatic
desarrollo:	development
voces:	you
pureza:	Preza
enunciado:	statement
dibujo:	drawing
Aquello:	That
nube:	cloud
vocablos:	words
corifeo:	coryphean
hallando:	finding
modos:	modes
funciones:	functions
nuevas:	new
posibilidades:	possibilities
seguro:	insurance
imaginación:	imagination
Treno.:	Train.
esbozos:	sketches
esperar:	wait
oscuridad:	darkness
consistencia:	consistency
fórmulas:	formulas
menor:	smaller
curiosidad:	curiosity
llevar:	carry
partitura:	score
lógica:	logic
abiertos:	open
sueño:	dream
haberle:	have him
tratando:	treating
efectos:	effects
ropas:	clothes
inútil:	useless
mesetas:	plateaus
días.:	days.
hermoso:	beautiful
Nada:	Nothing
repente:	suddenly
conocen:	they know
armado:	armed
siente:	feel
piel:	fur
grasas:	fats
afirma:	states
marcha:	march
quisiera:	I'd like
cerebro:	brain
sabores:	flavors
ajeno:	unaffiliated
pereza:	laziness
tremenda:	tremendous
espíritu:	spirit
añade:	duck
Mesetas:	Plateaus
recién:	newly
hicieron:	they did
aquellos:	those
voz.:	voice.
buscador:	seeker
tenga:	have
comprender:	grasp
—si:	-and
sabido:	known
terciopelo:	velvet
llevo:	he took
indios.:	Indians.
danzas:	dances
deber:	duty
—una:	-a
fija:	fixed
levantar:	lift
señalado:	indicated
trabajo:	job
época:	era
queda:	is left over
comunidad:	community
acuerdos:	agreements
trata:	treats
Indios:	Indians
Capitán:	Captain
venas:	is coming
orejas:	ears
misionero:	missionary
bastón:	cane
señala:	points out
bajar:	lower
naturales:	natural
hombro:	shoulder
contorno:	contour
crear:	create
siglo:	century
ritmos:	rhythms
estupor:	stupor
comienzo:	beginning
plantas:	plants
brazo:	arm
redondez:	roundness
ámbito:	scope
lleva:	carry
dejaron:	they left
regresado:	returned
sordo:	deaf
llegó:	arrive
Estamos:	We are
primitivos:	primitives
oídos:	ears
demiurgo:	demiurge
perros:	dogs
amenaza:	threat
llamado:	called
libro:	book
dificultad:	difficulty
fácil:	easy
revelación:	revelation
plumas:	feathers
dios:	God
puso:	heart
metidos:	stuck up
desorden:	disorder
crepúsculo:	dusk
hemos:	we have
inquieto:	restless
conduce:	lead
negras:	black
descender:	descend
haga:	do
solución:	solution
razón:	reason
tuve:	I had
hacerlo:	do it
hamaca:	hammock
cabecera:	head
hallé:	I found
esteras:	mats
confesar:	confess
instrumento:	instrument
quebrado:	broken
acabando:	running out
ellas:	they
saben:	per
recoger:	collect
cazador:	hunter
belleza:	beauty
treno:	train
música.:	music.
afán:	eagerness
mágico:	magical
prácticas:	practices
Veo:	I see
más.:	further.
reflejo:	reflection
arranca:	starts
abrir:	open
senos:	old
alcance:	range
amarla:	love her
renuncia:	resignation
voluntad:	willpower
acepta:	accept
quiera:	want
medido:	measured
edificación:	building
decisión:	decision
siquiera:	even
abiertas:	open
manantiales:	springs
entrañas:	bowels
tensión:	strain
posee:	owns
cubre:	covers
entra:	enter
hayan:	have
raíces:	roots
bulle:	bulls
Aquí:	Here
constante:	constant
cascada:	waterfall
Este:	It is
templo:	temple
atando:	tying
fuese:	was
olvidado:	forgotten
olivo:	olive tree
Noé:	Noah
especie:	species
Diluvio:	Flood
inesperada:	unexpected
figuraciones:	figurations
figuras:	figures
imposible:	impossible
altura:	height
trazados:	traces
signos:	signs
espera:	wait
perdido:	lost
cubierta:	deck
habitación:	room
siete:	seven
Esta:	This
único:	single
tras:	after
noticias:	news
mirando:	looking
licor:	liqueur
última:	last
pensando:	thinking
llega:	arrives
mirada:	look
prensa:	press
dicho:	saying
ciento:	hundred
parecía:	it seemed
fusil:	gun
paisaje:	landscape
crece:	grows
Todo:	All
envuelto:	wrapped
animales:	animals
cuerdas:	ropes
cuatro:	four
garganta:	throat
atrás.:	back.
compañero:	buddy
hacerme:	make me
Curador.:	Curator.
vacío:	empty
demás:	others
pesar:	weigh
hombros:	shoulders
grita:	scream
además:	besides
primeras:	first
apuntes:	notes
habrán:	there will be
impaciencia:	impatience
aturdimiento:	daze
tanta:	so much
sonoridad:	sonority
dibujado:	drawn
hará:	will do
buen:	good
escribir.:	write.
verdadera:	true
escrito:	written
alguno:	some
componer:	compose
sorpresa:	surprise
acto:	act
adolescencia:	adolescence
ello:	it
escena:	scene
alcanzar:	reach
cadáver:	corpse
empezó:	started
bastante:	quite
planos:	plans
terreno:	land
nuevos:	new
estuviera:	was
notas:	notes
distancias:	distances
árbol:	tree
público:	public
personaje:	character
acentos:	accents
hecha:	made
melodía:	melody
composición:	composition
quise:	I wanted
pensado:	thought
claro:	Of course
atrás:	back
elementos:	elements
torna:	returns
emoción:	emotion
propio:	own
existe:	exists
celo:	even
pensar.:	think.
impaciente:	impatient
cuales:	which
acercarse:	approach
entero:	whole
acento:	accent
Perteneciente:	Belonging
de...:	of...
encontrado:	found
arrojado:	thrown
blancas:	white
pregunto:	asked
quedado:	left
interés:	interest
medida:	measure
sabe:	he knows
peligro:	danger
cosa:	What
probablemente:	probably
cuestión:	question
existencia:	existence
venado:	deer
Gavilán:	Hawk
causa:	cause
Cuaderno:	Notebook
larga:	long
capuchino:	cappuccino
nuestros:	our
dioses:	gods
sé:	see
sigue:	go on
suprema:	supreme
posesión:	possession
mazorcas:	cobs
extremo:	extreme
marcado:	marked
proceso:	process
seres:	beings
vasto:	vast
hondamente:	deeply
eso:	that
generación:	generation
ayuda:	aid
capítulo:	chapter
cuenta:	account
única:	unique
antiguos:	ancient
gentes:	people
perfil:	profile
hechos:	facts
—el:	-he
remedios:	remedies
dar:	but
demora:	delay
aleja:	move away
llena:	full
estos:	these
rodar:	rotate
estudio:	study
preciso:	necessary
lejanías:	distances
empeñado:	pawned
dejar:	leave
verme:	don't give
enojo:	anger
cantar:	sing
otras:	others
tema:	him
podía:	could
juego:	game
—la:	-the
conocer:	know
maravilloso:	marvelous
daba:	after
recordar:	remember
lunes:	Monday
oficios:	crafts
allá.:	there.
sexo:	sex
Más:	Further
vuelvo:	I'm back
piernas:	legs
espesa:	thick
espacio:	space
Mesetas.:	Plateaus.
Grandes:	Big
muerto:	dead
tierras:	land
ocurre:	occurs
querido:	darling
noches:	nights
cuarenta:	forty
pudo:	could
mozo:	guy
ausencia:	absence
nivel:	level
paredón:	wall
muestra:	sample
botella:	bottle
rescate:	rescue
vivir:	live
brazos:	arms
divorcio:	divorce
olor:	smell
aguardiente:	schnapps
ciudades:	cities
cincuenta:	fifty
aquello:	that
andar:	to walk
hizo:	those
grandes:	big
yerbas:	herbs
todo.:	all.
partir:	leave
pueda:	can
muerte:	death
quiere:	wants
rostro:	face
encuentra:	finds
acabo:	just
cuerpos:	bodies
deben:	they must
dijo:	said
encontrar:	find
tratado:	treated
escribir:	write
varias:	several
empieza:	begin
debía:	should
absurdo:	absurd
volver:	return
pasos:	steps
posible:	possible
buscando:	searching
elemento:	element
quedaba:	remained
segunda:	second
atención:	attention
Porque:	Why
aquella:	that
escritura:	writing
dolor:	pain
veía:	saw
cierta:	true
significado:	meaning
acaba:	ends
poder:	can
Su:	They are
nosotros:	us
estaban:	were
Como:	As
luces:	lights
extraviado:	lost
ambos:	both
silencio:	silence
perro:	dog
morir:	to die
hablar:	talk
formas:	shapes
pocas:	few
asombro:	astonishment
prosa:	prose
tiempo.:	time.
aparición:	appearance
intento:	tried
así:	So
manera:	manner
empezar:	begin
confusión:	confusion
alguien:	someone
espaldas:	backs
centro:	center
Así:	So
conocido:	acquaintance
nombre:	name
hora:	time
cabeza:	head
montañas:	mountains
habré:	there will be
meses:	months
caído:	fallen
acaso:	chance
dinero:	money
golpe:	blow
techo:	ceiling
tipo:	type
conmigo:	with me
musicales:	musicals
destinado:	intended
Pienso:	I think
hallada:	found
creo:	believe
remoto:	remote
propósito:	purpose
seguir:	follow
mediodía:	average
país:	country
partes:	parts
pudiera:	could
ramas:	remaining
preguntándome:	wondering
tono:	application
tantas:	so many
maíz:	corn
mazorca:	cob
creciente:	growing
habían:	had
hijo:	son
serpientes:	snakes
enana:	dwarf
canoa:	canoe
hallado:	found
piloto:	pilot
menos:	less
uno:	a
semanas:	weeks
mujeres:	women
Desde:	From
mía:	tight
Estoy:	I'm
iba:	others
abierto:	open
leyes:	laws
estado:	state
dando:	giving
propia:	own
mente:	mind
busca:	search
forma:	shape
vuelve:	comes back
poema:	poem
sensación:	sensation
quería:	wanted to
Esto:	This
difícil:	difficult
lluvias:	rains
pasa:	happens
calor:	heat
tiempos:	time
ríos:	rivers
movimiento:	motion
salen:	the hall
ahí:	there
mismas:	themselves
objetos:	objects
signo:	sign
ruinas:	ruins
vuelto:	turned
Curador:	Curator
olvidar:	forget
mí.:	my.
tronco:	stem
cambio:	change
libros:	books
griego:	Greek
Odisea:	Odyssey
corriente:	current
habrá:	there will be
obras:	works
caer:	fall
humedad:	humidity
secreto:	secret
pasado:	past
vientre:	belly
muchas:	many
dado:	given
unas:	nails
haciendo:	doing
ellos:	they
orquesta:	orchestra
primeros:	first
salir:	go out
ruido:	noise
debajo:	below
Un:	And
trabajar:	work
después:	after
muchos:	many
orden:	order
objeto:	object
cierto:	TRUE
tomar:	take
instante:	instant
pasar:	market
últimos:	last
arriba:	above
mejor:	better
caminos:	roads
puedo:	I can
prueba:	proof
falta:	lack
uso:	use
través:	through
mirar:	look
punto:	point
tenido:	had
Además:	Besides
aunque:	although
sentir:	to feel
apenas:	just
parecen:	they seem
sombras:	shadows
noticia:	news
cual:	which
tarea:	task
periódico:	newspaper
sabiendo:	knowing
cerca:	fence
entrada:	Prohibited
lejos:	far
oficio:	job
tener:	have
regreso:	return
tengo:	I have
correr:	run
necesario:	necessary
segundo:	second
troncos:	trunks
podría:	could
sí:	Yeah
semblante:	countenance
expresión:	expression
jamás:	never
año:	year
llegado:	arrived
nubes:	clouds
suena:	sounds
debo:	I must
según:	according to
medios:	media
ciertas:	certain
varios:	several
Para:	To
digo:	I say
qué:	that
siento:	I feel
abajo:	below
choza:	hut
nunca:	never
historia:	history
viene:	he comes
señal:	sign
teatro:	theater
todavía:	still
quiero:	wanna
Ya:	Of
demasiado:	too much
caso:	case
hacía:	toward
recuerdo:	memory
súbito:	sudden
cualquier:	any
arte:	until
responde:	respond
eran:	were
dejado:	left
nuevamente:	again
Luego:	Then
hacen:	do
decir:	say
llegar:	arrive
cómo:	as
torno:	lathe
fuerza:	force
debe:	has to
gente:	people
será:	it will be
realidad:	reality
porque:	why
allí:	over there
hubieran:	they would have
Treno:	Train
tenía:	had
verdad:	TRUE
detrás:	behind
cuyos:	whose
texto:	text
suelo:	floor
Anunciación:	Annunciation
junto:	together
hojas:	leaves
ciertos:	some
—como:	-as
conciencia:	awareness
toda:	all
tantos:	so many
haya:	these
Venados:	Deer
fondo:	bottom
deseo:	desire
cuyas:	whose
fraile:	friar
les:	THE
Simón:	Simon
avión:	plane
presente:	gift
frente:	forehead
idioma:	language
necesidad:	need
medio:	half
horas:	hours
tienen:	have
él:	he
están:	are
esas:	those
lado:	side
algunos:	some
sería:	I would be
tarde:	afternoon
nuestra:	our
esposa:	wife
Le:	The
misma:	same
estar:	be
años:	years
pensar:	think
parte:	part
habla:	speaks
mientras:	while
puesto:	position
fueron:	were
viaje:	journey
encuentro:	meeting
sentido:	sense
pájaros:	birds
lluvia:	rain
veces:	times
bien:	GOOD
también:	also
árboles:	trees
presencia:	presence
algún:	some
estoy:	I'm
palabra:	word
visto:	view
primera:	first
mucho:	a lot
Mónica:	Monica
hallar:	cases
casi:	almost
Una:	A
otros:	others
palabras:	words
puede:	can
momento:	moment
aún:	still
gesto:	gesture
instrumentos:	instruments
ritmo:	rhythm
acerca:	about
quienes:	who
aquel:	that
buscar:	look for
cuyo:	whose
mañana:	tomorrow
hacer:	do
esos:	those
entonces:	so
Mouche:	Fly
mano:	thousand
otro:	other
cuanto:	how much
obra:	work
cosas:	things
han:	he
cuya:	whose
Por:	By
veo:	I see
unos:	some
tanto:	both
mundo:	world
estas:	is
parece:	it seems
hubiera:	had
regresar:	go back
fuera:	out
Ahora:	Now
dentro:	within
cuerpo:	body
poco:	bit
siempre:	always
indios:	indians
tal:	of
miedo:	fear
todas:	all
antes:	before
otra:	other
alguna:	some
vida:	life
estaba:	was
tres:	three
nada:	nothing
Cuando:	When
sólo:	only
esto:	this
pues:	well
lugar:	place
sido:	been
papel:	paper
fue:	was
suerte:	luck
noche:	evening
modo:	way
hecho:	made
durante:	during
cada:	each
todos:	all
De:	Of
hombres:	men
ni:	in
esta:	this
voz:	voice
tiene:	has
desde:	from
hasta:	until
este:	it is
mujer:	women
día:	day
ese:	that
allá:	there
días:	days
música:	music
ojos:	eyes
mismo:	same
hacia:	toward
pero:	but
muy:	very
hombre:	man
Adelantado:	Advanced
está:	this
quien:	who
entre:	between
algo:	something
tiempo:	time
bajo:	low
luego:	then
En:	In
La:	The
dos:	of the
hace:	does
le:	the
ya:	of
El:	He
mí:	my
si:	and
ser:	to be
aquí:	here
ahora:	now
donde:	where
Pero:	But
cuando:	when
había:	there was
todo:	all
vez:	time
sus:	their
sobre:	on
más:	further
como:	as
para:	to
su:	are
por:	by
se:	with
un:	and
una:	a
del:	of the
el:	he
en:	in
la:	the
que:	what
de:	of
