119
:	119
habrán:	there will be
estados:	states
primeros:	first
esta:	this
duerma:	sleep
descifrar.:	decipher.
podría:	could
taquigrafía:	shorthand
casos:	cases
muchos:	many
reduciendo:	reducing
energía:	energy
brote:	outbreak
impulsado:	driven
impaciencia:	impatience
jubilosa:	jubilant
escribo:	I write
tregua:	truce
ceñir.:	gird.
criticar:	criticize
tachar:	cross out
habrá:	there will be
dolor.:	pain.
algún:	some
desconfiar:	distrust
debo:	I must
Sé:	See
plomo:	lead
través:	through
salir:	go out
atrepellándose:	running over
mano:	thousand
llenaran:	will fill
cerebro:	brain
bajadas:	descents
asombra:	amazes
facilidad:	ease
invento:	invention
polémicas:	controversies
aburrimiento:	boredom
inacabable:	unending
manifiestos:	manifestos
conciertos:	concerts
lejos:	far
levantarse.:	get up.
pugnara:	fight
acallando:	silencing
asepsia:	asepsis
geometría:	geometry
pureza:	Preza
orden»:	order"
«regreso:	"return
consignas:	slogans
impresionar:	impress
dejado:	left
otros:	others
tantos:	so many
inventarse.:	invent
sonante:	resounding
contrapunto:	counterpoint
disimulada:	disguised
pobreza:	poverty
ricercare:	search
lados:	sides
ambos:	both
trepidaban:	trembled
respiración:	breathing
contrarios:	opposites
lugar:	place
fuera:	out
martillados:	hammered
acentos:	accents
desencuadrados:	out of frame
redondas—:	round—
blancas:	white
existido:	existed
hubiesen:	they would have
corcheas:	eighth notes
movimientos:	movements
Concerti:	Concerts
autores:	authors
durante:	during
aquejado:	afflicted
locomotriz:	locomotive
Una:	A
correr:	run
prisa:	hurry
aturdimiento:	daze
juegos:	games
inspiración:	inspiration
lentos:	boards
tiempos:	time
enjundia:	substance
olvidarlos:	forget them
propósito:	purpose
olvidaban:	they forgot
actualizado:	updated
«desarrollar»—:	"develop"-
rectas:	straight
—
la:	—
the
legado:	legacy
frío:	cold
fabricación:	manufacturing
calco:	cast
perdurabilidad:	perdurability
asegurar:	ensure
ingratos:	ungrateful
rispidos:	harsh
registros:	records
adrede:	ready
situados:	situated
instrumentos:	instruments
asperezas:	roughness
colocados:	placed
disonancias:	dissonances
eran:	were
espíritu.:	spirit.
recuperar:	recover
contrapuntísticas:	contrapuntal
recetas:	recipes
tomando:	taking
oficio:	job
cantada:	sung
miércoles:	Wednesday
empezaba:	started
—la:	-the
artesanal:	artisanal
espontaneidad:	spontaneity
salud:	health
encontrar:	find
tratado:	treated
gente:	people
tanta:	so much
Encadenado»:	Chained»
«Prometeo:	"Prometheus
«Preludio»:	"Prelude"
desventurado:	hapless
aquel:	that
mañosa:	crafty
asemejaba:	resembled
nada:	nothing
ahora.:	now.
hasta:	until
distinta:	different
invocación:	invocation
ensalmo:	I praise
algo:	something
gráfica:	graphic
homofónico:	homophonic
comienzo:	beginning
inscriben:	enroll
cuales:	which
paralelas:	parallel
convergentes:	convergent
líneas:	lines
trazados:	traces
irregularmente:	irregularly
toscos:	rough
maravillado:	amazed
esbozos:	sketches
página:	page
termino:	TERMS
olvidados:	forgotten
signos:	signs
renacer:	be reborn
viendo:	seeing
apuntado:	pointed
imperiosa:	imperious
escribir:	write
detengo.:	I stop.
presencia:	presence
anunciará:	will announce
órgano:	organ
sonoridad:	sonority
orquesta:	orchestra
abierto:	open
acorde:	chord
Un:	And
discantus:	students
entrando:	entering
dibujado:	drawn
cada:	each
hace:	does
edificio:	building
pondrá:	will put
aparición:	appearance
vosotros.»:	you."
remaba:	of father
despojos:	remains
desgracia.:	misfortune.
sepan:	know
todos:	all
orilla:	bank
levanta:	get up
todas:	all
quémame:	burn me
funerales;:	funeral;
lágrimas:	tears
abandones:	abandon
imploración::	entreaty:
preludio:	prelude
vocalización:	vocalization
interpretaré:	I will interpret
gemido:	moan
118
:	118
caminos».:	paths.
borde:	should
«su:	"are
tener:	have
llora:	cry
queja:	complaint
traído:	brought
será:	it will be
colocar:	to place
habré:	there will be
melismático:	melismatic
lanzas.:	spears.
bronce:	bronze
caídos:	fallen
guerreros:	warriors
enlutadas:	mourners
vírgenes:	virgins
estrofa:	stanza
imperceptiblemente:	imperceptibly
enternezca:	international
corifeo:	coryphean
hará:	will do
palabra:	word
discurso:	speech
estructura:	structure
concibo:	I conceive
requerida:	required
consistencia:	consistency
medida:	measure
muerte.:	death.
duermen:	they sleep
sobras:	leftovers
aparecer:	to appear
derramado:	spilled
bestias:	beasts
degollado:	beheaded
rebaños...:	flocks...
carnero:	SHEEP
daré:	I will give
vacas:	cows
sacrificaré:	I will sacrifice
Itaca:	Ithaca
regrese:	come back
prometo:	I promise
harina:	flour
Derramo:	I spill
libación:	libation
miel.:	Honey.
libaciones.:	libations.
«Hago:	"Do
solemne::	solemn:
preciso:	necessary
tono:	application
evocación:	evocation
deseada.:	desired.
simplicidad:	simplicity
homérico:	Homeric
hojarasca:	leaf litter
aligerar:	lighten
bastaba:	it was enough
sencilla::	simple:
problema:	problem
solución:	solution
buen:	good
vuelve:	comes back
poco:	bit
bambú.:	bamboo.
retoño:	shoot
garrapatas:	ticks
han:	he
Gavilán:	Hawk
orejas:	ears
limpiar:	clean
espaldas:	backs
rincón:	corner
sienta:	feel
molestar:	annoy
Por:	By
ceño.:	frown.
arruga:	wrinkle
cuenta:	account
dar:	but
obligado:	obliged
modo:	way
malos»:	bad»
«días:	"days
varón:	male
admitiendo:	admitting
preguntar:	ask
nervioso;:	highly strung;
verme:	don't give
alarma:	alarm
mujer:	women
respondo:	answer
Apenas:	Just
escándalo:	scandal
vueltas:	turns
irritado:	irritated
Salgo:	I'm on my way out
peripecias.:	adventures
lleno:	full
movido:	moved
cuentas:	accounts
Polifemo:	Polyphemus
veces:	times
varias:	several
escribir.:	write.
ponerme:	put on
impaciente:	impatient
pasajes:	tickets
releo:	reread
necesito.:	need.
género:	gender
opuesto:	opposite
resultaría:	would result
Nada:	Nothing
astucias».:	cunning."
dioses:	gods
vástago:	stem
Laerte:	Laertes
majestad»:	majesty"
suprema:	supreme
mío:	mine
Cronos:	Chronos
tipo:	type
invocatorias:	invocatory
usar:	to use
niego:	him
descorazonarme:	dishearten me
empieza:	begin
Su:	They are
vacilación:	hesitation
Vuelvo:	I'm back
propiciatorio.:	propitiatory.
signo:	sign
coincidencia:	coincidence
leído:	read
morado:	purple
terciopelo:	velvet
empastadas:	pasted
Vidas:	Lives
último:	last
este:	it is
—Estos:	-These
Gramática:	Grammar
Epítome:	Epitome
francés;:	French;
Mouche:	Fly
secundarios;:	secondary;
estudios:	studies
inglés:	English
hablaba:	spoke
alemán:	German
Sabía:	Knew
verdadero:	TRUE
¿cuál:	which
Además:	Besides
profunda.:	deep
crear:	create
debía:	should
tal:	of
desierta:	deserted
poeta:	poet
resabios.:	aftertaste
sorprenderme:	surprise me
mientras:	while
nunca:	never
verdadera:	true
sería:	I would be
renuncia:	resignation
ejecutado».:	executed".
«verme:	«don't give
confesión:	confession
inconsciente:	unconscious
enoja:	angry
artístico.:	artistic.
centro:	center
cualquier:	any
ejecución:	execution
obstáculo:	obstacle
eterno:	eternal
constituiría:	would constitute
componer:	compose
pensado:	thought
Nunca:	Never
queda:	is left over
toda:	all
bíblico:	biblical
dando:	giving
alejaría:	would distance
ésta:	this
cristiana:	Christian
prosa:	prose
bastante:	quite
pareciéndose:	resembling
excelentes:	excellent
óperas:	operas
peor:	worse
mucho:	a lot
despoja:	strips
cuento:	tale
asunto:	affair
sorpresa:	surprise
descubro:	I discover
Hojeando:	Browsing
ministerio:	ministry
propios:	own
textos:	texts
Usualis:	Usual
Líber:	Bast
libros::	books:
117
:	117
jamás:	never
tendré:	I will have
tengo:	I have
puesto:	position
imaginación:	imagination
caldearse:	get hot
absurdo:	absurd
lije:	pours
furia.:	rage
ménade:	maenad
acento:	accent
aullan:	howl
irrumpen:	break in
infierno»:	hell"
«perras:	«bitches
reinan:	reign
Dioses:	Gods
Madres:	Mothers
arcilla:	clay
siento.:	I feel.
rodean:	surround
elementos:	elements
tormentas::	storms:
manantiales:	springs
montañas:	mountains
coros:	choirs
luego:	then
directas::	direct:
simples:	simple
palabras:	words
hecho:	made
admirablemente:	admirably
correspondido:	reciprocated
hubieran:	they would have
recuerdo:	memory
versos:	verses
Ciertos:	Some
vida.:	life.
destinado:	intended
concepción:	conception
conforme:	according to
sombras:	shadows
regreso:	return
resurrección:	Resurrection
sentido:	sense
implícito:	implicit
fuga:	leak
mentalmente:	mentally
asocio:	association
encadenado:	chained
liberación:	release
tema:	him
maravilloso:	marvelous
Segundo:	Second
tercio:	third
ofrece:	offers
acto:	act
Desencadenado:	Unchained
Prometeo:	Prometheus
querido:	darling
adolescencia:	adolescence
proyecto:	project
fidelidad:	fidelity
intento:	tried
regla:	ruler
sirviéndome:	serving me
trazo:	I bring
esbozar:	outline
alguna:	some
cierto:	TRUE
entrega:	delivery
—que:	-what
portada:	front page
libretas;:	notebooks;
pedirle:	ask
Adelantado:	Advanced
corriendo:	in a hurry
transcurrida...:	elapsed...
transcurrida:	elapsed
conciencia:	awareness
Cobraba:	He charged
faltaba.:	was missing.
ello:	it
futuro:	future
intuía:	I intuited
oscuramente:	darkly
resto::	rest:
añadiendo:	adding
escena:	scene
contemplaba:	contemplated
músico:	musician
embrión:	embryo
gruñir:	snarl
maneras:	ways
voces:	you
alternación:	alternation
mágica:	magic
función:	function
reclamada:	defendant
caso:	case
—forma:	—shape
alcanzar:	reach
nota:	use
entonación:	intonation
necesitar:	need
transformaba:	transformed
exorcismo:	exorcism
palabra-célula:	word-cell
enunciado:	statement
renació:	reborn
auténtico:	authentic
visión:	vision
perros.:	dogs.
dejados:	left
huesos:	bones
roían:	gnawed
babeantes:	drooling
ancianos:	seniors
superiores:	superiors
creían:	they believed
superioridad:	superiority
ufanarme:	weapon
hicieran:	they did
mismos:	themselves
aquellos:	those
hombres;:	men;
considerar:	consider
quise:	I wanted
quienes:	who
hombres:	men
lección:	lesson
orines.:	urine.
excrementos:	excrement
postrados:	prostrate
cautivos:	captives
estaban:	were
pasos:	steps
crótalo:	crotalus
ponzoña:	poison
ennegrecido:	blackened
cadáver:	corpse
hechicero:	sorcerer
cómo:	as
escuché:	listen
monstruos:	monsters
poblado:	populated
orillas:	shores
abajo:	below
Paleolítico:	Paleolithic
crecer:	grow
empezó:	started
semilla:	seed
resembrada:	reseeded
dentro:	within
asombro::	astonishment:
vuelvo:	I'm back
Aún:	Still
reflexión.:	reflection.
deleitosa:	delightful
sorprende:	surprise
abre:	open
momento...:	moment...
inteligentes:	smart
músicos:	musicians
pocos:	few
hacía:	toward
desde:	from
aprovechados:	taken advantage of
empezaban:	they started
inexplotados:	unexploited
recursos:	resources
cuyos:	whose
eclesiásticos:	ecclesiastics
modos:	modes
habilidoso:	skillful
uso:	use
unidad:	unit
pensaba:	thought
armonía:	harmony
encontrado:	found
trombón:	trombone
contrabajo:	double bass
flautín:	piccolo
diálogos:	dialogues
sorprendentes:	surprising
unos:	some
referencia:	reference
medio:	half
puntos:	points
escritura:	writing
misma:	same
notas:	notes
Cuando:	When
lápiz.:	pencil.
tiempo:	time
tumba:	grave
primera:	first
habla:	speaks
El:	He
mejor:	better
Libación:	Libation
llenado:	fill
demasiado:	too much
encuentro:	meeting
episodio:	episode
detengo:	I stop
«Hijo:	"Son
fórmulas:	formulas
retórica:	rhetoric
veo:	I see
tanto:	both
también:	also
menudo:	slight
pudiera:	could
obra:	work
escrito:	written
alguno:	some
poema:	poem
está:	this
estilo:	style
Brabante:	Brabant
tres:	three
aquí:	here
ni:	in
esto:	this
matriz:	headquarters
esos:	those
deseo:	desire
ahora:	now
muerto:	dead
volver:	return
hacer:	do
mágico:	magical
entre:	between
—como:	-as
cuyo:	whose
hubiera:	had
De:	Of
casi:	almost
pentagramas:	staves
musicales:	musicals
empiezo:	start
Perteneciente:	Belonging
de...:	of...
Cuaderno:	Notebook
cuya:	whose
esas:	those
Ahora:	Now
aún:	still
ya:	of
ese:	that
forma:	shape
treno:	train
donde:	where
allá:	there
fue:	was
estaba:	was
día:	day
algunos:	some
años:	years
ser:	to be
elemento:	element
hallar:	cases
cuanto:	how much
obras:	works
todo:	all
arte:	until
suerte:	luck
necesidad:	need
pues:	well
Odisea:	Odyssey
sólo:	only
voz:	voice
tiene:	has
trabajar:	work
mismo:	same
lluvia:	rain
sí:	Yeah
cuando:	when
noche:	evening
mí:	my
idioma:	language
si:	and
le:	the
vez:	time
sus:	their
pero:	but
Treno:	Train
muy:	very
bajo:	low
dos:	of the
Pero:	But
texto:	text
En:	In
La:	The
había:	there was
música:	music
para:	to
como:	as
su:	are
más:	further
una:	a
sobre:	on
se:	with
por:	by
un:	and
del:	of the
el:	he
en:	in
que:	what
la:	the
de:	of
