99
:	99
Música.:	Music.
Nacimiento:	Birth
asistir:	watch
revelación:	revelation
deslumhrado:	dazzled
dejándome:	leaving me
treno—:	train-
cosa:	What
—pues:	-well
Treno:	Train
convulsivamente:	convulsively
estertora:	death rattle
ensalmador:	salamander
órfico:	Orphic
descorazona.:	disheartens
ablanda:	softens
Palabra:	Word
presa:	taken
soltar:	release
niega:	denies
Muerte:	Death
terquedad:	obstinacy
mí...:	my...
ejerce:	exercises
ceremonia:	ceremony
fascinación:	fascination
horrenda:	horrible
sustraerme:	steal away
puedo:	I can
distancias.:	distances.
guardar:	keep
mantenerme:	keep me
Trato:	Deal
hombre—.:	man-.
cálculos:	calculations
atraviesan:	go through
aniquilamiento:	annihilation
potencias:	powers
—intento:	-tried
tragedia:	tragedy
profunda:	deep
imprecatorio:	imprecatory
desgarrado:	torn
suelo:	floor
talones:	heels
golpea:	hits
vocifera:	vociferous
encara:	still
Ahora:	Now
mudos.:	mute.
rodeado:	surrounded
cadáver:	corpse
grita:	scream
pavorosa:	terrifying
prolongarse:	extend
pero:	but
vocalización:	vocalization
ignora:	ignore
Algo:	Something
lenguaje:	language
allá:	there
contratiempo:	setback
jadeo:	panting
adentro:	inside
ronquido:	snore
labios:	lips
lengua:	language
vibrar:	vibrate
luego:	then
melodía.:	melody.
embrión:	embryo
notas:	notes
cuatro:	four
cortados:	cut
trinos:	trills
ritmo;:	rhythm;
crear:	create
llegando:	arriving
repiten:	they repeat
sílabas:	syllables
aullidos;:	howls;
prolongados:	prolonged
guturales:	guttural
portamentos:	behaviors
apremiar.:	press.
gaznate:	fizzy
sarcasmo:	sarcasm
gime;:	moans;
increpa:	rebukes
responden.:	respondents.
alternan.:	they alternate.
destemplada.:	untemplated.
colérica:	choleric
mediano:	medium
hervor:	out
subterráneo:	underground
confusa:	confused
vientre.:	belly.
ensalmador;:	salting agent;
garganta:	throat
cadáver.:	corpse.
posee:	owns
espíritu:	spirit
atribuye:	attributes
voz:	voice
imita:	imitate
Palabra.:	Word.
nocturnos:	nocturnal
espantos:	frights
colmo.:	full.
esperan:	wait
expectación:	expectation
lleva:	carry
ensalmo:	I praise
preparador:	preparer
silencio:	silence
Muerte.:	Death.
mandatarios:	representatives
ahuyentar:	drive away
gente—:	people-
conoce:	know
instrumento:	instrument
—único:	-single
gravilla:	gravel
calabaza:	pumpkin
sacudir:	shake
comienza:	starts
horas.:	hours.
mordido:	bitten
cazador:	hunter
hinchado:	swollen
cuerpo:	body
acaban:	end
techo:	ceiling
sirven:	serve
ramas:	remaining
colgadas:	hanging
hojas:	leaves
amasijo:	I knead
Detrás:	Behind
correr.:	run.
echan:	they cast
todos:	all
Dioses...:	Gods...
respetar:	respect
morada:	household
Estoy:	I'm
vasija:	vessel
reverencia:	reverence
gesto:	gesture
torpe:	clumsy
esbozo:	outline
miran:	another
empreñadas:	engaged
hembras:	females
trepadores:	climbers
arrugado:	wrinkled
ancianas:	old women
Viendo:	Seeing
enunciado:	statement
sólo:	only
pronunciara:	will pronounce
tiempo»:	time"
espacio:	space
«solitaria:	«lonely
Mayores.:	Seniors.
uso:	use
preparándose:	getting ready
divinidad:	divinity
hábito:	habit
cobrando:	charging
fueran:	were
dados:	data
Niños:	Children
Tenía:	Had
Objeto.:	Object.
naciera:	was born
modelaron:	model kit
figura:	figure
abultado:	bulky
prólogo:	prologue
genésico:	genetic
hembra:	female
principio:	principle
religiones.:	religions.
Dios::	God:
Más:	Further
Esto:	This
blanda.:	mix.
estuviese:	was
apoyado:	supported
dedo:	finger
presión:	pressure
convexa:	convex
98
:	98
dibujado:	drawn
ombligo:	belly button
abiertos:	open
hoyos:	holes
asas:	basic
jarra:	jug
endurecida:	hardened
forma:	shape
yacen:	lie
bien—:	GOOD-
—cunas:	—cribs
apenas:	just
medio:	half
rodean...:	surround...
lamedores:	lickers
tragadores:	swallowers
tengo:	I have
Tampoco:	Neither
Nada.:	Nothing.
entes:	loved ones
estos:	these
común:	common
Nada:	Nothing
bestia.:	beast.
aullidos:	howls
noches:	nights
buitres:	vultures
carroñas:	carrion
disputen:	they dispute
dejados:	left
roer:	stir
sepan:	know
autorizada:	authorized
predilecta:	favorite
erigidos:	erected
existir:	exist
puedan:	can
último.:	last.
mío:	mine
eréctil:	erectile
cuelga:	hanging
humanas:	human
retroceso:	recoil
escalafones:	ladders
vértigo:	vertigo
Siento:	I feel
legítima:	legitimate
dueña:	owner
única:	unique
sarcástico—:	sarcastic-
«Cautivos:	«Captives
espanto.:	amazement.
repulsión:	repulsion
movido:	moved
ellos:	they
espaldas:	backs
vuelvo:	I'm back
seres:	beings
producen:	produce
Tal:	Of
colmillos.:	fangs.
metiéndose:	getting into
mirada:	look
servil:	servile
temeroso:	fearful
estúpidamente:	stupidly
sonríen:	they smile
anatómicas:	anatomical
planchas:	irons
figuras:	figures
azules:	blue
venas:	is coming
cubiertos:	covered
arrugados:	wrinkled
enanos:	dwarves
nacido;:	born;
recién:	newly
vagido:	loved ones
semejante:	such
gimotea:	gimme
bocas:	mouths
blancas:	white
barbas:	barbs
vivientes:	living
fetos:	fetuses
conocido::	acquaintance:
hayan:	have
horribles:	horrible
erguirse:	straighten
roídos:	gnawed
hedionda:	hideous
fangoso:	muddy
hueco:	gap
asomarme:	look out
brazo:	arm
agarra:	grab
gesticulación.:	gesticulation.
coincidencia:	coincidence
podríamos:	we could
siquiera:	even
antemano:	beforehand
admitiendo:	admitting
inutilidad:	futility
comprendiendo:	understanding
sentido:	sense
semblantes:	countenances
Contemplo:	I contemplate
perros.:	dogs.
anteriores:	previous
zorros:	foxes
Sus:	Their
recursos:	resources
conocen:	they know
Apenas:	Just
misma.:	same.
comerse:	eat
amasar:	knead
uñas:	nails
lombrices:	worms
tragan:	swallow
escarban:	dig
liendres:	nits
hormigas:	ants
avispa:	wasp
devoran:	devour
termes:	terms
pelado:	naked
entremos:	let's enter
región:	region
meses:	months
aislan:	isolate
creciente:	growing
techumbres:	roofing
colgándose:	hanging around
arriba:	above
allí:	over there
simios:	apes
disputar:	dispute
palmeras:	palm trees
corazones:	hearts
comiendo:	eating
rumbo:	course
delante:	in front of
andan:	from the moment
sembrar;:	sow;
acto:	act
asentado:	settled
semilla;:	seed;
energía:	energy
valerse:	valese
pensado:	thought
pecado:	sin
Adán:	Adam
saberlo:	know it
desnudas:	naked
están:	are
generación:	generation
órganos:	organs
ocultar:	disguise
pudor:	modesty
cobrado:	charged
gentes:	people
felinos;:	felines;
gestos:	gestures
ovillan:	at the door
estiran:	they stretch
niños:	children
hinchados;:	swollen;
cuelgan:	they hang
flaccidas:	flabby
senos:	old
cuyos:	whose
mí;:	my;
semejantes:	similar
brazos:	arms
piernas:	legs
individuos:	individuals
Esos:	Those
edades.:	ages.
tenebroso:	dark
retroceder:	back
hacía:	toward
ámbito:	scope
entrar:	to enter
edades—:	ages—
comienzo:	beginning
situaba:	situated
más»:	further"
líticos:	lithics
enseres:	equipment
colecciones:	collections
detenido:	arrested
hubieran:	they would have
paralelas:	parallel
industrias:	industries
—de:	-of
paleolítico:	paleolithic
salido:	left
Hemos:	We have
convivimos:	we coexist
cuales:	which
cultura:	culture
caído:	fallen
atardecer:	sunset
Porque:	Why
Génesis.:	Genesis.
compases:	compasses
retrocediendo:	going back
izquierda:	left
derecha:	right
revés:	reverse
leyendo:	reading
estamos:	we are
cabe:	fits
atónito:	amazed
crepúsculo:	dusk
elaboración:	elaboration
mañanas:	mornings
algunas:	some
97
:	97
dilatación:	dilatation
lapsos:	lapses
valores:	values
percibo:	I perceive
hora—:	time—
preocupa:	worries
—ahora:	-now
sorprendente:	surprising
movimiento:	motion
llevadas:	carried
jornadas:	days
andantes:	walking
tuviese:	had
telúrica:	telluric
—tiempos:	-time
sucedieran:	would happen
breves:	brief
largos:	long
Habla:	Speaks
tránsitos:	transits
considerablemente:	considerably
ensanchar:	widen
debe:	has to
ánimo:	cheer up
disposición:	provision
evidente:	obvious
asombroso.:	amazing.
mañana:	tomorrow
arrastrar:	drag
nada:	nothing
poseer:	possess
presente:	gift
vivir:	live
Este:	It is
importancia—.:	importance-.
tener:	have
pueda:	can
nuestro:	our
ocurrido:	occurred
suponer:	suppose
dejarme:	leave me
delicado:	delicate
tal:	of
dignidad:	dignity
defiende:	defend
etapas:	stages
marcaron:	they marked
éstos:	these
vivió:	lived
oculta:	hidden
pasado.:	past.
quiere:	wants
desmemoriada:	forgetful
comprender:	grasp
sé:	see
Muy:	Very
más.:	further.
preguntar:	ask
varón:	male
sigue:	go on
hato:	there
Agarra:	Grab
adonde:	where to
conmigo:	with me
lleve:	carry
pide:	ask
Todo:	All
Labán.:	Laban.
Raquel:	Rachel
invocadas:	invoked
mujeres»:	women"
«costumbres:	"traditions
recuerdan:	remember
pudorosas:	shame
inequívocas:	unequivocal
expresiones:	expressions
emplea:	employs
amante:	lover
ignorar:	ignore
naturaleza:	nature
intimidades:	intimacies
alude:	alludes
texto:	text
simplificación:	simplification
definidora:	defining
Además:	Besides
proféticos.:	prophetic.
gritos:	shouting
fragor:	roar
restando:	staying
entrañas:	bowels
sustituyen:	replace
Biblia:	The Bible
traductores:	translators
Tiene:	Has
contrato:	contract
afirmación:	affirmation
esposa.:	wife.
diera:	give
situaciones:	situations
definición:	definition
concepto:	concept
solidez:	solidity
posesivo:	posesive
reiteración:	reiteration
constante:	constant
buscaba»...:	I was looking for...
te:	the
durmiendo;:	sleeping;
estaba:	was
tercera:	third
refiriéndose:	referring
misma:	same
malo:	place
decir:	say
suele:	usually
Por:	By
humano.:	human.
ser:	to be
interpretación:	interpretation
capacidad:	ability
rebasan:	exceed
caso:	case
oscuro:	dark
mecanismo:	mechanism
grandes»:	big»
«cosas:	"things
regido:	governed
demasiado:	too much
analizando:	analyzing
andar:	to walk
destino:	destination
cumple:	meets
cuerpo»:	body"
«el:	"he
aquello:	that
recompensa:	reward
medida:	measure
molde:	mould
servir:	serve
salud:	health
ande:	Spirit
mientras:	while
arriba.:	above.
alumbra:	lights up
mediodía:	average
mundo:	world
centro:	center
Océano:	Ocean
atravesar:	cross
pensó:	thought
idioma:	language
'el:	'he
dejar:	leave
fronteras:	borders
cruzado:	crossed
existencia.:	existence.
plenitud:	fullness
propicio:	propitious
particularmente:	particularly
prestigioso:	prestigious
lugar:	place
estar:	be
noción:	notion
existe:	exists
remotas.:	remote.
cercanas:	nearby
comarcas:	regions
inquietarse:	worry
vamos:	let's go
adónde:	where to
importa:	matter
consentimiento.:	consent.
animoso:	game
responde:	respond
regresar:	go back
preocupación:	worry
pueril:	childish
desaliento:	discouragement
fatiga:	fatigue
encontrar:	find
temo:	theme
días.:	days.
algunos:	some
viaje:	journey
proseguiremos:	we will continue
estambres:	stamens
digo:	I say
crujido:	crunch
acompasado:	rhythmic
arranca:	starts
balanceo:	swinging
leve:	live
colgadizo:	hanging
dormirme:	fall asleep
Antes:	Before
generación.:	generation.
alguno:	some
ello—:	it-
seguro:	insurance
—estoy:	-I'm
imaginada:	imagined
vislumbre:	glimpse
maravillado:	amazed
quedé:	I stayed
palabras:	words
pocas:	few
revelada:	revealed
vean:	see
amantes:	lovers
voluntad:	willpower
deben:	they must
viajes:	trips
solitarios:	lonely
gineceo:	gynoecium
selvático:	wild
tiene:	has
esclavos;:	slaves;
atribuyen:	attribute
cimarrones:	maroons
antiguos:	ancient
creen:	believe
hallazgos:	findings
Hablan:	They talk
oírnos.:	eloquent
pudiese:	could
cuidando:	caring
junto:	together
confió:	trusted
Adelantado.:	Advanced.
Conozco:	Know
96
:	96
junio):	June)
(Jueves:	(Thursday
diligencia:	diligence
nuevamente:	again
encenderlo:	turn it on
incapaces:	incapable
seríamos:	we would be
apagara:	will turn off
abanican:	fan
Si:	And
Historia.:	History.
estadía—:	stay-
poca:	little
—metecos:	—metics
ignorantes:	ignorant
forasteros:	outsiders
intrusos:	intruders
Somos:	We are
hueso.:	bone.
dardo:	dart
espina:	thorn
anzuelo:	hook
rascador:	scraper
cuchillo:	knife
usan:	they use
técnicas:	techniques
inventan:	invent
tósigos:	codes
alimentos:	food
nosotros:	us
muerte:	death
derecho:	right
leyes:	laws
dictan:	dictate
Quienes:	Who
Paleolítica.:	Paleolithic.
Estamos:	We are
ánfora:	amphora
bramar:	bellow
haciendo:	doing
lloró:	cry
hueca:	hollow
caña:	cane
soplar:	blow
órgano:	organ
ornamentado:	ornate
cilindro:	cylinder
bastón:	cane
pasó:	passed
música:	music
necesitado:	needy
ríos:	rivers
orillas:	shores
aldeas:	villages
primeras:	first
fijar:	set
agricultura:	agriculture
errar:	err
cansado:	tired
alcanzamos:	we reach
hasta:	until
—fechas:	—dates
crecer:	grow
tornaron:	they returned
Anunciación.:	Annunciation.
regresó:	return
Natividad:	Nativity
borróse:	blurry
templo:	temple
volvieron:	they came back
mercaderes:	merchants
clavos:	nails
cayeron:	they fell
relumbre:	glare
Graal:	Grail
Perdió:	lost
números.:	numbers.
siglo:	century
siglos:	ages
pasando:	passing
lunas.:	remedy.
devolviendo:	returning
calendarios:	calendars
rellenando:	filling
borraban:	they erased
destranscurrían:	they passed away
vaciaban:	they emptied
años:	years
desaforada:	unbridled
fuga:	leak
guarismos.:	figures.
perdiendo:	losing
seguían:	they followed
Medioevo.:	Middle Ages.
concluido:	concluded
Había:	There was
Grafías.:	Graphics.
Dómino:	Lord
Benedicamos:	Let us bless
est:	East
líe:	place
espacio...:	space...
viajar:	travel
estupefaciente:	narcotic
vislumbro:	glimpse
aspiro.:	I aspire.
presente.:	present.
ese:	that
posible.:	possible.
recuperación:	recovery
testimonio:	testimony
barniz:	varnish
conocía:	knew
aliviaban:	relieved
curanderos:	healers
bálsamos:	balms
emplastos:	plasters
calles;:	streets;
baldados:	waste
ciegos:	blind
asado.:	roast.
torno:	lathe
borracheras:	drunkenness
grandes:	big
armar:	arms
pelear:	fight
gallos:	roosters
echar:	throw
plectro:	plectrum
instrumentos:	instruments
preferir:	prefer
suelta:	loose
pareja:	couple
bailar:	dance
cinturón:	belt
prendido:	on
dinero:	money
llevar:	carry
hábitos:	habits
claveteados.:	nailed
portones:	gates
cocinas:	kitchens
baldosas:	tiles
toscas:	rough
conocido:	acquaintance
había:	there was
cuadros:	paintings
cien:	hundred
caminos:	roads
nuevos:	new
buscar:	look for
hicieron:	they did
especias:	spices
afición:	hubby
desmedida:	excessive
compartido:	shared
chamuscadas:	singed
tetas:	tits
lechoncillos:	piglets
trinchado:	carved
museos;:	museums;
soñar:	dream
hiciera:	did
jocunda:	funny
cuya:	whose
servicio:	service
moza:	girl
catar:	Qatar
prestos:	ready
siempre:	always
trago:	I bring
buen:	good
burgueses:	bourgeois
convivido:	lived together
Comprendo:	Understand
bendición:	blessing
piden:	they ask
madres:	mothers
distintas:	distinct
hijos:	children
cuarenta:	forty
reconocer:	recognize
orgullosos:	proud
patriarcas:	patriarchs
prostitutas:	prostitutes
—medievales:	—medieval
medievales:	medieval
reverenciar:	bow
modo:	way
Perro:	Dog
Caballo:	Horse
trascendentales:	transcendental
funciones:	functions
alargamiento:	elongation
olla:	be
navegación:	navigation
modos:	modes
remedio.:	remedy.
vestir:	dress
prenda:	garment
objeto:	object
calendario:	calendar
pertenecer:	belong
Puede:	Can
Edad:	Age
temprana:	early
Aguinaldos:	bonuses
tarde:	afternoon
asombrosa::	amazing:
percato:	notice
recientemente.:	recently.
atravesado:	crossed
ciudades:	cities
perduran:	they endure
fielmente:	faithfully
Francia:	France
paseos:	walks
diablos:	devils
esto:	this
palabra.:	word.
fuera:	out
tratar:	treat
Dioses:	Gods
situado:	situated
todas:	all
Dios.:	God.
celo:	even
especie:	species
parte:	part
sexo:	sex
cuyas:	whose
huesos:	bones
suerte:	luck
Adelantado:	Advanced
El:	He
toda:	all
ojos:	eyes
dedos:	fingers
bajo:	low
gusanos:	worms
larvas:	larvae
árboles:	trees
todavía:	still
vientres:	bellies
ubres:	udders
veo:	I see
borde:	should
también:	also
sinfonía:	symphony
distintos:	distinct
tiempos:	time
fueron:	were
resulta:	result
acabo:	just
debo:	I must
ciertos:	some
matriz:	headquarters
primera:	first
nunca:	never
encuentro:	meeting
sí:	Yeah
cosas:	things
cuyo:	whose
está:	this
mismo:	same
hablar:	talk
lejos:	far
Para:	To
parece:	it seems
algún:	some
durante:	during
jamás:	never
hombres.:	men.
varias:	several
imaginan:	imagine
le:	the
nuestras:	our
inventó:	invention
hombre:	man
Cero:	Zero
Año:	Year
fue:	was
cifras:	figures
tres:	three
fechas:	dates
tiempo:	time
súbito:	sudden
muerto:	dead
pasado:	past
través:	through
Conocía:	I knew
enormes:	huge
parroquia:	parish
viajan:	they travel
horas:	hours
ritmo:	rhythm
otro:	other
desde:	from
hemos:	we have
danzas:	dances
Hechicero:	Sorcerer
vientre:	belly
cautivos:	captives
llena:	full
mí:	my
esas:	those
hacia:	toward
antes:	before
si:	and
poco:	bit
ciertas:	certain
pensar:	think
quien:	who
haya:	these
porque:	why
hamacas:	hammocks
Cuando:	When
mucho:	a lot
La:	The
mujeres:	women
tienen:	have
quienes:	who
lado:	side
Que:	What
aquí:	here
En:	In
veces:	times
tantas:	so many
otra:	other
ya:	of
perros:	dogs
han:	he
aún:	still
entre:	between
muy:	very
palabra:	word
todo:	all
ni:	in
donde:	where
noche:	evening
secreto:	secret
dos:	of the
posibilidad:	possibility
hace:	does
esos:	those
alguna:	some
les:	THE
días:	days
verdad:	TRUE
Una:	A
para:	to
algo:	something
cuando:	when
vida:	life
vez:	time
mujer:	women
otros:	others
Pero:	But
esta:	this
ahora:	now
hombres:	men
sobre:	on
más:	further
su:	are
como:	as
una:	a
por:	by
sus:	their
se:	with
un:	and
del:	of the
en:	in
el:	he
la:	the
que:	what
de:	of
