113
:	113
oscuramente:	darkly
épico:	epic
poema:	poem
gesta:	guests
cantar:	sing
jirones:	tatters
misionero:	missionary
recoge:	collect
pájaros:	birds
huesos:	bones
sorbido:	sordid
polvo:	dust
ritualmente:	ritually
emborracha:	drunk
noches:	nights
animales.:	animals.
alianzas:	alliances
memorables:	memorable
duelos:	duels
ardides:	ploys
inventos:	inventions
princesas:	princesses
raptos:	abducted
encierran:	enclose
relatos:	reports
esos:	those
afirma:	states
unidad:	unit
portentosa:	portentous
intervinieron:	they intervened
singulares:	singular
combates:	fighting
curso:	course
desviados:	diverted
ríos:	rivers
portentosos:	portentous
héroes:	heroes
levantadas:	raised
montañas:	mountains
habla:	speaks
victoriosa.:	victorious.
prodigios:	prodigies
arrasa:	rock
caribe:	Caribbean
migración:	migration
fragmentos.:	fragments.
reconstruyendo:	rebuilding
epopeya:	epic
oscura:	dark
recuerdo:	memory
conservan:	preserve
aquí:	here
indios:	indians
descubrí:	I discovered
tarde:	afternoon
posible.:	possible.
explicar:	explain
anotarlo:	write it down
comprenderlo:	understand it
historiador:	historian
botánico:	botanical
etnógrafo:	ethnographer
geólogo:	geologist
naturalista:	naturalist
quisiera:	I'd like
ansioso.:	anxious.
impaciente:	impatient
ritmo:	rhythm
necesario:	necessary
reposo:	repose
trabajar:	work
cerebro:	brain
paladar:	palate
novedad:	novelty
desconcertante:	disconcerting
sabores:	flavors
habituarme:	get used to
pescar:	fish
aprender:	learn
holgarme:	relax
quemarme:	burn me
sensación:	sensation
ajeno:	unaffiliated
físico:	physical
sido:	been
cuales:	which
pereza:	laziness
tremenda:	tremendous
horas.:	hours.
espíritu:	spirit
comparten:	share
muchos:	many
reflexión:	reflection
tema:	him
añade:	duck
destino—.:	destination-.
interesarse:	interest
puedan:	can
creerán:	will believe
extraviado:	lost
haberse:	have
—«por:	-"by
viaje:	journey
segundo:	second
volverá:	will return
jamás:	never
Mesetas:	Plateaus
empeñado:	pawned
Buscador:	Seeker
Estado::	State:
Razón:	Reason
creada:	created
posibilidad:	possibility
reticencias:	reticence
aceptan:	accept
ambos:	both
adivino:	soothsayer
silencio:	silence
hijo;:	son;
Ahora:	Now
fronterizo.:	frontier.
remoto:	remote
remacharon:	riveted
grillos:	irons
marcas:	brands
explicaciones:	explanations
muestra:	sample
descubierto.:	uncovered.
recién:	newly
odio:	hatred
hicieron:	they did
dócil:	docile
amistoso:	friendly
acercarse:	approach
quería:	wanted to
aquellos:	those
parte:	part
humillaciones:	humiliations
maltratos:	abuse
años:	years
dos:	of the
voluntad:	willpower
entero:	whole
voz.:	voice.
rencor:	rancor
acento:	accent
súbito:	sudden
acota:	abound
gente»:	people"
sitio:	place
«Este:	"It is
responde.:	responds.
marcharse»:	leave"
daría:	would give
«La:	"The
fiebre.:	fever.
cualquier:	any
manchan:	stain
buscador:	seeker
aparecer:	to appear
viese:	see
haría:	would
qué:	that
Pregunto:	Asked
víbora.:	snake.
perro:	dog
cuero:	leather
encerrado:	closed
echado:	lying
parricida:	parricide
condenaban:	they condemned
espectacular:	spectacular
impresionante:	awesome
castigo:	punishment
instituya:	institute
hambre:	hunger
morir:	to die
expulsado:	expelled
condenar:	condemn
vacilará:	will hesitate
voz:	voice
nunca:	never
pausado:	slow
hablar:	talk
ese:	that
entonces:	so
veo:	I see
vedada:	to carry
bestia:	beast
quien:	who
castigar:	punish
tenga:	have
momento:	moment
Perteneciente:	Belonging
de...:	of...
solemnemente:	solemnly
asentado:	settled
código:	code
apoyarse:	lean
acabará:	will end
creando:	creating
sospecharlo:	suspect it
fundado:	founded
Hombre.:	Man.
conocer:	know
jactanciosos:	boastful
bibliotecas:	libraries
escritos:	writings
libros:	books
cientos:	hundreds
comprender:	grasp
instructivos:	instructions
poesía:	poetry
arte:	until
formas:	shapes
meditación:	meditation
motivo:	reason
inteligente:	intelligent
solicitación:	solicitation
partes:	parts
encontrado:	found
cambio:	change
Pero:	But
raudales—.:	torrents.
tormenta:	storm
—si:	-and
arrostrados:	faced
peligros:	dangers
cuanto:	how much
Pobre:	Poor
remanso.:	backwater.
traidora:	traitor
podrido:	rotten
tronco:	stem
disfrazado:	disguised
artero:	cunning
caimán:	caiman
arrojado:	thrown
rugido:	roar
sabido:	known
crótalo:	crotalus
otra:	other
terciopelo:	velvet
pocas:	few
muy:	very
viajando:	traveling
llevo:	he took
En:	In
indios.:	Indians.
danzas:	dances
fulminante:	fulminant
mordida:	bite
vampiros:	vampires
saurios:	saurians
112
:	112
donde:	where
cartógrafos:	cartographers
antiguos:	ancient
Incógnitas:	Unknowns
Terras:	Lands
blancas:	white
desconocidas:	unknown
comarcas:	regions
estas:	is
planteados:	raised
problemas:	problems
gravedad:	gravity
mayores.»:	older."
necesitarán:	will need
numerosos:	numerous
seamos:	let's be
reprobación:	reprobation
sentir:	to feel
haciéndosele:	making him
palabra:	word
dirigirle:	direct you
castiga:	win
falta:	lack
alguna:	some
responde—:	respond—
ahora:	now
«Hasta:	"Until
instituir:	institute
deber:	duty
horroroso:	horrible
tenido:	had
ya:	of
pregunto:	asked
modo:	way
inquieta:	restless
ultimo:	last
prosa:	prose
castigada»:	punished"
«será:	"it will be
infracción:	infraction
inmediatas:	immediate
realizar:	perform
quedado:	left
capitular:	capitulate
reunión:	meeting
De:	Of
tiempo.:	time.
antes:	before
remontando:	reassembling
están:	are
año:	year
ciertos:	some
aparición:	appearance
vigilar:	watch
gente:	people
apostar:	bet
necesidad:	need
cercado:	surrounded
troncos:	trunks
acarreo:	haulage
tala:	story
sobre:	on
orden:	order
anotadas:	noted
cuestiones:	issues
examen:	exam
concluye:	concludes
latines:	Latin
interés:	interest
inmediato:	immediate
granos:	grain
conservación:	conservation
tajante:	cutting
tono:	application
responde:	respond
urgencia.:	urgency.
medida:	measure
debería:	ought
también:	also
esto:	this
terminada:	finished
edificación:	building
recuerda:	remember
dónde.:	where.
sabe:	he knows
salidas:	Departures
moscas:	flies
invasión:	invasion
exasperante:	infuriating
agobia:	overwhelms
pesados:	heavy
cubre:	covers
mediodía:	average
sobrellevar:	endure
difícil:	difficult
nubes:	clouds
cargando:	charging
pues:	well
Venados:	Deer
población:	population
toda:	all
movilizándose:	mobilizing
mismo:	same
inicio:	start
fija:	fixed
obra:	work
ejecutar:	execute
conveniencia:	convenience
unanimidad:	unanimity
reconoce:	recognize
palmos:	spans
tres:	three
unos:	some
valladar:	fence
levantar:	lift
conjurado:	conjured
podría:	could
señalado:	indicated
peligro:	danger
vertiente.:	slope.
narigón:	nose
trazando:	tracing
lograrse:	be achieved
podía:	could
cosa:	What
humedad:	humidity
demasiada:	too much
haya:	these
ni:	in
estanque:	pond
terrenos:	land
exige:	demands
cual:	which
cebolla:	onion
cultivo:	crop
intento:	tried
respondía:	responded
realizado:	carried out
trabajo:	job
explicaciones.:	explanations.
demanda:	demand
fraile:	friar
batey:	more
probablemente:	probably
inundándose:	flooding
cercana:	close
vertiente:	slope
canalizar:	channel
efecto:	effect
tendrá:	will have
discutida:	discussed
él:	he
orientación:	orientation
tienen:	have
dirección:	address
bajo:	low
hechos:	facts
aproxima:	approaches
lluvias:	rains
época:	era
públicas.:	public.
considerar:	consider
pasa:	happens
Cabildo:	Council
Actas:	Minutes
Libro:	Book
asentada:	seated
queda:	is left over
respetar:	respect
hacerla:	do it
acatarla:	abide by it
juran:	legal
todos:	all
Luego:	Then
medida.:	measure.
justificándose:	justifying
comarca:	district
existencia:	existence
mermado:	depleted
acción:	action
inconsiderada:	inconsiderate
caza:	hunting
manadas:	herds
ciertas:	certain
emigración:	emigration
presentes.:	gifts.
criterio:	criterion
sometida:	subdued
emergencia:	emergency
será:	it will be
levantamiento:	lifting
así:	So
hambruna:	famine
fuerza:	force
cervatillo:	fawn
hembra»:	female"
«el:	"he
absoluta:	absolute
prohibición:	prohibition
instituye:	institutes
ciervas:	deer
cazado:	hunted
ausencia:	absence
comprobado:	checked
Habiendo:	Having
escrito.:	written.
consignados:	consigned
dejarlos:	leave them
provecho:	advantage
número:	number
cierto:	TRUE
tomar:	take
trata:	treats
traseras.:	rear.
patas:	paws
guardado:	saved
hueso:	bone
sentado:	sitting
Gavilán:	Hawk
presencia:	presence
legislando:	legislating
estos:	these
acentuado:	accentuated
mucho:	a lot
causa:	cause
cueros:	leathers
casi:	almost
Pertenecientes:	Belonging
portada:	front page
colegial:	schoolgirl
libreta:	notebook
alcance:	range
teniendo:	having
tendida:	lying
Sentado:	Sitting
marcha:	march
después:	after
puesto:	position
regresar:	go back
quienes:	who
aquel:	that
algún:	some
hombre:	man
mitos:	myth
todas:	all
historia:	history
bien:	GOOD
fuera:	out
visto:	view
mundo:	world
serpientes:	snakes
allá:	there
hombres:	men
asombro:	astonishment
Una:	A
llegará:	will arrive
durante:	during
castigos:	punishments
hombrecito:	little man
tal:	of
Esto:	This
—una:	-a
varios:	several
este:	it is
Mónica:	Monica
mañana:	tomorrow
luego:	then
hacia:	toward
severamente:	severely
granos.:	grain.
almacén:	store
canteros:	stonemasons
obras:	works
cuestión:	question
fieras:	beasts
disposición:	provision
objeto:	object
venado:	deer
comunidad:	community
acuerdos:	agreements
entre:	between
lado:	side
Responsable:	Responsible
Indios:	Indians
Capitán:	Captain
últimos:	last
calor:	heat
Cuaderno:	Notebook
cuya:	whose
mano:	thousand
horcón:	pitchfork
detrás:	behind
como:	as
vez:	time
pero:	but
tiempo:	time
le:	the
si:	and
hace:	does
El:	He
La:	The
han:	he
días:	days
sólo:	only
todo:	all
más:	further
día:	day
ser:	to be
está:	this
Adelantado:	Advanced
para:	to
su:	are
del:	of the
por:	by
se:	with
una:	a
un:	and
el:	he
en:	in
que:	what
la:	the
de:	of
