116
:	116
citaba:	cited
especulando:	speculating
defenderme:	defend myself
último:	last
De:	Of
incitaciones.:	incitements.
riesgosas:	risky
entrañaba:	entailed
reinvención:	reinvention
engendrados:	begotten
estilos:	styles
desorden:	disorder
desconfiar:	distrust
Había:	There was
musicales.:	musicals.
implicaciones:	implications
través:	through
palabra-
célula:	word-
cell
indiscutible:	indisputable
seguir:	follow
haciéndosele:	making him
confusa:	confused
intrincada:	intricate
resultado:	result
hubiera:	had
golpe:	blow
presentada:	presented
sido:	been
simultaneidad:	simultaneity
percepción:	perception
oyente:	listener
prepararía:	would prepare
bastante:	quite
concepción:	conception
expresiva:	expressive
intensidad:	intensity
aumento:	increase
sinfónica:	symphonic
auténticas:	authentic
leyes:	laws
según:	according to
machihembradas:	mb lada s to town
concertadas:	concerted
armónico:	harmonic
polifónica:	polyphonic
coexistencia:	coexistence
lograr:	achieve
contrapuntístico.:	contrapuntal.
movimiento:	motion
creciente:	growing
enriquecimiento:	enrichment
polifonía:	polyphony
invención:	invention
entregarse:	surrender
podía:	could
compactado:	compressed
mientras:	while
oposiciones:	oppositions
armónica:	harmonica
variación:	variation
buscando:	searching
terreno:	land
pasaba:	was passing
melismático:	melismatic
vías:	ways
Ahora:	Now
coloreaba.:	colored
diversificaba:	diversified
sonoros:	sound
medios:	media
constantes:	constants
cuyas:	whose
nuevos:	new
sucesión:	succession
creaba:	created
Esto:	This
compostelano.:	compost it
femenino—:	female-
masculino:	masculine
—elemento:	-element
ordenaban:	they ordered
éstas:	are
primicial:	first time
voces:	you
sucesivas:	successive
entradas:	entries
ondulante.:	wavy.
añadía:	added
dignidad:	dignity
restaba:	remained
columna:	column
severa:	severe
colgada:	hung
guirnalda:	wreath
especie:	species
salvaguardada::	safeguarded:
quedaba:	remained
así:	So
pureza:	Preza
litúrgico:	liturgical
tema:	him
directamente:	directly
agregar:	add
decente:	decent
sombras:	shadows
darle:	give
adornarla:	decorate it
firmus:	firm
cantus:	song
situada:	located
voz:	voice
segunda:	second
Catholici—:	Catholics
—Congaudeant:	- Let them rejoice
compostelano:	compost it
lejanos:	distant
días:	days
aquellos:	those
impresionado:	impressed
parte:	part
Por:	By
posibles.:	possible.
aleaciones:	alloys
tenso:	tense
parche:	patch
cuerda:	rope
cobre:	copper
presencia:	presence
hecho::	made:
estuviera:	was
instrumento:	instrument
vibrante:	vibrant
intervenciones:	interventions
estas:	is
afirmándose:	asserting
recitado:	recited
normales:	normal
períodos:	periods
delimitar:	delimit
encuadrar:	frame
puntuación:	score
discretamente:	discreetly
entrarían:	they would enter
hablar:	talk
Transformado:	Transformed
palabra.:	word.
cercano:	nearby
estado:	state
conditor—:	founder
rerum:	of things
—Aeterne:	-Eternally
ambrosiano:	ambrosian
himno:	hymn
notas:	notes
pocas:	few
centrado:	centered
dibujo:	drawing
así—:	So-
quería:	wanted to
tuviera:	had
afirmarse:	assert
empezaría:	would start
estribillo:	chorus
medidas:	measures
distancias:	distances
cuidado:	Careful
sucesiones:	successions
entonación:	intonation
dando:	giving
irían:	they would go
palabras:	words
misma:	same
repetición:	repetition
verbo-génesis.:	verb-genesis.
sería:	I would be
Aquello:	That
adjetivo.:	adjective.
necesitaran:	they will need
elocuencia:	eloquence
otros:	others
árbol:	tree
nube:	cloud
hombre:	man
sustantivos:	nouns
corriente:	current
uso:	use
hecho:	made
decir:	say
comenzara:	will begin
auditorio:	auditorium
atención:	attention
reclamar:	complain
silencio:	silence
público:	public
hacia:	toward
adelantara:	will advance
personaje:	character
latín.:	latin.
naturales:	natural
nacida:	born
parece:	it seems
Illa:	Ill
Irae:	of anger
maravilla:	wonder
probablemente:	probably
ocurrió:	occurred
prosodia:	prosody
escansión:	scansion
propia:	own
hallando:	finding
haciéndose:	making
casi:	almost
cantado:	sung
hablado:	spoken
pasara:	passed
impresionista—:	impressionistic-
estilización:	stylization
exageración:	exaggeration
hecha:	made
115
:	115
desnuda:	naked
surgiera:	arose
bien:	GOOD
buscaba:	I was looking for
interesaba.:	was interested
realidad:	reality
vienesa:	viennese
escuela:	school
paroxísticos:	paroxysmal
exasperados:	exasperated
logros:	achievements
llegándose:	arriving
modernos:	modern
compositores:	composers
preocupa:	worries
tanto:	both
ese:	that
armónico;:	harmonic;
sostén:	support
contrario:	contrary
liberarla:	free her
acompañamiento:	accompaniment
enredar:	entangle
idioma:	language
buscar:	look for
diciendo:	saying
cantar:	sing
cantando:	singing
recitar:	recite
modos:	modes
estudio:	study
profanas.:	profane.
litúrgicas:	liturgical
historia:	history
repasado:	reviewed
problema:	problem
mejor:	better
enfocar:	focus
Para:	To
música.:	music.
acoplar:	couple
nuevas:	new
posibilidades:	possibilities
meditado:	meditation
mismo—:	same-
seguro:	insurance
crear:	create
miedo:	fear
fondo:	bottom
incitación:	incitement
toda:	all
flaqueza:	frailty
pereza:	laziness
composición:	composition
alejado:	away
hubieran:	they would have
actividades:	activities
estúpidas:	stupid
caer:	fall
Antes:	Before
sueño.:	dream.
durante:	during
imaginación:	imagination
impuesto:	tax
Treno:	Train
título:	title
Porque:	Why
Treno.:	Train.
esbozos:	sketches
primeros:	first
necesaria:	necessary
claridad:	clarity
traerá:	will bring
esperar:	wait
sólo:	only
pensamiento::	thought:
concretar:	specify
embriaguez:	drunkenness
torpezas:	clumsiness
subraya.:	underlines.
delimita:	delimit
enmienda:	amendment
tacha:	blemish
mano:	thousand
cerebro:	brain
ya:	of
orden:	order
buscan:	search
mismas:	themselves
conciencia;:	awareness;
nutre:	nourishes
lucubración;:	lucubration;
delirante:	delusional
aquella:	that
inició:	start
semejante:	such
partes:	parts
goteras:	leaks
rodeado:	surrounded
oscuridad:	darkness
ocurre:	occurs
lámpara.:	lamp.
calor:	heat
sublimado:	sublimate
habían:	had
agujas:	needles
trabajadas:	worked
burbujeantes:	bubbly
gotas:	drops
sonidos:	sounds
plástica:	plastic
estéticas:	aesthetic
transferencias:	transfers
imposibles:	impossible
descabelladas:	crazy
invenciones:	inventions
consistencia:	consistency
adocenadas:	cobbled
fórmulas:	formulas
menor:	smaller
tenía:	had
fumado:	smoking
bajo:	low
resuelto:	resolved
mortificante:	mortifying
verdad:	TRUE
quise:	I wanted
lúcido:	lucid
salí:	I went out
siguiente:	following
adoptar.:	adopt.
incertidumbre:	uncertainty
molesta:	bothers
proyectaba:	projected
Concierto:	Concert
vacilaciones:	hesitations
ni:	in
dolor:	pain
nacería:	would be born
horas:	hours
algunas:	some
pautado:	lined
droga:	drug
saliera:	came out
hecho.:	made.
medido:	measured
claro:	Of course
atormentaban.:	they tormented
creación:	creation
problemas:	problems
solución:	solution
repentina:	sudden
trajo:	brought
intelectual:	intellectual
produjo:	produced
cuarta:	quarter
recuerdo:	memory
opio::	youth:
fumar:	smoke
curiosidad:	curiosity
cierta:	true
llevar:	carry
dejado:	left
atrás:	back
años:	years
Muchos:	Many
entendieran.:	they would understand
leyeran:	they would read
palparan:	squander
partitura:	score
texto:	text
haciéndola:	doing it
salir:	go out
podría:	could
inscrita:	registered
ordenación.:	ordering
asombrándose:	amazed
oídos:	ears
suena:	sounds
cerrados:	closed
abiertos:	open
«cosa»:	"What"
espíritu;:	spirit;
construido:	built
preciso.:	necessary.
significado:	meaning
cobran:	they charge
ordenarse:	order
dispersos:	scattered
sentido:	sense
disgregados:	disintegrated
informes:	information
elementos:	elements
compactación:	compaction
maduración:	maturation
trabajo::	job:
realizarse:	be realized
acaba:	ends
mente:	mind
sensación:	sensation
despierto:	awake
todavía—:	still-
debe:	has to
—lejos:	-far
tiempo:	time
algún:	some
noches...:	nights...
arduas:	arduous
cuarenta:	forty
tiempos:	time
llegado:	arrived
hubiésemos:	we would have
borrando:	erasing
doquiera:	everywhere
duermo:	I sleep
odioso.:	hateful.
cariño:	dear
pareciendo:	seeming
huraña:	swearing
torna:	returns
acontece:	it happens
esto:	this
puede:	can
abrazar:	embrace
siquiera:	even
vez.:	time.
114
:	114
atardecer.:	sunset.
hasta:	until
llover:	rain
emergencia.:	emergency.
medida:	measure
dictado:	dictation
terminar:	finish
ayudado:	helped
invectivas:	invectives
Adelantado:	Advanced
cubre:	covers
pésimo:	appalling
Su:	They are
indios.:	Indians.
ayuda:	aid
apuntalable:	propable
apuntalar:	shore
tratando:	treating
sexo:	sex
puesto:	position
guayuco:	hang on co
cintura:	waist
anudado:	knotted
hábito:	habit
fraguado:	setting
aún:	still
caído:	fallen
llorar.:	cry.
hacía:	toward
humo:	in it
llenaron:	they filled
viviendas:	housing
fuegos:	fires
encendían:	they lit
lodo.:	official
rodeados:	surrounded
húmedas:	wet
ropas:	clothes
desconcertados:	bewildered
halló:	found
El:	He
cobija.:	blanket.
sostienen:	hold
vigas:	beams
colgarlos:	hang them
colectados:	collected
salvar:	save
nosotros:	us
debajo:	below
correr:	run
comenzó:	began
torrente:	torrent
goteras.:	leaks.
espacio:	space
busca:	search
inútil:	useless
otro:	other
lugar:	place
hamacas:	hammocks
mudando:	changing
primera:	first
pasamos:	we passed
resecas:	parched
estaban:	were
techo:	ceiling
Como:	As
fue:	was
súbito:	sudden
socavones:	sinkholes
retumbando:	rumbling
oquedades:	cavities
colándose:	sneaking in
mesetas:	plateaus
suelo:	floor
rodar:	rotate
parecieron:	they seemed
bajos:	bass
truenos:	thunder
obertura:	opening
Hubo:	Was
días.:	days.
hace:	does
Llueve:	It's raining
poema.:	poem.
siempre:	always
manchado:	stained
caracol:	snail
asombro:	astonishment
sabrá:	will know
falena:	moth
terciopelos:	velvets
pardos:	brown
calcedonias:	chalcedony
alfabeto:	alphabet
descubrirán:	they will discover
hombres:	men
Un:	And
creado.:	created.
entendimiento:	understanding
simplemente:	simply
consistirán:	they will consist
estética:	aesthetics
emoción:	emotion
superiores:	superiors
veces:	times
preguntarme:	ask me
Llego:	Arrive
dibuja:	draw
euritmia:	eurythmy
tiene:	has
coreografía:	choreography
Ninguna:	None
brisa.:	breeze.
bambúes:	bamboos
macizo:	solid
hermoso:	beautiful
Nada:	Nothing
prodigiosa:	prodigious
repente:	suddenly
torbellino:	whirlwind
alborozan:	exult
vencimientos:	expirations
respiros:	breaths
pausas:	pauses
blancas:	white
olas:	eggs
retornos:	returns
inquieto:	restless
ascendente:	ascending
frondas;:	fronds;
estremecido.:	shuddered
tronco:	stem
propio:	own
torno:	lathe
retoños:	shoots
ramas:	remaining
ligeras:	light
hojas:	leaves
rondas:	rounds
organizan:	organize
poseen:	possess
viento.:	wind.
bailar:	dance
secreto:	secret
conocen:	they know
Arboles.:	Trees.
existe:	exists
fulgurante:	dazzling
segundo:	second
descubierto:	uncovered
voz.:	voice.
raras:	rare
encienden:	turn on
mirar:	look
pasa:	happens
sentir:	to feel
acude.:	come
llamo:	called
cerca.:	fence.
recobrada.:	recovered.
forma:	shape
descanso:	rest
flecha:	arrow
disparar:	shoot
entesado:	entangled
armado:	armed
celo:	even
apremio:	pressure
incontenible:	irrepressible
deseo:	desire
llamada:	call
brota:	break
acerco:	approach
bien.:	GOOD.
siente:	feel
contorno:	contour
metida:	stuck up
desaparecido.:	missing.
plexo:	plexus
latidos:	beats
aprensiones:	apprehensions
ocurrir:	occur
desgracias:	misfortunes
presentimientos:	hunches
inmotivadas:	unmotivated
angustias:	anguish
sobresaltos:	shocks
flaccida:	flaccid
piel:	fur
traía:	brought
grasas:	fats
malas:	lazy
estructura.:	structure.
ceñidos:	tight
músculos:	muscles
escueto:	short
vuelto:	turned
cuerpo:	body
esqueleto::	skeleton:
apretando:	squeezing
adelgazado:	slimmed down
pescado:	fish
mañoco:	mancoco
alimentación:	feeding
parca:	park
ruda:	brown
vida:	life
trabajos:	jobs
demasiado.:	too much.
pensar:	think
memoria:	memory
escrita—:	writing—
posible:	possible
pensaba:	thought
puros:	cigars
planos:	plans
desarrollo:	development
tropo:	trope
enunciado:	statement
sencillez:	simplicity
poco:	bit
vocablos:	words
corifeo:	coryphean
poema:	poem
manera:	manner
proceso:	process
inflexiones:	inflections
funciones:	functions
recitativo:	recitative
ciertas:	certain
mucho:	a lot
regresar:	go back
pero:	but
muy:	very
todas:	all
esta:	this
eran:	were
imaginado:	imagined
revelación:	revelation
escritura:	writing
tipo:	type
acerca:	about
pluma:	feather
papel:	paper
tomar:	take
tendría:	would have
pensado:	thought
veía:	saw
euforia:	euphoria
vez:	time
lógica:	logic
Una:	A
algo:	something
sueño:	dream
constante:	constant
dificultad:	difficulty
fuera:	out
gesto:	gesture
poder:	can
tengo:	I have
otra:	other
haberle:	have him
algunos:	some
efectos:	effects
amanecer:	sunrise
tuve:	I had
instrumentos:	instruments
Luego:	Then
larga:	long
dos:	of the
ojos:	eyes
formas:	shapes
si:	and
Así:	So
luces:	lights
La:	The
está:	this
mujer:	women
vuelve:	comes back
tensión:	strain
Cuando:	When
preciso:	necessary
han:	he
estoy:	I'm
debo:	I must
expresión:	expression
elemento:	element
orquesta:	orchestra
acentos:	accents
cuya:	whose
melodía:	melody
hacer:	do
estar:	be
nada:	nothing
obra:	work
noche:	evening
entre:	between
mismo:	same
cuando:	when
día:	day
cada:	each
pensar.:	think.
aquí:	here
modo:	way
suerte:	luck
ruido:	noise
lluvia:	rain
entonces:	so
ritmo:	rhythm
todos:	all
Pero:	But
sus:	their
palabra:	word
había:	there was
dentro:	within
le:	the
desde:	from
como:	as
mí:	my
sobre:	on
todo:	all
luego:	then
más:	further
su:	are
música:	music
para:	to
por:	by
se:	with
una:	a
un:	and
del:	of the
el:	he
en:	in
que:	what
la:	the
de:	of
