122
:	122
muerte:	death
esperando:	waiting
distante:	distant
caverna:	cave
enfermo:	sick
llegar:	arrive
encontró:	found
buscador:	seeker
visto:	view
Sé:	See
andando.:	going.
arrastrándose:	crawling
montaña:	mountain
aleja:	move away
alforja:	saddlebag
guarda:	guard
arroja:	throws
mazorca:	cob
riendo:	laughing
entra:	enter
Luego:	Then
separarlo:	separate it
horquillada:	bracketed
suavemente:	gently
empuja:	push
enojo—.:	anger-.
«¡Vete:	«¡Yourself
pavor.:	dread.
muda:	time
arrodillada:	kneeling
pedazos:	pieces
agitando:	waving
gesticula:	gestures
cadáver:	corpse
presente:	gift
cuerpo:	body
pesadilla:	nightmare
ceniza.:	ash.
mano:	thousand
señalando:	pointing
ronquido:	snore
suerte:	luck
tráquea:	windpipe
despide:	say goodbye
desintegración:	disintegration
dentro:	within
licuarse:	liquefy
también:	also
disolverse:	dissolve
prestos:	ready
endurecido:	hard
llanto:	crying
ojos:	eyes
garganta:	throat
sombras:	shadows
abierto:	open
agujero:	hole
torno:	lathe
sujeta:	subject
escoria:	slag
semblante:	countenance
piltrafa:	piltraf
residuo:	residue
puntiagudo:	pointed
gorro:	cap
Bajo:	Low
selvas.:	jungles.
estas:	is
fondo:	bottom
depositarios:	depositories
horribles:	horrible
Levítico:	Leviticus
tantos:	so many
olvidada:	forgotten
clásica:	classic
antigüedad:	antique
lepra;:	leprosy;
allí:	over there
apareció:	appeared
atrás.:	back.
mirar:	look
jadeo:	panting
seguido:	followed
grito:	shout
falta...:	lack...
tanto:	both
Allá:	There
lejos:	far
allá:	there
legalizado:	legalized
firmado:	signed
reunida.:	reunited.
indiada:	Indian
fórmula:	formula
pronunciar:	pronounce
oyendo:	hearing
estampa:	print
pintado:	painted
aspira:	aspire
casarse;:	marry;
obligarla:	force her
quisiera:	I'd like
porque:	why
inferioridad:	inferiority
molesta:	bothers
humillado:	humiliated
mío.:	mine.
nociones:	notions
mundo:	world
Frente:	Forehead
réplica.:	replica.
concepto:	concept
lógica:	logic
campesina:	peasant
Confieso:	I confess
cuidado».:	Careful".
dé:	god
depende:	it depends
sabe:	he knows
varón:	male
«el:	"he
sentenciosa—:	judgmental—
—afirma:	—states
cambio:	change
unión:	union
mujeres.:	women.
hombres:	men
hicieron:	they did
leyes:	laws
peso:	weight
caer:	fall
Casarse:	Marry
licor.:	liqueur.
desórdenes:	disorders
engaño:	deception
entronizado:	enthroned
marido:	husband
abandona:	abandon
guardias:	guards
mandar:	to send
esposa:	wife
alguno.:	some.
derecho:	right
valer:	worth
tenga:	have
dejarlo:	leave it
abandonarlo:	abandon it
facultad:	faculty
descarría:	astray
compañero:	buddy
asiste:	attend
hombre.:	man.
defenderse:	fend
recurso:	resource
atadura:	tie
según:	according to
temen::	friend:
mujeres:	women
orgullo:	pride
recóndito:	recondite
probablemente:	probably
fue:	was
hermanas:	sisters
argumentación:	argumentation
desconcertado:	embarrassed
explicaciones.:	explanations.
pedirle:	ask
dolido:	hurt
celoso:	jealous
sorpresa:	surprise
transforma:	transform
punto:	point
matrimonio.:	marriage.
quiere:	wants
ninguna:	none
asombrado:	amazed
decir:	say
oigo:	I hear
catecúmenos:	catechumens
dominical:	Sunday
protagonista:	hero
hacerme:	make me
oportunidad:	chance
agarrar:	grab
creo:	believe
casemos.:	let's get married
deseable:	desirable
útil:	useful
preguntarle:	ask him
decido:	a decision
hable.:	speak.
observar:	notice
podrá:	will be able
rostro:	face
encuentra:	finds
Desde:	From
humedad.:	humidity.
causa:	cause
encender:	light
costado:	side
mucho:	a lot
121
:	121
maíz:	corn
unas:	nails
acabando:	running out
detrás:	behind
exigencia.:	requirement.
nuevamente:	again
Pienso:	I think
hamaca.:	hammock.
recuesto:	reclining
calmado:	calm
Algo:	Something
Curador.:	Curator.
año:	year
creer:	believe
hacérselo:	do it
quise:	I wanted
—como:	-as
totalmente:	fully
estaba:	was
demostrarme:	show me
aunque:	although
escribiré:	I will write
escribirlo:	write it
Debo:	I must
nunca.:	never.
ejecute:	run
importa:	matter
trombón.:	thrombo.
cornos:	horns
fagot:	bassoon
clarinetes:	clarinets
órgano::	organ:
sonoridad:	sonority
festiva:	festive
oídos:	ears
página:	page
esbozar:	outline
lápiz:	pencil
hará:	will do
posee:	owns
mañana:	tomorrow
libreta::	notebook:
segunda:	second
tercio:	third
ahí:	there
quedará:	will remain
jurarme:	swear to me
puedo:	I can
risible.:	laughable.
insentato:	senseless
absurdo:	absurd
realmente.:	really.
empezar:	begin
mía:	tight
escuchada:	heard
lugares:	places
evasión:	evasion
consumado:	consummated
esperado:	expected
audiencias.:	hearings.
vastas:	answered
alcanzar:	reach
música:	music
especialmente:	especially
demás:	others
destina:	intended
arte:	until
ejecutada.:	executed.
De:	Of
desde:	from
haciendo:	doing
vanidad:	vanity
hecha:	made
imagen:	image
confusión:	confusion
correo.:	mail.
puesto:	position
cartas:	cards
escribiendo:	writing
quién:	who
pregunta:	ask
encuentro:	meeting
exasperado:	exasperated
falta:	lack
estúpido:	idiot
escollo:	stumbling block
toparse:	bump
pudiera:	could
imaginación:	imagination
pensé:	think
Nunca:	Never
resquemante:	resequent
crepúsculo:	dusk
antes:	before
tarea:	task
abandonar:	abandon
acabo:	just
menguado:	diminished
maniatado:	tied up
pequeño:	little
haciéndome:	making me
discurso:	speech
cohibe:	control
inspiración:	inspiration
generosidad:	generosity
contraria:	contradicts
avara:	spacious
mezquina:	petty
preocupación:	worry
pero:	but
papel;:	paper;
milímetro:	millimeter
cada:	each
aprovechar:	leverage
pendolista:	commuter
astucias:	cunning
gráfica:	graphic
Aprieto:	Fix
Mesetas.:	Plateaus.
Nada:	Nothing
llueve:	it's raining
haga:	do
fibra:	fiber
envolturas:	wrappers
extrañas:	strange
yutas:	Yuta
naturales:	natural
tejidos:	fabrics
pródiga:	prodigal
debe:	has to
Alguna:	Some
problema.:	problem.
urgencia:	urgency
hallar:	cases
cuaderno.:	notebook.
segundo:	second
tercera:	third
llenado:	fill
escritura:	writing
apretado:	tight
pesar:	weigh
voces...:	you...
establecida:	established
polifonía:	polyphony
tipo:	type
desarrollo:	development
alimento:	food
sirviendo:	serving
entrada:	Prohibited
orquesta:	orchestra
—episodio:	-episode
lírico:	lyrical
episodio:	episode
introduciendo:	introducing
melismático:	melismatic
lamento:	I regret
discantus:	students
pasar:	market
sumamente:	extremely
Estoy:	I'm
esfuerzo.:	effort.
arduo:	arduous
lográndolo:	achieving it
trabajo:	job
concentrarme:	concentrate
cavilación:	rumination
acoso:	harassment
zozobra:	anxiety
huir:	flee
inquebrantable:	unwavering
propuesto:	proposed
había:	there was
proceder:	proceed
rectitud:	rectitude
acto:	act
abajo:	below
echará:	will cast
acepto—:	I accept—
mentira:	lie
armonía:	harmony
plácida:	placid
falseándose:	falsifying
misionero:	missionary
situación:	situation
pondrá:	will put
digo—:	I say—
mentir.:	lie.
cierto:	TRUE
confesar:	confess
dilema:	dilemma
veré:	I will see
disparadero.:	shooting
coloque:	put
ánimo:	cheer up
actuará:	will act
propósito:	purpose
tácticas:	tactics
probables:	probable
temor:	fear
canalladas.:	scoundrels
semejantes:	similar
impide:	prevents
Dios».:	God".
«marido:	"husband
libreta:	notebook
suscrita:	subscribed
alegría:	happiness
tal:	of
ropas:	clothes
guardar:	keep
verla:	see it
atroz:	atrocious
espectáculo:	show
aceptar:	accept
posible—.:	possible-.
siempre:	always
gravidez:	pregnancy
viviente:	living
albergar:	harbor
120
:	120
llevada:	carried
instinto:	instinct
atribuye:	attributes
importancia:	importance
tanta:	so much
engañarla:	cheat on her
subleva:	revolt
cosas:	things
todas:	all
estimo:	esteem
algo:	something
atañe:	concerns
cuanto:	how much
puesta:	putting
lealtad:	loyalty
mentira;:	lie;
prohibido:	forbidden
hombre:	man
sentirme:	feel
vuelto:	turned
estafas.:	scams.
tiempos:	time
pasaron:	bird
contentos.:	happy
quedarían:	would remain
todos:	all
pedida:	requested
ejemplar:	copy
comedia:	comedy
prestarme:	lend me
Podría:	Could
delito:	crime
sería:	I would be
tribunales:	courts
país:	country
distancias:	distances
bigamia:	bigamy
entrañablemente:	endearingly
hondamente:	deeply
importaría:	would matter
ya.:	of.
casado:	married
molesta::	bothers:
ocultar:	disguise
libertad:	freedom
literarios:	literary
buscaba:	I was looking for
reacciones:	reactions
fáciles:	easy
desafiante:	challenging
burla:	derision
entonces:	so
confesarme:	confess to me
Vuelvo:	I'm back
tamborileo.:	patter.
sordo:	deaf
lluvia:	rain
malangas:	oily
hojas:	leaves
anchas:	wide
temporalmente:	temporarily
calafateada:	the caulking
sido:	been
rajaduras:	cracks
abierta:	open
salgo:	I'm on my way out
carcajada:	laugh
prorrumpo:	I burst out
estampa.:	print.
personajes:	characters
consentido:	spoiled
hayamos:	let's have
abrazamos:	we hug
esteras:	mats
bendita:	blessed
asperjar:	asparagus
Habrá:	There will be
signo:	sign
ellos:	they
tracen:	trace
negras:	black
uñas:	nails
unos:	some
gozarse:	enjoy
yacer:	lie
cuerpos:	bodies
samaritano.:	Samaritan.
sayal:	skirts
escondidas:	hidden
ataduras:	restraints
relucir:	shine
salen:	the hall
Ya:	Of
decirle::	tell him:
iba:	others
guardando:	watching
otra:	other
hombros:	shoulders
encojo:	I shrink
cayado:	crook
golpea:	hits
Sorprendido:	Surprised
voz.:	voice.
oyeran:	they would hear
recogerse:	pick up
tenían:	they had
rebaño:	herd
ovejas:	sheep
hablaba:	spoke
frase:	phrase
presencia:	presence
justificando:	justifying
ministerio:	ministry
legitimidad:	legitimacy
dudas:	doubts
tolera:	tolerate
improperios:	expletives
profiere:	utters
insulta:	stroke
violencia:	violence
grita:	scream
iracundo:	wrathful
tiempo;:	time;
hincharse:	swell
parecen:	they seem
venas:	is coming
ministerio.:	ministry.
vivía:	lived
bien:	GOOD
diciéndole:	telling him
irónica:	ironic
reacción:	reaction
aplomo:	aplomb
vuelve:	comes back
Repentinamente:	suddenly
Venados.:	Deer.
Mónica:	Monica
instaurarse:	establish
habrá:	there will be
orden:	order
deben:	they must
legales:	legal
santificadas:	sanctified
uniones:	unions
pues:	well
casarme:	get married
obligación:	obligation
Afirma:	states
indios.:	Indians.
ejemplos:	examples
malos:	bad
dando:	giving
evangelización:	evangelism
entorpecer:	hinder
empiezan:	they start
sensatas:	sensible
cultas:	cultured
tienen:	have
increpa:	rebukes
cuestión.:	question.
ajena:	alien
cosa:	What
cualquier:	any
balbuceo:	babbling
esperaba:	I expected
concubinato:	concubinage
seguir:	follow
pienso:	I think
preguntándome:	wondering
conmigo:	with me
encara:	still
Casamientos.:	Marriages.
Registro:	Record
comunidad:	community
Entierros:	Burials
Bautizo:	Christening
llevarse:	take away
habrán:	there will be
además:	besides
éste:	this
añadiendo:	adding
da:	and
capuchino:	cappuccino
quejarme:	complain
Enojado:	Angry
pautados.:	ruled.
papeles:	papers
siquiera:	even
saben:	per
partituras:	sheet music
necesitan:	need
primeras:	first
carabelas:	caravels
venidos:	come
Medievo:	Medieval
siendo:	being
siguen:	they continue
plectro:	plectrum
gentes:	people
tocadores:	players
arpistas:	harpists
conoce:	know
músicas:	songs
necesidad:	need
relación:	relationship
establece:	establishes
Según:	According to
hijo:	son
guitarra:	guitar
ofrece:	offers
despecho:	spite
calmar:	calm
Para:	To
músicas.:	songs.
despilfarrarse:	waste
podían:	they could
alguno:	some
utilidad:	utility
apuntes:	notes
acuerdos:	agreements
consignar:	record
actas:	minutes
levantar:	lift
destinaban:	they destined
libretas:	notebooks
explicándome:	explaining
dijo:	said
último»:	last"
«Te:	"The
necesitaba:	I needed
expliqué:	explain
Le:	The
tragaba.:	swallowed
preguntó:	asked
cuaderno:	notebook
otro:	other
pedir:	ask
fui:	I went
sorpresa.:	surprise.
desagradable:	disgusting
Acabo:	Just
¡Vete:	¡Alone
cerca:	fence
aún:	still
lepra:	leprosy
mueve:	moves
En:	In
hacer:	do
frente:	forehead
quita:	remove
casamiento:	marriage
hacia:	toward
expresión:	expression
mazorcas:	cobs
vacío:	empty
tres:	three
suena:	sounds
fuerza:	force
sé:	see
Treno:	Train
medios:	media
obra:	work
puede:	can
viajar:	travel
despecho.:	spite.
siento:	I feel
pensar:	think
está:	this
evidente:	obvious
posible:	possible
fuera:	out
día:	day
pasará:	will pass
aparición:	appearance
partitura:	score
trato:	deal
esta:	this
vida:	life
difícil:	difficult
—si:	-and
firme:	firm
conciencia:	awareness
vez:	time
podría:	could
buscar:	look for
uso:	use
mismo:	same
verdad:	TRUE
manera:	manner
principios:	beginning
choza:	hut
nuestra:	our
cuya:	whose
nupcial:	bridal
cromo:	chrome
ridículo:	ridiculous
edificante:	edifying
dedos:	fingers
pueden:	they can
hasta:	until
mí:	my
parte:	part
suelo:	floor
eran:	were
acerca:	about
tengo:	I have
esto:	this
vida.:	life.
súbito:	sudden
Libros:	Books
olvidar:	forget
parece:	it seems
razón:	reason
ni:	in
Todas:	All
escribir.:	write.
componer:	compose
hecho:	made
entre:	between
alguna:	some
veo:	I see
modo:	way
tomar:	take
esas:	those
luego:	then
papel.:	paper.
qué:	that
El:	He
tener:	have
ese:	that
tiene:	has
este:	it is
hace:	does
papel:	paper
Por:	By
sus:	their
debo:	I must
dos:	of the
fraile:	friar
toda:	all
nada:	nothing
Adelantado:	Advanced
le:	the
cuando:	when
todo:	all
voz:	voice
momento:	moment
donde:	where
bajo:	low
estoy:	I'm
ahora:	now
poco:	bit
si:	and
ya:	of
aquí:	here
ser:	to be
Pero:	But
como:	as
La:	The
sobre:	on
más:	further
muy:	very
mujer:	women
quien:	who
del:	of the
por:	by
para:	to
su:	are
se:	with
un:	and
una:	a
el:	he
en:	in
la:	the
que:	what
de:	of
