101
:	101
abismo.:	abyss.
estaban:	were
tinieblas:	darkness
vacía:	empty
desordenada:	messy
alabanzas:	praise
incienso:	incense
tiempos:	time
sideral:	sidereal
tristeza:	sadness
—la:	-the
Creador:	Creator
comenzara:	will begin
adonde:	where to
llegaríamos:	we would arrive
retrocediéramos:	we would go back
Si:	And
Creación.:	Creation.
Día:	Day
Cuarto:	Room
Génesis:	Genesis
Estamos:	We are
noche.:	evening.
día:	day
señorear:	lord
100
:	100
habrán:	there will be
lumbreras:	luminaries
prueban:	they test
primera:	first
vez:	time
aparecidas:	appeared
apartarse:	depart
vivientes.:	living.
seres:	beings
parece:	it seems
nada:	nothing
cavernas:	caves
trabaje:	work
abeja:	bee
arborescentes:	tree-like
helechos:	ferns
huya:	come on
algo:	something
Aquí:	Here
Terciario.:	Tertiary.
dragonadas:	dragonades
legado:	legacy
prehistóricos:	prehistoric
animales:	animals
estampa:	print
cargan:	they load
todavía:	still
lepidosirenas:	lepidosirens
gimnotos:	Gymnotos
escualos:	sharks
cabezones:	big heads
laulaus:	tables
tetas:	tits
peces:	pieces
monstruosos:	monstrous
saurios:	saurians
quedaron:	were left
ríos:	rivers
grandes:	big
Abajo:	Below
hombre.:	man.
nuestros:	our
abre:	open
vedado.:	prohibited.
dominio:	domain
arrojados:	thrown
ser:	to be
prestos:	ready
intrusos:	intruders
vemos:	we see
explanadas.:	esplanades.
inmensidad:	immensity
sombras:	shadows
alcance:	range
pluralidad:	plurality
obras:	works
magnas:	big
fausto:	auspicious
sobrecogidos:	overcoected
sentimos:	we feel
hablamos.:	talk later.
planeta.:	planet.
caídas:	falls
acaso:	chance
—meteoritas:	— meteorite
coágulos:	clots
rugosos:	rough
peñascos:	boulders
nieblas;:	fogs;
respiran:	they breathe
hendeduras:	crevices
signos:	signs
agujas:	needles
cimas:	tops
borde:	should
monolitos:	monoliths
crepúsculo.:	dusk.
noche:	evening
llenan:	fill
opalescentes:	opalescent
orillas:	shores
helados:	ice cream
fondos:	funds
amanecer:	sunrise
escarchas:	frosts
holladas:	trampled
nunca:	never
soledades:	loneliness
vírgenes:	virgins
guardan:	they keep
nubes:	clouds
vecinos:	neighbors
lunares:	polka dots
planicies:	plains
últimas:	latest
escalonamiento:	staggering
cumbres:	summits
arriba:	above
adivina:	guess
otros.:	others.
unos:	some
derraman:	spill
estanques:	ponds
sucesión:	succession
caer:	fall
dividirse:	be divided
atronadores:	thunderous
ecos:	echoes
acrecidos:	accreted
naturales:	natural
arcos:	bows
enormes:	huge
torrente:	torrent
espumas:	foams
petrificada.:	petrified
árboles:	trees
jalonada:	drawn
arcoiris:	rainbow
deshace:	undo
vacío:	empty
arroja:	throws
cimera.:	summit
cornisa:	cornice
almenaje:	at least
amarillas:	yellow
cascadas:	waterfalls
siete:	seven
suelta:	loose
casi:	almost
granito:	granite
montaña:	mountain
allá:	there
inconmovible.:	immovable.
país:	country
este:	it is
movimiento:	motion
poner:	put
para:	to
confabula:	conspires
geológica:	geological
fantasía:	fancy
alguna:	some
arabesco:	arabesque
algún:	some
creado:	created
severidad:	severity
rompiendo:	breaking
De:	Of
procesión.:	procession.
figuras:	figures
semejan:	they resemble
cipos:	cipes
extraños:	strangers
corona:	crown
ángulos:	angles
afila:	affiliate
biseles:	bezels
recorta:	crop
flanqueante:	flanking
terraza:	terrace
tiene:	has
basalto:	basalt
farallón:	cliff
encarnado:	red
obelisco:	obelisk
adorna:	adorns
La:	The
quebrados.:	broken.
rectos:	straight
bruscos:	abrupt
aristas:	edges
propia:	own
morfología:	morphology
presenta:	presents
meseta:	plateau
Cada:	Each
cabezas.:	heads.
nuestras:	our
palmos:	spans
cien:	hundred
flancos:	flanks
ahondan:	they delve
túneles:	tunnels
esos:	those
conducir:	drive
deben:	they must
desconocido:	a stranger
—de:	-of
Puertas:	Doors
solemnidad:	solemnity
misteriosa:	mysterious
tienen:	have
madréporas.:	madreporas.
gigantescas:	gigantic
alvéolos:	alveoli
agrietados:	cracked
todos:	all
abiertos:	open
cuarzo:	quartz
cristales:	crystals
largos:	long
pirámides:	pyramids
bronce:	bronze
cilindros:	cylinders
inmensos:	immense
parecen:	they seem
majestad.:	majesty.
aplastante:	overwhelming
confiere:	confers
les:	THE
impar:	odd
abolengo:	lineage
vejez:	old age
misma:	same
contemplarlos:	contemplate them
pudieran:	could
hubiera:	had
aún:	still
terrestre:	land
corteza:	crust
alzaron:	raised
primeros:	first
monumentos:	monuments
telúrica.:	telluric.
geometría:	geometry
elementalidad:	elementality
grandiosa:	great
reducidas:	reduced
desnuda:	naked
Formas:	Shapes
lluvias:	rains
milenios:	millennia
tuvieron—:	had—
—cuando:	-when
vestidura:	clothing
Lavadas:	Washed
Mesetas.:	Plateaus.
Grandes:	Big
alzan:	rise
suelo:	floor
alcanzado:	reached
hemos:	we have
salomas:	Salom
compás:	compass
barcas:	boats
izar:	star
obligados:	obligated
quietos:	quiet
caños:	pipes
otra:	other
torrentes:	torrents
tramos:	sections
navegando:	browsing
siempre:	always
subiendo:	going up
Lentamente:	Slowly
crónicas.:	chronicles.
migraciones:	migrations
oscuras:	dark
hasta:	until
Historia:	History
olvidados:	forgotten
planeta:	planet
armazón:	warehouse
andamos:	we walk
días:	days
dos:	of the
Hace:	Does
junio):	June)
(Sábado:	(Saturday
aunque:	although
mundo:	world
antes:	before
bajo:	low
poco:	bit
perfiles:	profiles
hecha:	made
Algo:	Something
más:	further
parados:	stopped
ojos:	eyes
cuando:	when
peldaño:	step
otro:	other
salto:	jump
cascada:	waterfall
como:	as
entre:	between
sus:	their
su:	are
por:	by
sobre:	on
del:	of the
un:	and
una:	a
el:	he
se:	with
la:	the
en:	in
que:	what
de:	of
