105
:	105
noche.:	evening.
aspirar:	aspire
salimos:	we go out
momento:	moment
desembarcar.:	disembark.
asaltaron:	assaulted
mente:	mind
vuelve:	comes back
punto:	point
pienso:	I think
Henoch»:	Enoch»
vivirse:	live
debió:	should have
llegada.:	arrival.
fue:	was
sencillos:	simple
sucesos:	events
promovidos:	promoted
tambores:	drums
cantos:	songs
colectiva:	collective
explosiones:	explosions
sequía:	drought
tras:	after
lluvia:	rain
abundante:	abundant
pesca:	fishing
tibieza:	tepidity
júbilo:	jubilation
motivo:	reason
hallando:	finding
simples:	simple
cosas:	things
contentan:	happy
destinos:	destinations
hoguera:	bonfire
calor:	heat
residencia:	residence
dioses:	gods
usando:	using
siguen:	they continue
trueno:	thunder
rayo:	ray
acompañan:	accompany
escama:	scale
veneno:	poison
trajes:	suits
cuyos:	whose
conocidos:	acquaintances
mandatarios:	representatives
tiempo:	time
unidades:	units
creado.:	created.
vasta:	only
asignado:	assigned
papel:	paper
aceptando:	accepting
instinto:	instinct
admiten:	admit
divertido:	fun
Creación:	Creation
rigores.:	rigors.
tiene:	has
Orden:	Order
parte:	part
antemano::	beforehand:
aceptados:	accepted
naturales:	natural
posibles:	possible
padecimientos:	ailments
allá.:	there.
renovadas:	renewed
amenazas:	threats
frías:	cold
crueldades:	cruelties
sobresaltos:	shocks
espantos:	frights
tratable:	tractable
consideran:	consider
belleza.:	beauty.
pesar:	weigh
circunda:	surrounds
indudable:	doubtless
gente:	people
propias:	own
fuesen:	were
empeños:	pawns
ocupaciones:	occupations
—como:	-as
menosprecio:	disparagement
allá.»:	there."
regresan:	they return
Adelantado—:	Advanced-
«El:	"He
existir.:	exist.
juego:	game
leyes:	laws
auténticas:	authentic
figura:	figure
trabado:	stuck
sucumbe:	succumbs
sobrellevar:	endure
hecho:	made
atavismo:	atavism
gangrena.:	gangrene.
impotencia:	impotence
hambruna:	famine
inundación:	flood
levantados;:	raised;
trabajosamente:	laboriously
animales:	animals
devoran:	devour
fieras:	beasts
insectos:	insects
venenosos:	poisonous
azotes:	spanking
enfermedades:	diseases
cartógrafos.:	cartographers.
antiguos:	ancient
Terrenal:	Earthly
Paraíso:	Paradise
pretende:	intend
propia.:	own.
legislar:	legislate
poder:	can
interesa:	interest
mucho:	a lot
búsqueda:	search
abandonado:	abandoned
afana:	they are similar
sabe:	he knows
Ahora:	Now
orden.:	order.
cosa:	What
haga:	do
cementerio:	cemetery
Señala:	Point out
lápida:	stone
bajo:	low
entierra:	buries
Firma:	Business
Gobierno.:	Government.
Levanta:	Get up
contorno:	contour
traza:	trace
arcadas.:	arcades.
puentes:	bridges
monumentos:	monuments
tener:	have
llegue:	I arrived
futuro:	future
esperar:	wait
razón:	reason
nacieron:	were born
todas:	all
Puesto:	Position
hablarse:	talk
«fundar»:	"meetings"
verbo:	verb
comprender:	grasp
tuve:	I had
mismo:	same
sorpresa:	surprise
probablemente:	probably
Siente:	feel
percata:	notice
tortugas.:	turtles.
huevos:	eggs
orquídeas:	orchids
embalsamados:	embalmed
pájaros:	birds
ostensiblemente:	ostensibly
comercia:	trade
suspicacias:	suspicions
burlar:	cheat
ánimo:	cheer up
apetencias.:	desires.
excesos:	excesses
trastornarlo:	upset it
ignorado:	ignored
invadiendo:	invading
rastro:	trail
seguirle:	follow him
tardarán:	will take
bolsillos:	pockets
polvo:	dust
apareciendo:	appearing
sigue:	go on
entonces:	so
Piensa:	Think
rocas.:	rocks.
apremio.:	pressure.
señal:	sign
orilla:	bank
guijarros:	shingle
arrojan:	they throw
mozas:	girls
tardes:	afternoon
cascada:	waterfall
baña:	but
prospera.:	prosper.
vida:	life
interesando:	interesting
poco:	bit
Poco:	Bit
jamás:	never
pues:	well
inventar:	inventory
Adán:	Adam
tienen:	have
destetado:	weaned
becerro:	calf
cabra:	goat
Luego:	Then
fondo:	bottom
patas:	paws
atados:	tied
pareja:	couple
viaje:	journey
segundo:	second
regreso:	return
104
:	104
carpintería.:	carpentry.
apero:	conference
posturas:	postures
semillas:	seeds
cambiarlo:	change it
estaño.:	tin.
esta:	this
Encuentra:	Finds
rodean.:	surround.
esos:	those
trabajos:	jobs
penurias:	hardships
solidario:	supportive
convalecencia:	convalescence
Su:	They are
extinción.:	extinction.
vías:	ways
numerosa:	numerous
endeble:	flimsy
especie:	species
vástagos:	scions
últimos:	last
somos:	we are
muchos:	many
piensan:	they think
él:	he
antes:	before
Sólo:	Only
hierbas.:	herbs.
curan:	cure
funeraria—:	mortuary-
jarra:	jug
factores:	factors
cultura:	culture
asentada:	seated
—gente:	-people
hueso.:	bone.
pierna:	leg
dejando:	leaving
engusanada:	to swallow
desemboca:	flows
hambruna.:	famine.
meses:	months
saltamontes:	grasshopper
hormigas:	ants
avispas:	wasps
larvas:	larvae
comiendo:	eating
montañas:	mountains
perdido:	lost
noventa:	ninety
Camina:	walk
Mesetas.:	Plateaus.
Grandes:	Big
asoma:	appears
propia:	own
habituado:	accustomed
favorecido:	favored
Nunca:	Never
buscadores.:	search engines.
afortunadas:	lucky
insistencias:	insistences
desengaños:	disappointments
miserias:	miseries
comparte:	share
Durante:	During
llevado.:	carried.
ofrece:	offers
izan:	be
poblaciones.:	populations.
aparecen:	appear
desnudas:	naked
coloreadas:	colored
zonas:	zones
incansablemente:	untiringly
sueña:	sounds
Cunucunuma:	Conuconuma
sonoridad:	sonority
percutiente:	striking
obsesionado:	obsessed
libros;:	books;
ignorados:	ignored
ríos:	rivers
extraños:	strangers
bañar:	bathe
azahar:	noon
bombonas:	candy
encargan:	they order
quienes:	who
conoce:	know
nuevos::	new:
yacimientos:	deposits
aprende:	learn
recetarios:	recipe books
Andando:	Going
lejana.:	distant
irse:	go
domingos:	Sundays
ropas:	clothes
salen:	the hall
carcomido:	rotten
púlpito:	pulpit
última:	last
oído:	ear
después:	after
año:	year
lunes:	Monday
edad:	age
envidia:	nvidia
joven:	young
rumbo.:	course.
secreto:	secret
revelar:	reveal
parten:	the party
buba:	happen
aliviados:	relieved
curados:	cured
apenas:	just
muestras:	samples
examinando:	examining
habitaciones:	rooms
llave:	key
encierran:	enclose
mujeres.:	women.
preguntan:	they ask
descansan:	they rest
Esos:	Those
posible.:	possible.
barrunto:	around
enfebrecidos:	feverish
ojos:	eyes
hallaron:	they found
nada:	nothing
Pasan:	They pass
música.:	music.
hembras:	females
hartarán:	will be fed up
gema:	echo
mirífica:	myrific
arrancaron:	they started
también:	also
llegan:	they arrive
vencidos:	defeated
Llegan:	They arrive
ignorado.:	ignored.
cortinas:	curtains
pasante:	intern
oscuro:	dark
descorriendo:	slipping away
contraído:	contracted
creen:	believe
comarcas:	regions
azufre:	sulfur
quinina:	quinine
abandonadas:	abandoned
misiones:	missions
leprosos:	lepers
sarnas:	similarly
rascan:	they scratch
palúdicos:	malaria
tembladeras:	scrapies
añagazas:	tricks
desconfiaran:	they will distrust
llegar:	arrive
andén:	platform
podridas:	rotten
tablas:	tables
bastones:	walking sticks
tientan:	tentan
agobiado:	overwhelmed
andar:	to walk
cercano:	nearby
desembarcadero:	disembarkation
bajan:	they go down
cargan:	they load
viejos:	old
barcos:	boats
veces:	times
tierras:	land
vienen:	they come
despacioso:	slow
correr:	run
moletas:	knuckles
linaza:	flax
ocurre:	occurs
encuentra:	finds
mozo:	guy
aleros:	eaves
transita:	transit
nadie:	nobody
emético.:	emetic.
tártaro:	Tartarus
raíz:	root
vómica:	vomic
nuez:	nut
casera:	homemade
prescripción:	prescription
recetas:	recipes
confían:	trust
maceraciones:	macerations
enseñaron:	they taught
Algo:	Something
albergue.:	hostel.
botica:	drugstore
trabajar:	work
ofrecido:	offered
enfermo:	sick
Vencido:	Overdue
cloacas.:	sewers.
carboneras:	charcoal pits
sótanos:	basements
sombras:	shadows
oficios:	crafts
halló:	found
adolescente:	adolescent
crecidas:	floods
suben:	they go up
caminos:	roads
jornadas;:	days;
jornadas:	days
103
:	103
Caballo:	Horse
Tierras:	Land
Más:	Further
nublada.:	cloudy
Santísimas:	Most Holy
Marías:	Marias
canta:	sing
cura:	treatment
pasa:	happens
monjas;:	nuns;
hojaldres:	puff pastries
rosarios:	rosaries
maitines:	meals
provincia:	province
Hacia:	Toward
viejos.:	old
tinta:	ink
llenas:	full
bolas:	balls
través:	through
rebelde:	rebel
desgarrado:	torn
pecho:	chest
veinte:	twenty
caduceo:	caduceus
emblema:	emblem
Bajo:	Low
batea:	Bataa
pasar:	market
demás:	others
adelantaba:	advanced
dieron:	they gave
trata:	treats
sólo:	only
diré:	I will say
les:	THE
título:	title
hechos:	facts
grandes:	big
llamarse:	call
corriente:	current
apellido:	last name
llamo:	called
arrojando:	throwing
«Pues:	"Well
rumbos.:	directions.
hogar:	home
junto:	together
escucharé:	I will listen
gineceo:	gynoecium
recojan:	pick up
caserío:	hamlet
duerman:	sleep
hartado:	treasuredo
hayan:	have
pasadas:	passed
jicaras:	jikaras
beben:	tremble
resina:	resin
sabor:	flavor
burbujeante:	bubbly
articulaciones:	joints
ablando:	softening
cantan:	they sing
intereso:	interest
Ayudo:	Ayuso
parte.:	part.
llegado:	arrived
invadir:	invade
dejo:	let
preguntas.:	questions.
oportunidades:	opportunities
muchas:	many
vencidos.:	defeated.
dicen:	they say
preferentemente:	preferably
misas:	masses
acepta:	accept
sólida:	solid
alienta:	encourages
todo:	all
teniéndose:	having
intransigencias:	intransigence
aspiraciones:	aspirations
interdictos:	interdicts
cánones:	canons
fardo:	burden
tremendo:	tremendous
estorbo:	hindrance
encima:	on
echa:	cast
fundar:	meeting
impar:	odd
oportunidad:	chance
cómo:	as
comprendo:	understand
inmediato.:	immediate.
formular:	formulate
impide:	prevents
asados:	roasted
festín:	feast
preparativos:	preparations
nuevas:	new
empero:	however
excluye:	excludes
aquiescente:	acquiescing
silencio:	silence
Losada:	slab
fundaron:	founded
primeros:	first
eran:	were
distinto.:	distinct.
pensado:	thought
Ni:	In
eso.:	that.
sorna.:	sarcasm.
fraile:	friar
pregunta:	ask
raro.:	down.
imponente:	imposing
sugerido:	suggested
palabra:	word
confieso:	I confess
Le:	The
hijos.»:	children."
criado:	created
varón:	male
Agustín:	Augustine
parió:	gave birth
fundador::	founder:
llamaba:	called
venado:	deer
ésta:	this
advierte:	warns
acompañado:	accompanied
Gobernador:	Governor
recibir:	receive
alcalde:	mayor
mestizas:	mixed race
esposas:	wives
bienvenida:	welcome
grita:	scream
vecindario:	neighborhood
desborda:	overflows
penalidades:	penalties
increíbles:	incredible
chivatos:	snitches
verracos:	voircos
cabras:	goats
cría:	creates
inicia:	starts
cercado:	surrounded
maíz:	corn
sembrados:	sown
señalarme:	point me out
terminado:	finished
Catedral.»:	Cathedral."
levantaremos:	we will lift
«Frente:	"Forehead
volviéndose:	turning
añade:	duck
indios...»:	Indians..."
Detrás:	Behind
bestias...:	beasts...
algunas:	some
enseres:	equipment
granos:	grain
tenemos:	have
hijas...:	daughters...
tres:	three
Allá:	There
Allí:	Over there
Gobierno...:	Government...
«Esta:	"This
voz::	voice:
orgullo:	pride
temblor:	shaking
blanquecino.:	whitish.
humo:	in it
levanta:	get up
hogueras:	bonfires
unas:	nails
También:	Also
establo.:	barn.
almacén:	store
lados:	sides
ambos:	both
situadas:	situated
construcción:	construction
cuanto:	how much
semejantes:	similar
pequeñas:	small
viviendas:	housing
dos:	of the
ventanas.:	windows.
cuatro:	four
divisa:	split
extremo:	extreme
cuyo:	whose
limpiado:	cleaned
lado:	side
doscientos:	two hundred
espacio:	space
pequeño:	little
veo:	I see
102
:	102
desconcertado.:	embarrassed.
detengo:	I stop
verdad:	TRUE
Venados.:	Deer.
portento:	portent
asomarme:	look out
puedo:	I can
amarra:	tie
raras.:	rare.
revestido:	coated
farallón:	cliff
recibirlo:	receive it
mansas:	meek
laberintos:	labyrinths
otro:	other
curso:	course
pasándose:	passing
bordeándose:	bordering
calma:	calm
horas:	hours
Transcurren:	They pass
exasperantes:	exasperating
ignora:	ignore
respirando:	breathing
montaña:	mountain
fragancias:	fragrances
recobran:	recover
plantas:	plants
cerca:	fence
vivas:	lives
somnolencia:	sleepiness
boga:	have
acompasado:	rhythmic
arrulla:	coos
hombre;:	man;
invencida:	invincible
continente:	continent
fundarse:	establish
podrían:	could
cuento:	tale
inexploradas:	unexplored
territorios:	territories
inmensos:	immense
pensando:	thinking
regazo:	lap
cabeza:	head
Recuesto:	Reclining
órgano...:	organ...
tañedor:	keeper
nacido:	born
habían:	had
aún:	still
edificada:	built
Henoch:	Enoch
Génesis.:	Genesis.
voluntad:	willpower
horrores:	horrors
sustraiga:	subtract
gobernar:	govern
Crear:	Create
verbo.:	verb.
conjugar:	combine
posible:	possible
fundo:	bottom
Fundar:	Meetings
codiciadas.:	coveted.
gemas:	excited
imaginación:	imagination
luminarias:	luminaries
encendiendo:	lighting
noches:	nights
pocas:	few
confiado:	confident
repetírmelo:	repeat it
canso:	tired
secreto::	secret:
voces:	you
partido:	party
griego:	Greek
Porque:	Why
muelle:	dock
conducirnos:	drive us
habrá:	there will be
caño:	spout
angosto:	narrow
navegación:	navigation
proseguimos:	we continue
bendice:	bless
sorprendente:	surprising
hombro:	shoulder
llevando:	carrying
amanecer:	sunrise
desnudo:	naked
aleja:	move away
desengañarla:	undeceive her
pueda:	can
Antes:	Before
suerte.:	luck.
traerá:	will bring
Historia:	History
creyendo:	believing
agarra:	grab
Alborozada:	Exhilarated
Odisea:	Odyssey
mí:	my
tiende:	tends
puesta:	putting
lleva:	carry
ropa:	clothes
teniendo:	having
presente:	gift
hacernos:	make us
Quiere:	Wants
aventureros.:	adventurers.
emprende:	undertake
Micenas:	Mycenae
hacía:	toward
precioso:	precious
codicia:	greed
guía:	guide
apegado:	attached
haberse:	have
parecía:	it seemed
tanto:	both
Homero:	Homer
conocedor:	connoisseur
acaieno:	acaien
perfil:	profile
campesino:	peasant
abrazamos:	we hug
emoción:	emotion
instante:	instant
huellas:	footprints
detrás:	behind
borrando:	erasing
decires:	you say
mentiroso:	liar
manejos:	handling
avaro:	miserly
hallazgo;:	find;
compartir:	share
quiere:	wants
minero:	miner
Solitario:	Lonely
buscar:	look for
despide:	say goodbye
rumbo:	course
señalando:	pointing
alzado:	raised
junio):	June)
estatutos.:	statutes.
tus:	the
fueron:	were
Cánticos:	Chants
CAPITULO:	CHAPTER
tragedia:	tragedy
viven:	they live
Aquí:	Here
muerte:	death
Un:	And
cual:	which
larga:	long
vieron:	they saw
Cuando:	When
nombre:	name
mañana:	tomorrow
vez:	time
lejos:	far
menos:	less
rencores:	grudges
llaga:	sore
frascos:	jars
dónde:	where
traen:	they bring
tiempos:	time
otros:	others
contemplando:	contemplating
duermen:	they sleep
laboratorio:	laboratory
remedios:	remedies
cambio:	change
farmacia:	pharmacy
siempre:	always
suena:	sounds
historia:	history
alguna:	some
alegría:	happiness
hacer:	do
peligros:	dangers
cuenta:	account
leña:	firewood
interrogaciones:	interrogations
«Así:	"So
aquella:	that
porque:	why
Venados:	Deer
hijas:	daughters
acuden:	they come
traídos:	brought
cerdos:	pigs
hacia:	toward
En:	In
hijo:	son
cuyas:	whose
suerte:	luck
allí:	over there
tarde:	afternoon
luego:	then
frente:	forehead
espaldas:	backs
volver:	return
hacen:	do
pequeños:	small
naturaleza:	nature
mesetas:	plateaus
primera:	first
así:	So
Época:	Era
mapas:	maps
Fundador:	Founder
esto:	this
puede:	can
nuestra:	our
estampa:	print
nosotros.:	us.
sí:	Yeah
nosotros:	us
brazo:	arm
aquí:	here
algún:	some
está:	this
día:	day
nombres:	names
quien:	who
durante:	during
allá:	there
noche:	evening
hora:	time
acción:	action
sobre:	on
años:	years
había:	there was
misma:	same
Anunciación:	Annunciation
Gobierno:	Government
unos:	some
plagas:	pests
medio:	half
todavía:	still
ciudades:	cities
ni:	in
hace:	does
fuera:	out
desde:	from
fundado:	founded
ahora:	now
mujer:	women
ese:	that
ser:	to be
lugar:	place
cada:	each
pero:	but
entre:	between
mineros:	miners
si:	and
algo:	something
indios:	indians
ya:	of
mundo:	world
este:	it is
hombre:	man
semejante:	such
hombres:	men
hablar:	talk
La:	The
muy:	very
todos:	all
Mónica:	Monica
días:	days
donde:	where
Pero:	But
como:	as
El:	He
le:	the
Adelantado:	Advanced
cuando:	when
para:	to
sus:	their
su:	are
más:	further
un:	and
por:	by
del:	of the
se:	with
una:	a
el:	he
en:	in
la:	the
que:	what
de:	of
