21
:	21
inútil:	useless
herramienta:	tool
dejado:	left
poco:	bit
mente:	mind
enmohecido:	moldy
leer:	file
aprendí:	I learned
infancia;:	childhood;
hablé:	I spoke
pues:	well
idioma.:	language.
poros::	couples:
lentamente:	slowly
penetra:	penetrates
fuerza:	force
escrúpulos.:	scruples.
adormece:	falls asleep
voluptuosidad:	voluptuousness
ahora:	now
aluminio:	aluminum
lluvia:	rain
tenue:	outfit
arrojaba:	threw
adverso:	adverse
viento:	wind
empeñada:	pawned
envergadura:	wingspan
oscilante:	oscillating
tiempos:	time
tres:	three
encierro:	confinement
este:	it is
cómplice:	accomplice
secuestrado:	kidnapped
preso:	taken 
sentía:	felt
dinero:	money
devolver:	return
antes:	before
cuanto:	how much
regresar:	go back
primera:	first
aprovechar:	leverage
deseos:	wishes
tenía:	had
viaje;:	journey;
emprendido:	undertaken
arrepentido:	repentant
sucias:	dirty
amanecer:	sunrise
socavón:	sinkhole
podridos:	rotten
crustáceos:	crustaceans
hedor:	stench
brisa:	breeze
cambio:	change
cierto:	TRUE
también:	also
llegando:	arriving
profundidad:	depth
calar:	shut up
parece:	it seems
espartillo:	wire grass
olor:	smell
recobrada:	recovered
vez:	time
acostumbrados.:	accustomed.
caminos:	roads
lejos:	far
hallarme:	find me
acostumbrado:	used to
aún:	still
pienso:	I think
maletas:	suitcases
nuestras:	our
contenido:	content
examinar:	examine
habrán:	there will be
prisa:	hurry
darse:	give
esperando:	waiting
distinto:	distinct
Aturdido:	Stunned
preguntas:	questions
responde:	respond
cuños:	dies
oficina:	office
sordos:	deaf
firme:	firm
rodar:	rotate
regreso:	return
placentero:	pleasant
avión.:	plane.
izquierda:	left
desaparece:	disappears
investidura.:	investiture.
solemne:	solemn
acompañaran:	will accompany
romanos:	Romans
desfiles:	parades
populares:	popular
festejos:	celebrations
asistir:	watch
faltado:	missed
pocos:	few
República:	Republic
Presidente:	President
vivía:	lived
allí:	over there
orilla:	bank
hasta:	until
descendían:	they descended
surtidores:	suppliers
terrazas:	terraces
jardines:	grounds
rodeada:	surrounded
amable:	gentle
vasta:	only
compañero:	buddy
pregunté:	I asked
aterrizaje:	landing
pista:	track
enfilando:	heading
Como:	As
Océano.:	Ocean.
lugar:	place
iniciaba:	started
ciclón:	cyclone
derribadas:	knocked down
cada:	each
frecuentes:	frequent
tormenta:	storm
rayos:	good heavens
demás:	others
Por:	By
experiencia.:	experience.
probada:	proven
desconcertar:	bewilder
esperaba:	I expected
le:	the
menos:	less
surgiendo:	arising
confusión:	confusion
entregado:	delivered
existía:	existed
Gusano.:	Worm.
visto:	view
Nadie:	Nobody
secretos:	secrets
aceptada:	accepted
explicación:	explanation
ocurrían:	occurred
cosas:	things
esas:	those
Cuando:	When
vano.:	vain.
buscaba:	I was looking for
policía:	police
decires:	you say
pánico:	panic
llevada:	carried
ocurrido;:	occurred;
nada:	nothing
ventanillas:	windows
lanzaba:	threw
ácidos;:	acids;
desafiaba:	challenged
parásito:	parasite
mordido:	bitten
Nacional:	National
botellas;:	bottles;
dentro:	within
burbujear:	bubble
empezaban:	they started
licores:	liquors
desajustaban;:	they were out of adjustment;
precisión:	precision
aparatos:	appliances
hongos;:	fungus;
llenas:	full
amanecían:	they dawned
suero:	serum
ampolletas:	vials
mañana:	tomorrow
Una:	A
garantizado.:	guaranteed.
objetos:	objects
peso:	weight
trastocar:	disrupt
cálculos:	calculations
embrollar:	muddle
abierto:	open
cerrar:	close
abrir:	open
designios:	designs
misteriosos:	mysterious
actuar:	act
ponía:	put
volante—:	steering wheel—
carcoma:	woodworm
duende:	elf
—polen:	—Poland
maligno:	malignant
polen:	Poland
anofeles.:	helpless.
tiempo:	time
conocer:	know
alcanzado:	reached
habían:	had
decanos:	deans
cuyos:	whose
mercaderes:	merchants
contento:	happy
vinos:	wines
multiplicación:	multiplication
embajadas:	embassies
fausto:	auspicious
céspedes:	lawns
lisura:	smoothness
reflejaba:	reflected
progreso:	progress
historia.:	history.
todavía:	still
experimentados:	experienced
cautelosamente:	cautiously
métodos:	methods
cotidiana:	everyday
rutina:	routine
aceptándose:	accepting
facilidad:	ease
sorprendente:	surprising
asimiladas:	assimilated
técnicas:	techniques
Aquí:	Here
goterones.:	drips.
techo:	ceiling
trepidaba:	trembled
mecánica:	mechanics
penetraba:	penetrated
eléctrica:	electric
La:	The
hojalata.:	tin.
jarros:	jugs
bebiendo:	drinking
aporreando:	downstream
templando:	temple
vestir:	dress
medio:	half
vida:	life
20
:	20
pasaba:	was passing
habitadas:	inhabited
porque:	why
ilustres:	illustrious
visitantes:	visitors
ni:	in
forasteros:	outsiders
mostraban:	they showed
barrancas:	ravines
estrellándose:	crashing
ciegos:	blind
callejones:	alleys
extraviaban:	they lost
derribaban:	they demolished
desconocidos:	unknown
conducidos:	driven
vehículos:	vehicles
tránsito:	transit
desconcierto:	bewilderment
tal:	of
plazas:	places
inundaban:	flooded
desagües:	drains
suficientes:	enough
nunca:	never
abril:	April
llegaban:	they arrived
textos.:	texts.
legislada:	legislated
ejemplarmente:	exemplarily
urbe:	city
prosperidad:	prosperity
abundancia:	abundance
bronce:	bronze
proclamaban:	they proclaimed
victorias:	victories
martillos:	hammers
dentadas:	bites
ruedas:	wheels
trompetas:	trumpets
alados:	winged
genios:	geniuses
caduceos:	caduceus
balanzas:	scales
mundo:	world
canícula:	Canicula
perenne:	perennial
públicos:	public
blancura:	whiteness
Lonjas:	Markets
riqueza:	wealth
Bancos:	Banks
mármoles:	marbles
periódicos:	newspapers
Bolsas:	Scholarships
hormigueo:	tingle
Dominando:	Dominating
primitiva:	primitive
fundadores:	founders
apropiado:	appropriate
sitio:	place
trazaran:	will trace
avenidas:	avenues
guardarrayas:	stripe guard
empaque:	packing
dando:	giving
coloniales:	colonial
resurgían:	they resurfaced
urbanistas:	urban planners
eminentes:	eminent
trazados:	traces
suburbios:	suburbs
arrojado:	thrown
Habían:	They had
Le:	The
funcional:	functional
voluntad:	willpower
mejor:	better
veinte:	twenty
acabando:	running out
arquear:	arch
siestas:	naps
canciones:	songs
descuido:	neglect
aprovechaban:	they took advantage
indolentes:	indolent
servidumbres:	easements
custodia:	custody
dejando:	leaving
París:	Paris
meses:	months
unos:	some
iba:	others
propietario:	owner
murallas;:	walls;
resquebrajaban:	they cracked
pisos:	flats
levantaban:	they raised
luchado:	fought
Durante:	During
remotas.:	remote.
noches:	nights
abismada:	astonished
inimaginable:	unimaginable
civilización:	civilization
obra:	work
destinadas:	intended
edificaciones:	buildings
fueran:	were
si:	and
hombre:	man
otra:	other
estableciendo:	establishing
realidades:	realities
falseaban:	they falsified
siglo:	century
comienzo:	beginning
cimborrios:	domes
antiguos:	ancient
campanarios:	bell towers
antenas:	antennas
modernas:	modern
paradas:	stops
inútiles:	useless
Esas:	Those
mano:	thousand
salido:	left
aerolito:	aerolite
tiro:	number
pulidos:	polished
solitarios:	lonely
allá:	there
alzaban:	raised
peñones:	rocks
inconmovilidad:	immobility
insectos:	insects
amarilla:	yellow
fiebre:	fever
marismas:	salt marshes
siglos:	ages
librar:	librate
tenido:	had
población:	population
orden:	order
construidas:	built
fortificaciones:	fortifications
servían:	served
cerros:	hills
delimitada:	delimited
faja:	wad of bills
angosta:	narrow
creciendo:	growing
seguir:	follow
Para:	To
nosotros.:	us.
debajo:	below
dibujaban:	they drew
topografía:	topography
anárquica:	anarchic
estilo:	style
dispersa:	disperses
cariño:	dear
sorna:	sarcasm
mezcla:	mix
hablaba:	spoke
atrás—:	back-
anchura:	width
dormía:	I slept
Mouche:	Fly
—pues:	-well
instalado:	installed
periodista:	journalist
pleno:	full
Allá:	There
lluvia.:	rain.
difuminada:	blurred
musgo:	moss
derecha:	right
invisibles.:	invisible.
olas:	eggs
entregaba:	delivered
apoyo:	support
dejaba:	left
recogía:	collected
inesperadamente:	unexpectedly
soltaba:	released
inestable:	unstable
desconfiado:	suspicious
vacilante:	hesitant
hizo:	those
arriba:	above
quedaron:	were left
De:	Of
descendiendo.:	descending
estábamos:	we were
advertían:	they warned
nuestros:	our
minutos:	minutes
algunos:	some
hacía:	toward
Desde:	From
junio):	June)
(Miércoles:	(Wednesday
SEGUNDO:	SECOND
CAPITULO:	CHAPTER
muy:	very
volábamos:	we wanted to
algún:	some
donde:	where
Gusano:	Worm
ciertos:	some
gente:	people
estaban:	were
veces:	times
estatuas:	statues
lluvias:	rains
céntricas:	central
palmeras:	palm trees
días:	days
partes:	parts
todas:	all
residencia:	residence
pero:	but
raíces:	roots
años:	years
centenares:	hundreds
desconocido:	a stranger
uso:	use
escala:	scale
edificios:	buildings
aquí:	here
calles:	streets
primeras:	first
cuyas:	whose
aquella:	that
asiento:	seat
toda:	all
lado:	side
El:	He
estaba:	was
alzaba:	raised
ritmo:	rhythm
luego:	then
avión:	plane
nubes:	clouds
oídos:	ears
idioma:	language
sus:	their
cuando:	when
entre:	between
algo:	something
sobre:	on
ya:	of
Pero:	But
bajo:	low
más:	further
para:	to
su:	are
eran:	were
como:	as
había:	there was
del:	of the
una:	a
un:	and
por:	by
se:	with
que:	what
el:	he
en:	in
la:	the
de:	of
