129
:	129
alcanzando.:	reaching.
vamos:	let's go
altitud:	altitude
licor:	liqueur
aturdido:	stunned
duermo:	I sleep
acuesto:	I lie down
visibilidad:	visibility
volaremos:	we will fly
Avisado:	Warned
aisla:	isolate
niebla:	fog
ascendemos:	we ascend
bonanza:	see them
debajo:	below
espesa:	thick
nube:	cloud
Una:	A
buitres.:	vultures.
revuelo:	stir
cayó:	fell
Lejos:	Far
viuda.:	widow.
olfato—:	smell—
deleitosamente:	delightfully
vuelve:	comes back
—dividida:	—divided
lados:	sides
cuelga:	hanging
cabellera:	hair
advertir:	warn
alzar:	raise
camina:	walk
nuestra:	our
conduce:	lead
128
:	128
cogollo.:	heart.
sacude:	shake
junto:	together
arriba:	above
jarras:	jugs
cayado.:	crook.
molinetes:	pinwheels
vecinos.:	neighbors.
invadida:	invaded
cuya:	whose
giramos:	we turn
Meseta:	Plateau
rasando:	rage
pasamos:	we passed
abajo;:	below;
quedan:	remain
copas:	glasses
fangoso.:	muddy.
ruedas:	wheels
encajar:	fit
trepidante:	trembling
inmovilidad:	immobility
seguida:	followed
explanada;:	esplanade;
extremo:	extreme
ir:	and
pensar.:	think.
estrépito:	crash
motores:	engines
mí.:	my.
detrás:	behind
cierra:	close
metálica:	metallic
seña.:	sign.
última:	last
mando:	command
cabina:	cabin
jubilosa.:	jubilant
prorrumpen:	they break out
avión.:	plane.
arranca:	starts
hablo:	speak
llamo:	called
acariciado.:	caressed
volver:	return
abrazaban:	they hugged
huyendo:	fleeing
rápido:	fast
zafa:	they died
beso:	kiss
mirarme.:	look at me
rencoroso:	rancorous
acento:	accent
llevar»:	carry"
puedes:	can
«Te:	"The
después:	after
valiosa:	valuable
esos:	those
apuntes:	notes
prueba:	proof
entrego:	I deliver
despectiva.:	derogatory
hombros:	shoulders
encogiéndose:	shrinking
responde:	respond
decidir.:	decide.
acabo:	just
explico:	I explain
ajena:	alien
imperativo.:	imperative.
hombro:	shoulder
nombrando.:	naming.
Adán:	Adam
verdadera:	true
creación:	creation
mirara:	will look
uno:	a
bastaba:	it was enough
mirara.:	would look
acababa:	ended
liberador.:	liberating.
encuentro:	meeting
hallar:	cases
mensaje:	message
parte:	part
alguna:	some
joven:	young
sabía.:	knew.
callarme:	shut up
aplauso—:	applause-
huera:	hula
sabido:	known
envanecerme:	get puffed up
Aunque:	Although
torceduras.:	sprains.
muchas:	many
música:	music
curaran:	curan
formas:	shapes
inventar:	inventory
capaz:	able
creyera:	believed
aunque:	although
respecto:	regard
toda:	all
curado:	cured
sentía:	felt
ejucutándola:	ejucutandola
entenderían:	they would understand
destinada:	intended
sería:	I would be
quienes:	who
amigos:	friends
músicos:	musicians
directores:	directors
correo:	mail
cuidado:	Careful
quedando:	staying
poblado:	populated
bajar:	lower
tocara:	will touch
Anunciación:	Annunciation
llevaría:	would take
producida:	produced
obra:	work
cuanto:	how much
necesario:	necessary
estaría:	would be
semanas:	weeks
cuatro:	four
evasión.:	evasion.
caminos:	roads
conocía:	knew
imposibles:	impossible
reclamar:	complain
divorcio:	divorce
obstaculizar:	hinder
inutilidad:	futility
comprendiera:	would understand
culpas:	blame
todas:	all
Aceptaría:	I would accept
malograda.:	ill-fated
víctima:	victim
mujer:	women
allá.:	there.
ataba:	he won't be
vínculo:	bond
rotura:	rip
deber:	duty
último:	last
cumplimiento:	compliance
exigía:	demanded
brusca;:	abrupt;
demasiado:	too much
adaptación:	adaptation
Comprendo:	Understand
divorcio.:	divorce.
pedirle:	ask
lealmente:	loyally
situación:	situation
explicarle:	explain
comunicado:	statement
haberme:	have me
enviado:	sent
regresaré:	I will return
días:	days
Dentro:	Within
común.:	common.
esfuerzo:	effort
requieren:	require
oficios:	crafts
legítimo:	legitimate
tener:	have
Adelantado.:	Advanced.
gobierna:	governs
fraile:	friar
adoctrina:	doctrine
cazador:	hunter
Caza:	Hunt
destino.:	destination.
cumplen:	they comply
Todos:	All
demás.:	others.
conocen:	they know
plena:	full
llevar:	carry
necesarias:	necessary
iré:	I will go
decisión::	decision:
repente:	suddenly
aluminio.:	aluminum.
quedaba:	remained
cabaña.:	cabin.
noches:	nights
sueño:	dream
turbaban:	they were disturbing
presencias:	presences
librarán:	will free
fibra:	fiber
esteras:	mats
envueltos:	wrapped
127
:	127
funeraria:	mortuary
jarra:	jug
sonajeras:	rattles
ritmo:	rhythm
bastón:	cane
pensando:	thinking
Curador.:	Curator.
posesión:	possession
deberían:	should
llevando:	carrying
sube:	go up
apremiarme.:	urge me
enérgicamente:	strongly
ofrecida:	offered
recompensa:	reward
apetecer:	feel like
mucho:	a lot
colocan.:	place.
ellas:	they
Perteneciente:	Belonging
de...:	of...
Cuadernos:	Notebooks
recibir:	receive
abre:	open
denegación:	denial
hongos.:	fungus.
maleta:	suitcase
llega:	arrives
eso:	that
importa.:	matters.
ocurrir:	occur
pueda:	can
todos:	all
demostrar:	demonstrate
altiva:	haughty
mirada:	look
míos:	mine
evitan:	they avoid
zozobra:	anxiety
advierte:	warns
indudable:	doubtless
dolor.:	pain.
ni:	in
angustia:	distress
disgusto:	disgust
expresa:	express
ausente:	absent
fría:	cold
aquí...:	here...
bombonas:	candy
botellas:	bottles
pomos:	snitches
hechos:	facts
libros:	books
medios:	media
expresadas:	expressed
tinta::	ink:
carecer:	lack
brasa.:	ember
asadas:	roasted
mazorcas:	cobs
roer:	stir
ceniza:	ash
limpiado:	cleaned
cuerpo:	body
simplificación:	simplification
suprema:	supreme
llegando:	arriving
innecesario:	unnecessary
lastre:	plates
aficiones:	hobbies
objetos:	objects
tiempos::	time:
prescindir:	dispense with
llegado:	arrived
palabras::	words:
resumen:	summary
carezco:	I lack
admito:	I admit
marchar:	leave
quiero:	wanna
ánimo.:	cheer up.
confusión:	confusion
ponen:	they put
vocablos:	words
vuelto:	turned
pensar:	think
Apenas:	Just
matriz:	headquarters
mente:	mind
desplaza:	move
años:	years
tantos:	so many
jorth.:	Jorath.
poema::	poem:
versos:	verses
recuerdo:	memory
despierta:	wake up
piloto.:	pilot.
habla:	speaks
espaldas:	backs
deseo:	desire
imperioso:	imperious
hará:	will do
libros.:	books.
necesidad:	need
libro:	book
viene:	he comes
escribir.:	write.
falta:	lack
Recomienza:	Restart
orquesta:	orchestra
acorde:	chord
festiva:	festive
poderosa:	powerful
denegación.:	denial.
arrancar:	start up
meseta:	plateau
suelte:	release
bruma:	Hoar
aguarda:	wait
otra:	other
amenaza:	threat
demora:	delay
marcharme:	leave
recoja:	pick up
encontrara.:	will find
dondequiera:	wherever
alcanzarme:	reach me
inaplazable:	unavoidable
convocatoria:	call
expresado:	voiced
acontecimiento:	event
suceder:	happen
emplea::	uses:
lenguaje:	language
distinto:	distinct
oigo:	I hear
infinito:	infinite
atronador.:	thunderous.
hacerse:	become
crece:	grows
cascadas:	waterfalls
ruido:	noise
aquel:	that
hablarme:	talk to me
planos:	plans
ajenos;:	aliens;
hacen:	do
paisaje:	landscape
elementos:	elements
Ciertos:	Some
mío.:	mine.
cierran:	they close
telones:	curtains
frondosos.:	leafy.
hicieron:	they did
lluvias:	rains
espesarse;:	thicken;
vuelven:	they come back
montañas:	mountains
precioso:	precious
habitado.:	inhabited.
deshabitado:	unoccupied
siento:	I feel
ablanda.:	softens
desconcierta:	baffles
ardiente:	burning
líquido:	liquid
Este:	It is
miope—.:	short-sighted—.
lentes:	glasses
sanos:	healthy
coincidir:	coincide
aciertan:	they get it right
amarillo:	yellow
litografía:	lithography
tiro:	number
movidas:	moved
planchas:	irons
esas:	those
incómodamente:	uncomfortably
superponemos:	we overlap
él:	he
estampa;:	print;
propia:	own
ajustarse:	conform
acaba:	ends
agitarse:	shake
Conservatorio.:	Conservatory.
hurtadillas:	sneaking
adolescencia:	adolescence
fumaba:	I smoked
tabaco:	tobacco
126
:	126
cigarrillos:	cigarettes
renace:	reborn
cigarrillo:	cigarette
hielo.:	ice.
vinagre:	vinegar
marisco:	seafood
apio:	celery
té:	has
apremiantes:	pressing
llamadas:	calls
paladar.:	palate.
disputan:	they dispute
ansias:	craving
aguardiente:	schnapps
tragan:	swallow
hijo:	son
impaciencia:	impatience
celosa:	jealous
beber:	to drink
quisiera:	I'd like
olvidadas.:	forgotten.
apetencias:	desires
entrañas:	bowels
llena:	full
lúcida:	lucid
embriaguez:	drunkenness
envuelve:	wraps
humedad:	humidity
licor.:	liqueur.
sorbo:	sip
probado:	tried
raudales:	rapids
tempestad:	storm
noche:	evening
beber.:	to drink.
desenrosca:	unscrew
aluminio:	aluminum
aparta:	separate
capuchino.:	cappuccino.
vendas:	sales
cuchillos:	knives
conservas:	preserves
medicamentos:	medicines
entregan:	deliver
aterrizaje:	landing
imposible:	impossible
habérseme:	have me
paracaídas:	parachute
impermeables:	waterproof
envuelto:	wrapped
bulto:	bulk
sacan:	they take out
Romanticismo.:	Romance.
Conquista:	Conquest
Medievo:	Medieval
día:	day
ciudades:	cities
presente—:	present—
fuese:	was
acá:	here
presente:	gift
identifican:	identify
época:	era
regresándose:	returning
minutos:	minutes
ochenta:	eighty
cruzarse:	cross
pueden:	they can
transcurre:	passes
año:	year
cifra:	cipher
Génesis:	Genesis
capítulo:	chapter
cuarto:	room
entre:	between
siglos:	ages
decir:	say
recta.:	straight.
línea:	line
fraguas:	forges
aún:	still
Henoch:	Enoch
admiro:	admire
buscaban.:	they were looking for
agitar:	shake
verme:	don't give
pensaron:	they thought
huella:	fingerprint
suelos:	floors
otear:	otter
viviendas:	housing
aglomeración:	agglomeration
divisar:	spot
asombraron:	they amazed
Mesetas:	Plateaus
Grandes:	Big
pasar:	market
turbonada.:	turbo nada.
esquivar:	dodge
rumbos:	directions
apartarse:	depart
tuvieron:	they had
partida:	match
abandonar:	abandon
buscar.:	look for.
cuyos:	whose
dispersión:	dispersion
área:	area
informes:	information
orientados:	oriented
fueron:	were
pilotos:	pilots
rescate.:	rescue.
cuantioso:	large
premio:	award
ofrecido:	offered
periódico:	newspaper
historia:	history
reactualizando:	updating
prensa:	press
publicados:	published
relatos:	reports
conmigo:	with me
torturado.:	tortured.
haya:	these
hipótesis:	hypothesis
insidiosa:	insidious
incluye:	includes
novela:	novel
creado:	created
sanguinarios.:	bloodthirsty
prisionero:	prisoner
estoy:	I'm
dicho:	saying
quién—:	who-
decirme:	tell me
saben:	per
Alguien:	Someone
buscando.:	searching.
aviones:	airplanes
semana:	week
estupor:	stupor
acrece:	increases
nombre.:	name.
llaman:	they call
aparato::	device:
salen:	the hall
impulso.:	impulse.
restaba:	remained
frena:	brake
oportuno:	timely
viraje:	turn
peligroso:	dangerous
rodar:	rotate
suelo;:	floor;
contacto:	contact
bajo.:	low.
cada:	each
vacilando:	hesitating
cerrada:	closed
desciende:	descends
despejar:	clear
cayado:	crook
apartarlos:	separate them
alborotando:	rioting
saltando:	jumping
temor:	fear
acuden:	they come
contagioso:	contagious
regocijo:	joy
agitando:	waving
explanada:	esplanade
centro:	center
señal.:	sign.
esperando:	waiting
buscando:	searching
Advierto:	I warn
modo:	way
titubeo:	hesitation
suerte:	luck
invención:	invention
menos:	less
patas:	paws
pájaros:	birds
paralelamente:	in parallel
redondez:	roundness
hélice:	propeller
removido:	removed
explosión;:	burst;
un.:	and.
lejanías:	distances
estas:	is
125
:	125
aferrada:	clinging
desafiante:	challenging
Indios:	Indians
Capitán:	Captain
volante:	steering wheel
máquina:	machine
separan:	separate
nuevamente;:	again;
romperse:	break
prestas:	lend
techo:	ceiling
pesado:	heavy
unos:	some
gente.:	people.
peligro:	danger
«cosa:	"What
aullan:	howl
mujeres:	women
pasmados:	stunned
miran:	another
seguido:	followed
Gobierno:	Government
umbral:	threshold
salido:	left
Neolítico.:	Neolithic.
aterrorizados:	terrified
huyen:	Huyen
regresa:	come back
gira:	tour
Bajo:	Low
volteo.:	I turn.
precipitación:	precipitation
acunado:	cradled
encima.:	on.
entra:	enter
percutiente:	striking
trueno:	thunder
fusil.:	gun.
llevaba:	wore
noche.:	evening.
arreció:	escalated
mojada.:	wet
adelante:	forward
terminó:	term
derritiendo.:	melting.
estuviera:	was
cerosa:	waxy
prisa:	hurry
pecho:	chest
escurría:	drained
pedazos:	pieces
desintegraba:	disintegrated
encarnada:	red
humano.:	human.
contorno:	contour
perdiendo:	losing
emborronando:	blurring
desdibujando:	blurring
rostro:	face
seguía:	continued
mirar::	look:
forcé:	strength
ecos:	echoes
volaban:	they flew
estampido:	stamped
rebotando:	bouncing
confundieron:	confused
disparos:	shots
Sonaron:	They sounded
derecho.:	right.
perdigones:	shot
carga:	load
izquierdo:	left
cañón:	canon
estado:	state
habías:	had
atreven:	dare
arrancó:	started
colérico:	choleric
Ejecutor.:	Executor.
iniciaría:	would start
existencia.:	existence.
deslindes:	demarcations
cipos:	cipes
muros:	walls
levantan:	they lift
siempre.:	always.
cambiar:	change
gatillo:	trigger
apretara:	will squeeze
resistía:	resisted
rapiña.:	rapine.
dejado:	left
anulado:	annulled
suprimido:	deleted
contaminándola:	contaminating it
destrozado:	destroyed
atropello:	run over
indignante:	outrageous
inmundo;:	unclean;
hombre.:	man.
Apagar:	To switch off
apagarlos.:	turn them off.
dependía:	it depended
mirando.:	looking.
seguían:	they followed
párpados:	eyelids
ahí::	there:
apuntar.:	aim.
Volví:	I returned
esto.:	this.
cura:	treatment
Más:	Further
—apremió—.:	-pressure-.
«Dispara:	«Shoot
volví:	I returned
morir.:	to die
antes:	before
confesión:	confession
pedía:	asked
Bajé:	I went down
onjejión».:	objection".
onjejión...:	objection...
«onjejión...:	"objection...
como::	as:
así:	So
ininteligible:	unintelligible
salía:	went out
gatillo.:	trigger.
hacer:	do
decidía:	decided
hundía:	sank
agujero:	hole
nivel:	level
puse:	side
Levanté:	Levant
dijo:	said
«Apunta:	«Aim
horribles:	horrible
mirándonos:	looking at us
claro:	Of course
allí:	over there
detuvo::	stopped:
rastreador:	tracker
Avanzamos:	We move forward
llovida.:	rained
maleza:	evil
abierto:	open
recién:	newly
trillo:	trill
regresar:	go back
concertábamos:	we arranged
leproso.:	leper.
dado:	given
estábamos:	we were
oscurecer:	darken
empezó:	started
Cuando:	When
tiempo.:	time.
Anduvimos:	We walked
huellas.:	footprints.
seguir:	follow
encorvado:	curved
hondamente:	deeply
marcaban:	they marked
pasas:	passes
Unos:	Some
sucias:	dirty
holladas:	trampled
estaban:	were
yerbas:	herbs
violación:	rape
Llegamos:	we arrived
manatí.:	manatee.
parecía:	it seemed
vientre:	belly
hinchado:	swollen
Veo:	I see
cabeza:	head
brazos:	arms
entonces:	so
todo.:	all.
parece:	it seems
cosa:	What
hecho:	made
buscar:	look for
vanidad:	vanity
le:	the
Venados:	Deer
Mónica:	Monica
mundo:	world
pasado:	past
vocación:	vocation
pocas:	few
todavía:	still
sí:	Yeah
digo:	I say
estar:	be
debe:	has to
quiere:	wants
expresión:	expression
cuadernos:	notebooks
tinta:	ink
expresar:	express
puedo:	I can
—el:	-he
otros:	others
siempre:	always
nuevamente:	again
trabajar:	work
Treno.:	Train.
sonoridad:	sonority
Hago:	Do
pues:	well
ellos:	they
palabras:	words
sendero:	path
otro:	other
olor:	smell
cuyo:	whose
sabores:	flavors
Desde:	From
cantimplora:	canteen
hallado:	found
arrojado:	thrown
telas:	screens
—como:	-as
oficio:	job
esperaba:	I expected
mañana:	tomorrow
musicales:	musicals
Curador:	Curator
vuelo:	flight
Un:	And
caso:	case
torno:	lathe
extraviado:	lost
allá:	there
están:	are
varios:	several
nosotros:	us
aleja:	move away
ya:	of
rebozo:	shawl
correr:	run
ello:	it
nada:	nothing
tienen:	have
repite:	repeat
primera:	first
Por:	By
años.:	years.
nubes:	clouds
está:	this
grita:	scream
mientras:	while
ambos:	both
hamaca:	hammock
pasa:	happens
fue:	was
seguidos:	followed
desde:	from
fusil:	gun
hiciera:	did
segundo:	second
miedo:	fear
hubiera:	had
hacerlo:	do it
fuerza:	force
debía:	should
aquello:	that
Aquello:	That
Dos:	Of the
palabra:	word
garganta:	throat
presión:	pressure
dedo:	finger
semblante:	countenance
ojos.:	eyes.
medio:	half
arrodillado:	kneeling
estaba:	was
señaló:	pointed out
Ya:	Of
Petroglifos:	Petroglyphs
La:	The
aquí:	here
tinta.:	ink.
idioma:	language
voz:	voice
dentro:	within
este:	it is
algunos:	some
horas:	hours
sólo:	only
hasta:	until
instrumentos:	instruments
árboles:	trees
suena:	sounds
mano:	thousand
suelo:	floor
acaso:	chance
lluvia:	rain
súbito:	sudden
todo:	all
esto:	this
tiempo:	time
tenía:	had
instante:	instant
partir:	leave
si:	and
ser:	to be
vida:	life
casi:	almost
poco:	bit
lugar:	place
Le:	The
En:	In
Ahora:	Now
tres:	three
hombre:	man
esta:	this
sido:	been
hace:	does
indios:	indians
tiene:	has
bajo:	low
cincuenta:	fifty
ciento:	hundred
Adelantado:	Advanced
hombres:	men
tal:	of
De:	Of
durante:	during
ese:	that
fuera:	out
también:	also
quien:	who
mismo:	same
gesto:	gesture
ojos:	eyes
sus:	their
cuando:	when
cosas:	things
piloto:	pilot
ahora:	now
luego:	then
pero:	but
dos:	of the
había:	there was
hacia:	toward
sobre:	on
papel:	paper
avión:	plane
mí:	my
algo:	something
Pero:	But
donde:	where
El:	He
vez:	time
más:	further
como:	as
su:	are
por:	by
para:	to
un:	and
una:	a
se:	with
del:	of the
en:	in
el:	he
la:	the
que:	what
de:	of
