134
:	134
desconcierto:	bewilderment
aumentar:	increase
divirtiendo:	having fun
aposento:	chamber
caballería.:	chivalry.
orden:	order
secretos:	secrets
callaban:	they were silent
callarse:	shut up
debían:	they had to
pruebas:	evidence
marcado:	marked
prestigios:	impressive
cuyos:	whose
arcano:	arcane
comunes;:	common;
caminos:	roads
alcanzar:	reach
tratar:	treat
inútil:	useless
asidero:	handle
pintaba:	painted
llaves.:	keys.
ciertas:	certain
posesión:	possession
requería:	required
explicación:	explanation
acá:	here
incomprensible:	incomprehensible
remoto:	remote
estupor:	stupor
imprevisto:	sudden
presentando:	presenting
secreto:	secret
saqué:	I took out
decisivo:	decisive
asestar:	deal
llegado:	arrived
enfriar.:	cool.
puestos:	positions
vinos:	wines
departamento:	department
parte:	part
dispuesta:	willing
delicada:	delicate
conclusión:	conclusion
reconfortante:	comforting
faltaría:	would be missing
previsto:	predicted
abrazo:	hug
anticipación:	anticipation
suyas:	his
lado:	side
colocadas:	placed
pantuflas:	slippers
velador:	pedestal table
mejores:	best
sábanas:	bed sheets
arreglada:	fixed
veía:	saw
abierta:	open
magnánimo.:	magnanimous.
sollozante:	sobbing
vendría:	would come
caído:	fallen
habría:	there would be
castigada:	punished
debilidad:	weakness
comprensión:	comprehension
endulzando:	sweetening
rostro:	face
aceptar.:	accept.
alguno:	some
indulgencia:	indulgence
generosa:	generous
fácil:	easy
compasión:	compassion
peligro:	danger
mirada:	look
mejor.:	better.
escucharme:	listen to me
rodillas:	knees
puso:	heart
verdad—.:	TRUE-.
moradas:	purple
tránsito:	transit
devuelta:	returned
regresara:	will return
nuevos:	new
contemplaba:	contemplated
—desde:	-from
engañosas:	misleading
amigos:	friends
perenne:	perennial
engaño:	deception
falacias:	fallacies
significaban:	they meant
desprecio:	contempt
vicios:	vices
presente:	gift
desprendimiento:	detachment
narrarle:	narrate
pasado:	past
Sigue.»:	Go on."
Sigue...:	Go on...
«Sigue...:	"Go on...
operación:	operation
queriendo:	wanting
gimiente:	moaning
estertor:	rattle
decirme:	tell me
acertaba:	was right
dibujadas:	drawn
venas:	is coming
jadeante:	panting
alfombra:	rug
desplomada:	collapsed
físico.:	physical.
impudor:	impudence
desorden:	disorder
juvenil:	youth
encontrado:	found
astrales:	astral
figuraciones:	figurations
adornado:	decorated
encuentros:	meetings
primeros:	first
hablé:	I spoke
injustificada.:	unjustified.
aparentemente:	apparently
ruptura:	rupture
acarrea:	carries
trastornos:	disorders
pereza:	laziness
cumple:	meets
deber:	duty
imagen:	image
transformado:	transformed
distante;:	distant;
buen:	good
dije:	said
detalle:	detail
hincada:	kneeling
precisa:	it needs
revelado:	revealed
añadir:	add
vindicativa:	vindictive
llevado:	carried
día.:	day.
séptimo:	seventh
fornicación:	fornication
reducida:	reduced
cuerpos:	bodies
separación:	separation
antepuesta:	anteposed
vocación:	vocation
Culpé:	Culpe
dinero.:	money.
innegable:	undeniable
abyecta:	abject
asistiera:	would attend
decir:	say
pensado:	thought
largando:	letting go
precipité:	precipitate
contenerse:	contain
podría:	could
cólera:	anger
estallido:	pop
adelantarme:	get ahead
Comprendí:	I understood
apretar:	squeeze
buscando:	searching
cabellera:	hair
hundido:	sunken
crispadas:	tense
Sus:	Their
mucho—:	a lot-
ocultaba:	hid
defecto:	flaw
dientes:	teeth
dejaba:	left
sardónica:	sardonic
mueca:	grin
inmovilizada:	immobilized
trágicas:	tragic
máscaras:	masks
yesosa:	of sauce
hecha:	made
parecía:	it seemed
palabras;:	words;
situado:	situated
instante:	instant
miraba:	looked
ridículo.:	ridiculous.
hundía:	sank
súbito:	sudden
oportunidad.:	chance.
pérfida:	perfidious
salía:	went out
silencio:	silence
evidenciado:	evidenced
quedaba:	remained
historia:	history
equívoco:	misconception
querida.:	dear.
hombre:	man
133
:	133
entera:	whole
nación:	nation
empeñado:	pawned
ironía::	irony:
malvada:	evil
vislumbrar:	glimpse
impostura.:	imposture.
vasta:	only
opinión:	opinion
atribuir:	assign
visto:	view
fuga:	leak
vengando:	avenging
está:	this
entender::	to understand:
deben:	they must
entiendan:	understand
interesados:	interested
basta:	it just is
sabiendo:	knowing
canoa:	canoe
regresando:	returning
paludismo:	malaria
derribara:	would knock down
voluntariamente:	voluntarily
abandonó:	abandonment
afirmando:	stating
Completa:	Complete
primitivos.:	primitives.
cosmogónicas:	cosmogonic
nociones:	notions
confiada:	confident
aprovecha:	take advantage
astrología:	astrology
estudiosa:	studious
presenta:	presents
relaciones.:	relations.
índole:	nature
haciendo:	doing
presencia:	presence
justificar:	justify
trata:	treats
erudición:	erudition
falsa:	false
despliegue:	deployment
pesar:	weigh
hábil:	skillful
evidentemente:	evidently
debidos:	due
ejemplos:	examples
Pitágoras:	Pythagoras
nombra:	name
indostánicos:	Hindustani
cita:	dream
movimientos;:	movements;
siete:	seven
sinfonía:	symphony
lluvia»:	rain"
especialista:	specialist
cualquier:	any
risibles:	laughable
errores:	errors
cometiendo:	committing
aterradora:	terrifying
intrepidez:	fearlessness
planetaria.:	planetary.
jerarquía:	hierarchy
escalas:	scales
relacionaron:	related
antigüedad:	antique
sabido:	known
—pues:	-well
astrológico:	astrological
enfoque:	approach
consideraba:	considered
organográfico:	organographic
primitivos:	primitives
instrumentos:	instruments
estudiaba:	I studied
mientras:	while
colaboradora:	collaborator
sorpresivo:	surprising
declaró:	declared
Esta:	This
amante.:	lover.
fuera:	out
tenida:	had
relata:	reports
autor:	author
viaje.:	journey.
revelaciones:	revelations
despreciable—:	negligible-
tabloide:	tabloid
—tomado:	-taken
artículo:	article
título:	title
escándalo.:	scandal.
explotación:	exploitation
coloquio:	colloquium
fotografía:	photograph
trozo:	piece
entrega:	delivery
encendidos:	on
violento:	violent
ademán:	gesture
decirle:	tell
pensar:	think
dándome:	giving me
cariño:	dear
gestos:	gestures
temidos:	feared
retarda:	slows down
mente:	mind
distracción:	distraction
alegro:	glad
sorpresa.:	surprise.
creciente:	growing
causa:	cause
lectura:	reading
Parece:	It seems
debajo:	below
deslizado:	slipped
vecino:	neighbor
—un:	— and
recorte:	cutout
recoger:	collect
inclinado:	inclined
entrar:	to enter
vez...:	time...
quiero:	wanna
devuelve:	returns
olor:	smell
maravillas.:	wonders.
falsas:	fake
arsenales:	arsenals
época:	era
producido:	produced
sutil:	subtle
inteligente:	intelligent
literatura:	literature
Toda:	All
muerto.:	dead.
biblioteca:	library
entrepaños:	shelves
alineados:	aligned
libros:	books
Entre:	Between
aquello.:	that.
recuperar:	recover
deseos:	wishes
tengo:	I have
ni:	in
significado:	meaning
aquí:	here
objetos:	objects
Ninguno:	None
otro.:	other.
entrara:	will enter
encontrar:	find
vuelvo:	I'm back
tiempo.:	time.
potestad:	power
arrogarse:	assume
atreviera:	dared
indignado:	indignant
casi:	almost
extrañamente:	strangely
miré:	Look
reposo»:	repose"
«Tómese:	«Take
empresa::	enterprise:
dijo:	said
aquí.:	here.
quedado:	left
esto.:	this.
ajeno:	unaffiliated
candilejas.:	footlights.
apagar:	to switch off
telón:	curtain
bajar:	lower
falta:	lack
Ayuntamiento:	City hall
salir:	go out
impresión:	impression
vestido.:	dress.
modelado:	modeling
brazo:	arm
colgada:	hung
escalinata:	staircase
descender:	descend
hombres:	men
entendidos:	understood
guiños:	winks
marchar:	leave
tribulaciones:	tribulations
crueles:	cruel
reposo:	repose
deseo:	desire
fatiga:	fatigue
persuasivamente:	persuasively
Protagonista:	Hero
juego:	game
relumbre:	glare
quitar:	remove
reiteración:	reiteration
agotarse:	run out
recursos:	resources
presiente:	present
espera.:	wait.
engrandecida:	enlarged
Griseldis:	in Griseld
lecho:	litter
hablarle:	talk to him
oyendo:	hearing
Penélope:	Penelope
Brabante:	Brabant
bodas;:	white;
ración—:	ration-
desflo:	deflo
dolor:	pain
—esta:	-this
alegría:	happiness
estremecida:	extremecidal
132
:	132
aplaudir.:	applaud.
ganas:	desire
dan:	And
dicha:	bliss
estampa:	print
ofrecerse:	offer
inteligentes:	smart
artimañas:	tricks
usando:	using
atenta:	attentive
aunque:	although
admirar:	admire
haciéndose:	making
distancias:	distances
guardar:	keep
dándose:	giving
insinuante:	insinuating
diversa:	different
matizada:	nuanced
actuación:	performance
actualidades:	news
camarógrafo:	cameraman
esbelta:	slender
próxima:	next
acompañará:	will accompany
afirma:	states
declaración:	declaration
breve:	brief
da:	and
citó:	cited
ingeniosa:	ingenious
palabra:	word
coloca:	put
sorprendido;:	surprised;
único:	single
cada:	each
íntimo:	intimate
segundo:	second
espacio:	space
contempla:	contemplate
golosina:	candy
regresa:	come back
cartera;:	briefcase;
oportuna:	timely
oblea:	wafer
hallando:	finding
importante:	important
jaqueca:	migraine
alivia:	relieve
acecha;:	stalks;
fotógrafo:	photographer
entona:	gas
inasible;:	ungraspable;
ubicua:	ubiquitous
resurgir:	resurface
desaparece:	disappears
columnas:	columns
detrás:	behind
desliza:	slide
partes;:	parts;
Está:	This
bailarina.:	ballerina.
movilidad:	mobility
ama:	or
funciones:	functions
usurpa:	usurp
mujeres:	women
demás:	others
iniciativa:	initiative
toda:	all
quitando:	removing
gravitación:	gravitation
eje:	axis
acto:	act
centro:	center
arabesco:	arabesque
inacabable:	unending
desenredando:	unraveling
enredando:	getting tangled up
vida::	life:
mejor:	better
retratos:	portraits
galería:	gallery
arañas:	spiders
observo:	noticed
Ayuntamiento.:	City hall.
encamino:	on the way
espectros:	spectra
esos:	those
Escoltado:	Escorted
decían.:	they said.
sonido:	sound
desaparecen:	disappear
trabajo:	job
área:	area
obligada:	obligatory
concurrencia:	concurrence
común:	common
práctica:	practice
nosotros:	us
estrechamente:	tightly
conviven:	coexist
olvidado::	forgotten:
venidos:	come
surgir:	to emerge
envuelven:	they wrap
confusión:	confusion
ya—.:	of—.
borracho:	drunk
—completamente:	-completely
públicas:	public
relaciones:	relations
comisionado:	commissioner
sincronización:	synchronization
finalmente:	finally
bailarina:	ballerina
cerámicas:	ceramics
pintor:	painter
ahí:	there
municipalidad:	municipality
gobierno:	government
funcionarios:	officials
Facultades;:	Faculties;
Decanos:	Deans
encabezada:	headed
delegación:	delegation
emocionado;:	thrilled;
abraza:	hug
llega:	arrives
aeródromo.:	aerodrome.
atardecer:	sunset
rotos:	broken
espejos:	mirrors
relámpagos:	lightning
cegado:	blind
Estoy:	I'm
hombro.:	shoulder.
sollozos:	sobs
prorrumpir:	break out
viste:	showed
tejido:	tissue
ligero:	light
vientre:	belly
senos:	old
contacto:	contact
reconozco:	I recognize
flancos;:	flanks;
lados:	sides
ambos:	both
uno:	a
hacen:	do
abiertos:	open
abrigos:	shelters
creada:	created
inesperada:	unexpected
busca:	search
encuentro:	meeting
acude:	come
escalerilla:	ladder
dejo:	let
Apenas:	Just
señalen:	point out
pide:	ask
culpas:	blame
acepta:	accept
librar:	librate
adversario:	adversary
peor:	worse
repudio.:	repudiation.
acallan:	silence
violencia:	violence
desarman:	disarm
humildad:	modesty
ternura:	tenderness
asistidos:	assisted
amada:	loved
quiere:	wants
ejercer:	exercise
suelen:	they usually
tiranías::	tyrannies:
combatir:	combat
habré:	there will be
Siento:	I feel
mí—.:	my-.
deserción:	desertion
brusca:	abrupt
explicaría:	would explain
—gravidez:	-pregnancy
gravidez:	pregnancy
agravarse:	get worse
venido:	come
indudable:	doubtless
remordimientos.:	regrets.
plantearé:	I will raise
treinta:	thirty
dinero:	money
Cobraré:	I will charge
relato.:	report.
veracidad:	veracity
dar:	but
antiguos:	ancient
sucedidos:	successful
indígenas:	indigenous
leyendas:	legends
refiriéndose:	referring
árboles:	trees
animales:	animals
precisan:	they need
suramericano:	south american
escritor:	writer
famosa:	famous
maleta:	suitcase
encontraron.:	they found.
«misión»:	"mission"
llegué:	I arrived
hambriento:	hungry
kilómetros:	kilometers
131
:	131
atravesando:	passing through
fugarme:	run away
logré:	I managed
desconfiada:	suspicious
tribmás:	tribmore
prisionero:	prisoner
viaje::	journey:
patraña:	humbug
venderé:	I will sell
cosas.:	things.
muchas:	many
callarme:	shut up
curiosidad:	curiosity
inspiran:	inspire
misiones:	missions
plantado:	planted
fraile:	friar
apartado:	apart
«misión:	"mission
llamar:	call
hábito:	habit
reportes:	reports
refirieron:	they referred
hallaron:	they found
pilotos:	pilots
Mesetas.:	Plateaus.
rumbo:	course
visitantes:	visitors
peores:	worst
poner:	put
equivaldría:	would be equivalent
ello:	it
tenido:	had
maravilloso:	marvelous
revelar:	reveal
efecto:	effect
ahora—.:	now-.
vender:	sell
cuartillas:	quarters
cincuenta:	fifty
—ya:	—of
innumerables:	countless
exclusividad:	exclusiveness
reservarle:	reserve
ofrecida:	offered
acepté:	I accepted
Ese:	That
meses.:	months.
dominical:	Sunday
rito:	here
rutinario:	routine
última:	last
acoplado:	coupled
posibilidades:	possibilities
dentro:	within
desventura:	misfortune
ultimo:	last
Esto:	This
dicho:	saying
preguntándome:	wondering
suspenso:	suspended
pulso:	pulse
quedé:	I stayed
emergido:	emerged
inteligible:	intelligible
mentalmente:	mentally
oír:	hear
parasitarios:	parasitic
sonidos:	sounds
entrecortada:	choppy
confusa:	confused
despedida:	farewell
tomaría:	would take
permaneciera:	would remain
grité:	I screamed
rogativas:	prayers
incluían:	included
hispánicas:	hispanic
difícil:	difficult
sumamente:	extremely
evasión:	evasion
antesala:	anteroom
terreno:	land
traería:	would bring
propósito:	purpose
Aterrado:	Grounded
conmigo.:	with me.
reunirse:	meet up
tomar:	take
abandonado:	abandoned
expresiones:	expressions
fueron:	were
decirme.:	tell me
entendí:	understood
apenas:	just
tanta:	so much
reía:	laughed
Lloraba:	I cried
teléfono.:	telephone.
voz:	voice
llegó:	arrive
hemisferio:	hemisphere
extremo:	extreme
venida:	coming
Kappelmeister:	Bandmaster
velado:	veiled
habíamos:	we had
Estaba:	Was
embuste.:	scam.
pista:	track
arrumba:	rumba
vuelo:	flight
embustero.:	liar.
aplaudir:	applaud
ignoran:	they ignore
aplaudirme:	applaud me
disponen:	they have
mías.:	mine
pendientes:	earrings
orbe:	the world
ciernen:	hover
guerras:	wars
capaces:	capable
sido:	been
humanos:	humans
seres:	beings
Millones:	Millions
cornadas.:	gored.
recibir:	receive
toreo:	bullfighting
albur:	dace
reglas:	rules
riesgos:	risks
incluye:	includes
elegido:	elected
libremente:	freely
desempeño:	performance
bárbaros:	barbarians
cautivo:	captive
haberse:	have
pueda:	can
cazador:	hunter
etnógrafo:	ethnographer
explorador:	explorer
pensando:	thinking
sufre:	suffer
enternece:	internecially
planchas:	irons
hacinados:	overcrowded
niños:	children
estamos:	we are
cuales:	which
ésos:	those
—como:	-as
ciertos:	some
espectáculo:	show
fríamente:	coldly
soportar:	endure
capaz:	able
sobrecoge:	overwhelms
entera.:	whole.
familias:	families
varias:	several
holgada:	baggy
existencia:	existence
país:	country
costado:	side
irritado.:	irritated.
avergonzado:	ashamed
sacarme:	take me out
enterando:	finding out
evoquen:	evoke
Ana:	Well
Crónica:	Chronicle
Pequeña:	Small
vean:	see
normas:	norms
infringir:	infringe
excusa:	excuse
talento:	talent
hallarse:	be
arte:	until
regazo:	lap
torna:	returns
científica:	scientific
investigación:	investigation
mártir:	martyr
mí::	my:
refieren:	refer
artículos:	articles
tras:	after
persistente:	persistent
temática:	thematic
ejemplar.:	copy.
lectores:	readers
presentarme:	introduce myself
empeña:	pawn
familia:	family
congraciarse:	ingratiate
dado:	given
aviadores:	aviators
premiar:	reward
acaba:	ends
generosamente:	generously
sobremanera::	exceedingly:
irrita:	irritates
130
:	130
conyugal.:	conjugal.
cuadro:	chart
plácido:	placid
trazado:	having sex
mimetismo-mágico-rítmico:	magic-rhythmic mimicry
absurda:	absurd
teoría:	theory
elogios:	compliments
grandes:	big
á:	on
explicó:	explained
soldados:	soldiers
otra:	other
ruinas:	ruins
uniforme:	uniform
Jesús:	Jesus
regañadientes—:	reluctant—
aceptada:	accepted
incluso:	even
publicadas:	published
pasaron:	bird
fotografías:	photographs
Todas:	All
nacional.:	national.
interés:	interest
víspera:	eve
ignorada:	ignored
desaparición:	disappearance
actualidad:	present
figura:	figure
patética:	pathetic
siguiente:	following
mañana:	tomorrow
destino.:	destination.
geográfica:	geographical
zona:	area
señalado:	indicated
inexplorada:	unexplored
hallara:	to cases
premio:	award
dando:	giving
exigiera:	demanded
pidió:	asked
colmo:	full
luego—:	then-
sanguinarias:	bloodthirsty
tribus:	three
cautivos:	captives
sabios:	wise
viajeros:	travelers
exploradores:	explorers
figuras:	figures
evocaron:	evoked
mí.:	my.
inquieto:	restless
realmente:	really
tarde—:	afternoon—
verla:	see it
fuere:	was
—quien:	-who
comienzos:	beginnings
regreso:	return
mías:	mine
tenían:	they had
revelando:	revealing
diario:	diary
redacción:	wording
directamente:	directly
diálogo:	dialogue
iniciar:	start
saliendo:	leaving
réplica:	replica
sollozar:	sob
Rompió:	Broke
corazonada.:	hunch.
tuvo:	had
cuentan—:	count—
escena:	scene
estando:	standing
Curador.:	Curator.
dramática:	dramatic
expresión:	expression
mapa:	map
mirando:	looking
Organográfico:	Organographic
vitrinas:	showcases
silueta:	silhouette
irguiendo:	erecting
periodistas:	journalists
aparece:	appears
publicaciones:	publications
recortes:	clippings
mostraron:	showed
envidiarme::	envy me:
atracción:	attraction
fui:	I went
rodea:	surrounds
contrasentido:	contradiction
Para:	To
desarrollarse.:	develop.
tendrán:	they will have
Treno:	Train
apuntes:	notes
aguarda:	wait
mujer:	women
Venados:	Deer
preparando:	preparing
creía:	believed
jamás:	never
humos:	fumes
novedad:	novelty
esposa.:	wife.
papel::	paper:
interpretar:	interpret
dejado:	left
clima.:	climate.
cronologías:	chronologies
escaparon:	they escaped
semanas:	weeks
inmensas:	immense
dilatación:	dilatation
pasmosa:	astonishing
vivido:	vivid
uso:	use
calendarios:	calendars
cálculo:	calculation
dejé:	I left
opresión:	oppression
angustiosa:	distressing
acerco:	approach
alegran:	they rejoice
Mientras:	While
ventanillas.:	windows.
cristales:	crystals
índices:	indexes
paseando:	strolling
luminosas:	luminous
geometrías:	geometries
ubicar:	locate
divierten:	have fun
Algunos:	Some
encenderse.:	light.
empiezan:	they start
luces:	lights
cuyas:	whose
crepúsculo:	dusk
hallar:	cases
claridades:	clarities
humo—:	in it—
colosos:	colossi
carcomidos:	eaten away
obeliscos:	obelisks
truncos:	trunks
arcos:	bows
través:	through
nubes:	clouds
espesor:	thickness
manso:	meek
atravesar:	cross
Acabamos:	We're done
sueños:	dreams
viviendo.:	living.
empezar:	begin
acabar:	end
SEXTO:	SIXTH
CAPITULO:	CHAPTER
engañados:	deceived
Le:	The
cómo:	as
golpe:	blow
debía:	should
habían:	had
aspecto:	aspect
nuestras:	our
indios:	indians
punto:	point
modo:	way
Su:	They are
conocido:	acquaintance
periodista:	journalist
tenía:	had
esto:	this
alguna:	some
días:	days
después:	after
segunda:	second
cerca:	fence
alguien:	someone
mano:	thousand
gesto:	gesture
recepción:	reception
dejar:	leave
tantos:	so many
rostros:	faces
muchos:	many
lejos:	far
veo:	I see
aturdimiento:	daze
empresa:	enterprise
presidente:	president
estudio:	study
varios:	several
nuestros:	our
intimidad:	privacy
fuerza:	force
acercarse:	approach
necesidad:	need
años:	years
unos:	some
nombres:	names
novela:	novel
Tengo:	Have
centenares:	hundreds
pues:	well
público:	public
misión:	mission
Por:	By
puedo:	I can
suma:	addition
puesto:	position
mía:	tight
conversación:	conversation
repasando:	reviewing
creí:	I believed
sería:	I would be
leyes:	laws
divorcio:	divorce
allí:	over there
misma:	same
junto:	together
siempre:	always
allá:	there
otro:	other
hacia:	toward
Porque:	Why
olvidar:	forget
han:	he
extraviado:	lost
pero:	but
absurdo:	absurd
caso:	case
asegurar:	ensure
necesario:	necessary
verdadera:	true
siento:	I feel
Cuando:	When
apacible:	gentle
conyugal;:	conjugal;
virtud:	virtue
también:	also
prosa:	prose
personaje:	character
hogar:	home
hermoso:	beautiful
tanto:	both
prensa:	press
frente:	forehead
comunión:	communion
primera:	first
noticia:	news
emoción:	emotion
aquella:	that
noticias:	news
Una:	A
apartamento:	apartment
bien:	GOOD
rodeada:	surrounded
todos:	all
gente:	people
Mónica:	Monica
suburbios:	suburbs
volando:	flying
tremenda:	tremendous
seis:	six
según:	according to
medio:	half
mundo:	world
llegar:	arrive
otros:	others
tantas:	so many
entre:	between
abajo:	below
día:	day
todavía:	still
cual:	which
nacer:	be born
ojos:	eyes
habla:	speaks
conyugal:	conjugal
viene:	he comes
cuerpo:	body
antes:	before
perdón:	sorry
esta:	this
durante:	during
sólo:	only
suerte:	luck
mentiras:	lies
momento:	moment
menos:	less
si:	and
hubiera:	had
cuanto:	how much
avión:	plane
De:	Of
tiempo:	time
oficio:	job
En:	In
puede:	can
hacía:	toward
Curador:	Curator
lugar:	place
desde:	from
noche:	evening
nuestra:	our
parece:	it seems
viaje:	journey
tiene:	has
realidad:	reality
ese:	that
vivir:	live
llamáis:	you call
Mouche:	Fly
palabras:	words
todas:	all
acerca:	about
iba:	others
quería:	wanted to
bajo:	low
demasiado:	too much
muy:	very
Pero:	But
rescate:	rescue
poco:	bit
hecho:	made
morir:	to die
luego:	then
le:	the
algo:	something
El:	He
estaba:	was
fue:	was
quien:	who
estar:	be
vez:	time
papel:	paper
ahora:	now
vida:	life
periódico:	newspaper
teatro:	theater
este:	it is
cuando:	when
hace:	does
ya:	of
esposa:	wife
mí:	my
ser:	to be
todo:	all
donde:	where
sobre:	on
había:	there was
más:	further
sus:	their
como:	as
para:	to
su:	are
por:	by
se:	with
un:	and
del:	of the
una:	a
en:	in
el:	he
la:	the
que:	what
de:	of
