137
:	137
erizados:	bristling
fetiches:	fetishes
africanos:	Africans
máscaras:	masks
blandían:	the mixture
quienes:	who
intento:	tried
risible:	laughable
resultaba:	it turned out
razón.:	reason.
debieran:	should
fervores:	fervor
fomento:	promotion
savias:	swordfish
nuevas:	new
rejuvenecerse:	rejuvenate
tratado:	treated
cansada:	tired
cultura:	culture
veinte:	twenty
Durante:	During
primitivos—.:	primitives—.
ritmos:	rhythms
fuerza:	force
batería:	battery
instrumentos:	instruments
abuso:	abuse
generación:	generation
compositores:	composers
numerosos:	numerous
buscar:	look for
instintivas:	instinctive
energías:	energies
añoranza:	yearning
misma:	same
perdida:	lost
elocuencia:	eloquence
secreto:	secret
pintores:	painters
muchos:	many
interrogaban:	they interrogated
eran:	were
terribles:	terrible
enigmáticos:	enigmatic
rostros:	faces
adoradores:	worshipers
tener:	have
sentido:	sense
vaciados:	emptied
difuntos:	deceased
ídolos:	idols
exhiben:	exhibit
pintura:	paint
galería:	gallery
vitrina:	showcase
detengo:	I stop
públicas.:	public.
plazas:	places
bosta:	they will be
ennoblecidos:	ennobled
zócalos:	sockets
magistralmente:	masterfully
vacas:	cows
cubriendo:	covering
celo:	even
grandes:	big
fueran:	were
monumentos:	monuments
gentes:	people
estas:	is
soñando:	ringing
vez:	time
otra:	other
Estoy:	I'm
apisonar—.:	अपिसोनार—.
tiene:	has
tristeza:	sadness
comunica:	communicate
seda:	this
barreras:	barriers
exasperados:	exasperated
contactos:	contacts
objeto:	object
abrazos:	hugs
estrechez:	narrowness
propiciando:	enabling
apagan:	turn off
rítmicos.:	rhythmic.
valores:	values
meros:	heritage
reducido:	reduced
compás:	compass
desde:	from
movida:	moved
especie:	species
ingredientes:	ingredients
confundidos:	confused
encajados:	embedded
otros:	others
metidos:	stuck up
cuerpos:	bodies
intríngulis:	intrigued
pista:	track
rodea.:	surrounds
gente:	people
observo:	noticed
Reconocido:	Recognized
filtraciones.:	leaks.
hongos:	fungus
irregularmente:	irregularly
caverna:	cave
bóveda:	vault
remeda:	remedy
raso:	satin
burgués»—.:	bourgeois"-.
«espíritu:	"spirit
llamaba:	called
reacción:	reaction
reciente:	recent
todavía:	still
fecha:	date
fiel:	fell
fuera:	out
—aunque:	-although
rancios:	stale
locura:	craziness
elogios:	compliments
puesto:	position
nada—:	nothing-
—muniqueses:	—muniques
rococós:	rococo
castillos:	castles
panorámicas:	panoramic
vistas:	views
fondo:	bottom
traje:	lasts
Hornig:	Horny
cochero:	coachman
Baviera:	Bavaria
agrandadas:	enlarged
fotografías:	photographs
poco:	bit
gruta:	cave
mármol.:	marble.
mano:	thousand
dedo:	finger
pasar:	market
intermitentemente:	intermittently
rozados:	rubbed
pezones:	nipples
giratorio:	rotary
montados:	mounted
senos:	old
consiste:	consists
móvil:	mobile
anatómicas:	anatomical
planchas:	irons
hipocampos:	hippocampi
cabezas:	heads
encierran:	enclose
iluminadas:	illuminated
grutas:	caves
pequeñas:	small
ahondan:	they delve
trozos:	pieces
estuco:	stucco
construcción:	construction
montado:	mounted
está:	this
orquesta:	orchestra
estrado:	platform
astrágalo.:	astragalus.
haciendo:	doing
negras:	black
vestidas:	dressed
griego:	Greek
cornisa:	cornice
caracol:	snail
clepsidra:	hourglass
metrónomo:	metronome
allá:	there
Más:	Further
hormigas:	ants
comido:	eaten
abierto:	open
costillar:	rib
exangüe:	bloodless
Gorgona:	Gorgon
presencia:	presence
ignorar:	ignore
parecen:	they seem
desollados:	skinned
desesperanza:	hopelessness
agobiados:	overwhelmed
planos:	plans
primeros:	first
pétreos:	stony
falos:	will fall
sostienen:	hold
muletas:	crutches
ciclistas:	cyclists
bicicletas:	bicycles
arcos:	bows
osamentas:	bones
áridas:	arid
llanuras:	plains
escenografías:	scenery
pintado:	painted
sótano:	basement
divertirse:	enjoy
quieren:	they want
Sigo:	I continue
góticos.:	goths.
caracteres:	characters
luminosa:	bright
enseña:	teaches
beber:	to drink
veníamos:	we came
tantas:	so many
lugar:	place
Venusberg:	Venus mountain
precisamente:	precisely
llegado:	arrived
próximo:	next
fatigados:	fatigued
tristes:	sad
desamparados:	helpless
licor:	liqueur
aturdimiento:	daze
danzas:	dances
estrépito:	crash
hora—:	time—
esta:	this
antes:	before
—como:	-as
fuguen:	the fugue
menos:	less
vivido:	vivid
será:	it will be
tampoco:	neither
mañana:	tomorrow
vivir:	live
fuerzas:	forces
repondrán:	will replenish
vivirlo:	live it
Vivieron:	They lived
nutricias.:	nutricies.
empresas:	companies
vendieron:	they sold
extenuados:	exhausted
salen:	the hall
ahogar:	drown
acabará:	will end
circundante:	surrounding
anteriores:	previous
culturas:	cultures
retazos:	scraps
hechas:	made
fachadas:	facades
136
:	136
perdido:	lost
encrespamiento:	inking
ocurrencia:	occurrence
Una:	A
estilo.:	style.
nuevos:	new
sustituirlos:	replace them
abandonado:	abandoned
arquitectura:	architecture
secarse:	dry up
acaban:	end
Renacimiento:	Renaissance
acantos:	acanthus
siglo:	century
ejecutados:	executed
clásicos:	classics
entablamentos:	entablatures
agonizantes:	dying
edificios:	buildings
enfermas:	sick
partes:	parts
tenidas:	had
cubierta:	deck
encuentro:	meeting
vivienda.:	dwelling.
entrada:	Prohibited
familia:	family
jefe:	boss
colgaba:	hung
coagulada:	coagulated
pringoso:	catch
caza:	hunting
trofeo:	trophy
figuración:	figuration
edades:	ages
noche:	evening
traído:	brought
ornamento:	ornament
probablemente:	probably
aplicado:	applied
arquitecto:	architect
algún:	some
dibujado:	drawn
habrá:	there will be
bucráneo:	bucranium
triglifos:	triglyphs
antiguo::	ancient:
asienta:	nods
pública:	public
biblioteca:	library
aquella:	that
Alzo:	I get up
implicaciones.:	implications.
medido:	measured
alcance:	range
prácticas:	practices
luciferada:	luciferated
propiciatoria:	propitiatory
percusión:	percussion
velado:	veiled
espejo:	mirror
reto:	challenge
alianza:	alliance
gaje:	grows
yerbas:	herbs
baño:	bathroom
enmascarado:	masked
vivienda:	dwelling
purificación:	purification
tumba:	grave
desconozca::	don't know:
cambio:	change
regresaré:	I will return
mundo:	world
siglos.:	ages.
cuarenta:	forty
hablar:	talk
dejaron:	they left
inscripciones:	registrations
cubiertos:	covered
desconocido:	a stranger
uso:	use
objetos:	objects
recoger:	collect
reflejo:	reflection
automatismo:	automatism
reducidas:	reduced
olvidado:	forgotten
tradiciones:	traditions
conservar:	keep
orgullo:	pride
ponen:	they put
acá:	here
enjoyaron.:	they bejeweled
árbol:	tree
almendra:	almond
qué:	that
guirnaldas:	garlands
abeto:	fir
cubren:	cover
bautismo:	baptism
almendras:	almonds
llevan:	they carry
Epifanía:	Epiphany
Buscan:	They search
gestos.:	gestures.
propios:	own
milenaria:	millennial
simbólica:	symbolic
ignorantes:	ignorant
cabeza:	head
arroz:	rice
puñados:	handfuls
reciben:	receive
anillos:	rings
intercambian:	they exchange
casan:	feet
Cuando:	When
hacen.:	do.
propia:	own
misterio:	mystery
asisten:	assistant
inconsciencia:	unconsciousness
advierto:	I warn
ignoran:	they ignore
lengua:	language
canta:	sing
congregados:	congregants
forasteros:	outsiders
extraños:	strangers
percatarme:	notice
acompaña.:	accompanies
muerto:	dead
escucharse:	listen
escucha:	listen
hombres::	men:
mayoría:	most
ser:	to be
añade:	duck
texto:	text
ininteligibilidad:	unintelligibility
nostri.:	our.
Dei:	Of the
atris:	black
—plantatus:	- planted
multiplicatur::	is multiplied:
Libani:	Lebanon
cedrus:	cedar
—
Sicut:	-
Like
florebit::	will bloom
gregoriano::	Gregorian:
Ya:	Of
muertas.:	dead
repleto:	full
foso:	pit
ensancha:	widens
fieles:	faithful
Entre:	Between
malentendido.:	misunderstanding.
creciente:	growing
teatro:	theater
representación:	representation
esto:	this
inútil:	useless
escuelas:	schools
arrojado:	thrown
sido:	been
latín:	Latin
ajena.:	foreign
prosa:	prose
belleza:	beauty
La:	The
sacerdote.:	priest.
entiende:	understand
nocturno:	night
oficio:	job
congregado:	congregated
nadie:	nobody
cirios::	candles:
amarillor:	yellower
refleja:	reflects
oficiante:	officiant
vueltas:	turns
caras:	guys
deambulatorio.:	ambulatory
bóvedas:	vaults
litúrgicos:	liturgical
latines:	Latin
resuenan:	resonate
ecos:	echoes
profundos:	deep
órgano.:	organ.
notas:	notes
invitan:	invite
incienso:	incense
ahumadas:	smoked
penumbras:	shadows
Llego:	Arrive
dormido:	asleep
borracho:	drunk
zapatos:	shoes
frío:	cold
tiembla:	trembles
perro:	dog
socavón:	sinkhole
comprada;:	purchased;
recién:	newly
prueba:	proof
raído:	raido
gabán:	overcoat
envuelto:	wrapped
ladrillo:	brick
garita:	sentry box
gravidez:	pregnancy
estado:	state
avanzado:	advanced
hornacina:	niche
paradas.:	stops.
momias:	mummies
aturdidos:	stunned
seres:	beings
soldadas:	welded
escaparates:	escapes
suelen:	they usually
resguardados:	sheltered
espacios:	spaces
angostos:	narrow
entonces:	so
Descubro:	I find out
prisa.:	hurry.
tienen:	have
inválidos:	invalid
indulgencia:	indulgence
zona:	area
así:	So
existe:	exists
135
:	135
comercios:	shops
vitrinas:	showcases
pegado:	glued
lentamente:	slowly
progresar:	to progress
leyes:	laws
ajustarme:	adjust
logro:	achievement
semáforo.:	traffic light.
semáforo:	traffic light
agitación:	agitation
restablece:	resets
pero:	but
reinante;:	reigning;
prisa:	hurry
parece:	it seems
pulsación:	pulsation
constancia:	constancy
minutos:	minutes
tantos:	so many
cada:	each
tranvía:	tram
bocas:	mouths
multitud:	crew
cruzar:	cross
permite:	allows
encenderse:	light
esquina:	corner
llegar:	arrive
fija:	fixed
corresponde:	corresponds
porque:	why
otro:	other
tal:	of
andan:	from the moment
Si:	And
orgánicas.:	organic.
voluntades:	wills
ajeno:	unaffiliated
llevando:	carrying
acera:	pavement
ancha:	much
cruzan:	cross
vienen:	they come
rodean:	surround
descubrir:	discover
asombro:	astonishment
respiración:	breathing
costumbre:	habit
adquirido:	acquired
tarde):	late)
(Más:	(Further
peldaños:	steps
escaleras.:	stairs.
bajé:	I went down
necesitado:	needy
Cansado:	Tired
sí.:	Yeah.
detrás:	behind
cerrando:	closing
esfuerzo:	effort
levantó:	rose
remoto;:	remote;
contemplar:	contemplate
ojos:	eyes
fijó:	fixed
calmada:	calm
Luego:	Then
gemidos.:	moans.
marcaban:	they marked
venidos:	come
sollozos:	sobs
adolorida:	sore
mirarme:	look at me
infantil:	children's
humilde:	humble
modo:	way
llorar:	cry
rompió:	broke
avilantez:	degrade
defenderla:	defend her
entrañas:	bowels
naciendo:	being born
estaba:	was
le:	the
vida:	life
doblándose:	bending
desolado:	bleak
propio:	own
abrazó:	hug
Temis:	It was
momento:	moment
embarazo.:	pregnancy.
cierto:	TRUE
pregunté:	I asked
Le:	The
Justicia.:	Justice.
encarnación:	incarnation
Poder:	Can
alfombra:	rug
plantada:	planted
femenina:	feminine
majestuosa:	majestic
estatua:	the state
Parecía:	It seemed
Átala.:	Atala.
ridiculizante:	ridiculous
término:	term
designaba:	designated
vivía:	lived
impedir:	prevent
embrolladas:	muddled
tramitaciones:	procedures
pérfidos:	perfidious
legales:	legal
lazos:	ties
confundiría:	would confuse
sinuosos:	sinuous
enredados:	tangled
llevaría:	would take
atado:	tied
tenerme:	have me
medios:	media
tenía:	had
advirtió:	warned
modelarla:	with models
vestido:	dress
negrura:	blackness
atiesada:	Atisara
acusadora:	accuser
actitud:	attitude
inmovilizada:	immobilized
Helada:	Frost
fiscales.:	prosecutors.
abogados:	lawyers
tribunales:	courts
Su:	They are
esposa:	wife
registro:	record
bajó:	low
cayeron:	they fell
paroxismo...:	paroxysm...
ascendía:	ascended
monólogo:	monologue
alivio:	relief
hallaron:	they found
furia:	rage
dolor:	pain
viviendo:	living
escena:	scene
lacerarse:	lacerate
aplazados:	postponed
siempre:	always
deseos:	wishes
papel:	paper
atadura:	tie
dramáticas:	dramatic
inhibiciones:	inhibitions
Sospecho:	I suspect
justeza.:	fairness.
patética:	pathetic
apoyando:	supporting
inmóvil:	still
cuerpo:	body
delgados:	thin
gestos:	gestures
gestos::	gestures:
fueron:	were
impresionó:	impressed
escenario.:	scenery.
hora:	time
durante:	during
dijo:	said
podría:	could
mí.:	my.
alzó:	raised
trágica:	tragic
Entonces:	So
inquebrantable.:	unwavering.
decisión:	decision
expone:	exposes
quien:	who
alterado:	changed
resuelto:	resolved
tono:	application
enojo:	anger
varias:	several
repetí:	I repeated
comprender:	grasp
parecía:	it seemed
palabra:	word
caer:	fall
dejé:	I left
repente:	suddenly
atención.:	attention.
escuchar:	listen
colocó:	placed
peligro:	danger
amenazada:	threatened
viéndose:	seeing each other
asentado:	settled
firme:	firm
sonido:	sound
daba:	after
invención:	invention
distensión:	distension
serpiente.:	snake.
hecho:	made
hubiera:	had
Gavilán:	Hawk
rastreada:	tracked
Terrenal:	Earthly
Paraíso:	Paradise
decoración:	decoration
torno:	lathe
plantando:	planting
prestaban:	they lent
hallar:	cases
oscuridad:	darkness
El:	He
piernas:	legs
Mouche:	Fly
hacía:	toward
cemento:	cement
han:	he
órdenes:	orders
últimos:	last
columnas:	columns
templo:	temple
significado:	meaning
cuyo:	whose
hace:	does
luces:	lights
haba:	length
mujeres:	women
música:	music
presentes:	gifts
año:	year
veo:	I see
Ahora:	Now
este:	it is
bajo:	low
mujer:	women
suerte:	luck
descansan:	they rest
hallarse:	be
ancianos:	seniors
movimiento:	motion
subterráneo:	underground
andar:	to walk
Como:	As
leves:	light
casi:	almost
gesto:	gesture
vientre:	belly
si:	and
apenas:	just
regreso:	return
caminos:	roads
dejado:	left
había:	there was
hizo:	those
Pero:	But
aquel:	that
años:	years
palabras:	words
yeso:	and so
habitación:	room
recordar:	remember
divorcio:	divorce
De:	Of
frente:	forehead
voz:	voice
dentro:	within
mismo:	same
mí:	my
ciertos:	some
cuyos:	whose
día:	day
ni:	in
todo:	all
hacia:	toward
cuyas:	whose
unos:	some
dos:	of the
colectivo:	collective
ya:	of
aún:	still
ritmo:	rhythm
idioma:	language
todas:	all
semblante:	countenance
brazos:	arms
nada:	nothing
ruinas:	ruins
medio:	half
aquí:	here
entre:	between
hombres:	men
ese:	that
tiempo:	time
fue:	was
donde:	where
muy:	very
les:	THE
algo:	something
veces:	times
En:	In
ahora:	now
su:	are
sobre:	on
sus:	their
para:	to
como:	as
del:	of the
más:	further
por:	by
una:	a
se:	with
un:	and
el:	he
en:	in
la:	the
que:	what
de:	of
