27
:	27
cuerpos:	bodies
puesto:	position
vencedor:	winner
contempladas:	covered
ruinas:	ruins
muerte.:	death.
muerte:	death
ello:	it
incomprensibles:	incomprehensible
fueran:	were
pasiones:	passions
moría:	died
países:	countries
Si:	And
abyectos.:	abject
parecieron:	they seemed
Ahora:	Now
dril.:	drill.
claridad:	clarity
marchamos:	we leave
nuevos:	new
poniendo:	putting
todavía:	still
encajaban:	they fit
enrojecido:	flushed
yacente:	recumbent
quitar:	remove
poder:	can
retrocedimos:	we went back
Todos:	All
vientre.:	belly.
llevando:	carrying
grito:	shout
metralla.:	shrapnel.
pase:	than
vientre:	belly
alcanzados:	reached
repente:	suddenly
doblaron:	they folded
delante:	in front of
marchaban:	they marched
dos:	of the
empaque.:	packing.
marcial:	martial
hicimos:	we did
chaquetas:	jackets
conservado:	conserved
terciadas.:	tertiated.
mausers:	mousers
armados:	armed
después:	after
vimos:	we saw
desaparecido.:	missing.
mozos:	guys
supimos:	we knew
siempre:	always
mestizos:	mestizo
estados:	states
rezongando:	grumbling
copas:	glasses
dados:	data
naipes:	suits
partidas:	matches
malhumoradas:	bad-tempered
armado:	armed
forasteros:	outsiders
todos:	all
trastornaban:	upset
grandemente:	greatly
irritó:	irritated
forzoso:	forced
encierro:	confinement
perspectiva:	perspective
ingrata:	ungrateful
quedaban.:	were left.
turpiales:	disgraceful
bandazo:	lurch
aplastando:	crushing
brutalmente:	brutally
frenaban:	they braked
conductores:	drivers
amontonadas:	piled up
obstáculo:	obstacle
falso:	false
pleno:	full
cayendo:	falling
numerosas:	numerous
pasaban:	they passed
ambulancias:	ambulances
sirenas:	mermaids
sacada:	balcony
angustiada:	distressed
apareció:	appeared
emblema:	emblem
pendones:	banners
Oficio:	Job
convivir:	live together
acostumbrados:	accustomed
estamos:	we are
tradición:	tradition
nosotros:	us
piense:	think
calma—;:	calm-;
aceptar:	accept
chapado:	stoned
levita:	elevated
abogado:	lawyer
respondía:	responded
justo:	fair
«Muy:	"Very
distintos.:	distinct.
siglos:	ages
vivieran:	they would live
gentes:	people
librada:	delivered
batalla:	battle
criterios:	criteria
cronológico:	chronological
desajuste:	maladjustment
representaban:	they represented
conservadora:	conservative
avanzada:	advanced
tendencia:	trend
representar:	represent
pugnas:	you fight
religión.:	religion.
asemejaba:	resembled
caía:	fell
época:	era
político:	political
conflicto:	conflict
razonar:	reason
manera:	manner
según:	according to
acercaba:	approached
unida.:	united.
gente:	people
entablada:	planked
enemigos:	enemies
hermanos:	siblings
querella:	complaint
ruedo:	arena
aspecto:	aspect
historias:	stories
relación:	relationship
ignorancia:	ignorance
devuelto:	returned
Cada:	Each
partidos.:	parties.
fuese:	was
ocurría:	it happened
apellidos:	surnames
citarse:	quote
volvían:	they came back
posiciones:	positions
invertidas:	inverted
quedaban:	were left
barajaba:	shuffled
católicos:	Catholics
comunistas:	communists
radicales:	radicals
conservadores:	conservatives
socialistas:	socialists
trataba:	tried
creía:	believed
claridad.:	clarity.
pugna:	fight
bandos:	flocks
anhelos:	desires
tendencias:	tendencies
conocer:	know
Traté:	I tried
muerta:	dead
letra:	letter
personalidades:	personalities
nombres:	names
citando:	quoting
versión:	version
daba:	after
cual:	which
observé:	observed
información.:	information.
tener:	have
acalorarse:	heat
comentar:	comment
cuantos:	how many
interrogar:	question
puse:	side
pobladores.:	settlers.
primitivos:	primitives
musicales:	musicals
hablado:	spoken
frailes:	friars
algunos:	some
viajes:	trips
Conquista:	Conquest
Descubrimiento:	Discovery
ajeno:	unaffiliated
historia:	history
significaba:	meant
esto:	this
26
:	26
revolución.:	revolution.
hablaba:	spoke
explicaciones.:	explanations.
bajé:	I went down
respectaba:	I respected
cuanto:	how much
Tranquilizado:	Reassured
sábanas.:	bed sheets.
enredados:	tangled
caderas:	hips
camisa:	shirt
almohada:	pillow
abrazada:	hugged
durmiendo:	sleeping
seguía:	continued
habitación.:	room.
nuestra:	our
Subí:	I went up
calentándose:	warming up
desierta:	deserted
permanecía:	remained
guacamayo:	macaw
soberbio:	superb
abandonado:	abandoned
velocípedo:	velocipede
manubrio:	handlebar
erguido:	erected
Detrás:	Behind
protección.:	protection.
acogerse:	embrace
queriendo:	wanting
saltando:	jumping
venía:	permission
arrastraba:	dragged
tucán:	toucan
abierta.:	open.
permanecido:	remained
acabé:	I finished
empavorecidas:	terrified
cotorras:	parrots
posaderos:	innkeepers
derribando:	knocking down
colibríes:	hummingbirds
pateando:	kicking
canarios:	canaries
atropellando:	running over
Saltando:	Jumping
emprendí:	I undertook
farmacia:	pharmacy
vitrina:	showcase
agujereado:	leaky
hombro:	shoulder
Decidido:	Decided
separaba:	separated
Sólo:	Only
fuga.:	leak.
dejados:	left
lotería:	lottery
billetes:	tickets
colgaban:	they hung
pilastras:	pilasters
soportal:	support
guarecerme:	shelter me
Corrí:	I ran
suelo.:	floor.
plomo:	lead
alcanzadas:	reached
saltaban:	they jumped
desviaban:	they diverted
frutas:	fruits
rodar:	rotate
desplomó:	collapsed
naranjas:	oranges
Cerca:	Fence
trechos.:	excerpts.
encendió:	turned on
cuyo:	whose
despejar:	clear
acabó:	just
tensión:	strain
latigazo:	lash
pedrada.:	stoned.
recibido:	received
órgano:	organ
tubos:	tubes
vibrantes:	vibrant
dejándolos:	leaving them
alumbrado:	lighting
postes:	positions
topaban:	bumped
rotos.:	broken.
Llovían:	They were raining
fusilería.:	riflery.
recia:	strong
derribándolo:	knocking him down
desembocó:	ended
miedo:	fear
hostigada:	harassed
vociferante:	shouting
multitud:	crew
columna.:	column.
amparo:	protection
asustado:	scared
detener:	arrest
grita:	scream
protectora:	protective
eficacia:	effectiveness
tuvieran:	had
estampados:	prints
cuños:	dies
pasaporte:	passport
Saqué:	I took out
anunciaba.:	announced.
metálicas:	metal
transeúntes:	passersby
vacías:	empty
cuenta:	account
darme:	give me
pude:	could
regresé:	I came back
inquieto:	restless
Algo:	Something
empezó».:	started."
¡Ya:	Yes
empezó:	started
tapias::	walls:
gritó:	shout
voz:	voice
peligro.:	danger.
mojadas:	wet
ropas:	clothes
batea:	Bataa
llevaba:	wore
descalza:	barefoot
despavorida:	terrified
mujer:	women
seguido:	followed
correr:	run
pasó:	passed
fuerza:	force
nuevamente:	again
oyó:	heard
memoria:	memory
reconstruido:	rebuilt
llegada:	arrival
jirones:	tatters
regresaban:	they returned
versos:	verses
repetir:	repeat
volvía:	came back
Repetía:	I repeated
famosa.:	famous.
Itálica:	Italics
fueron:	were
collado:	hill
mustio:	Black man
agora:	now
romanos.:	Romans.
torno:	lathe
buche:	beech
hinchaban:	they swollen
palomas:	pigeons
arrullos:	coos
enredarse:	tangle
volvieron:	they came back
Hubo:	Was
manejo:	management
adiestraban:	they trained
militar:	military
escuela:	school
alumnos:	students
Eran:	Were
descarga:	discharge
encerado:	waxed
papel:	paper
desgarrado:	torn
naufragio:	shipwreck
víctimas:	victims
monumento:	monument
coronada:	crowned
poetisa:	poet
Fronteras:	Borders
Guetra:	War
veterano:	veteran
afiebrados:	feverish
estudiante:	student
mármol::	marble:
yacía:	lay
daguerrotipo:	daguerreotype
ostentaba:	flaunted
hongos:	fungus
empañado:	tarnished
yerbas:	herbs
olvidadas:	forgotten
tumbas:	graves
cipreses:	cypresses
frescura:	freshness
mañanera:	morning
atraído:	attracted
natillas.:	custard.
oloroso:	odorous
jugaban:	they played
niños:	children
cantado:	sung
25
:	25
Escuchaba:	I listened
Mágica.:	Magic.
Flauta:	Flute
masónica:	masonic
estética:	aesthetics
ilustraciones:	illustrations
edición:	edition
hojeaba:	leafed
Maximiliano;:	Maximilian;
fusilamiento:	shooting
Aquí:	Here
desconocidas.:	unknown.
vagar:	wander
objeto:	object
distraían:	distracted
marinera:	sailor
bailando:	dancing
estampas:	prints
exhibía:	exhibited
escaparate:	escape
descubrimiento:	discovery
reencuentro:	reunion
Este:	It is
compañeros:	companions
pegado:	glued
llevaban:	they carried
mediterráneo:	Mediterranean
volver:	return
asperjarlo:	sprinkle it
puerros:	leeks
cuenco:	bowl
corteza:	crust
quebrar:	to break
deferente:	deferential
gesto:	gesture
tomado:	taken
bendecirlo:	bless him
reparte:	distribute
rompe:	breaks
vergonzosa:	embarrassing
cerrados:	closed
camiones:	trucks
traído:	brought
dónde:	where
amasado:	kneading
mañanas:	mornings
Hacía:	Toward
sorpresa.:	surprise.
deleitosa:	delightful
zuecos.:	clogs.
cantando:	singing
afanaban:	warm up
sótano:	basement
respiraderos:	vents
brotó:	sprouted
horneada:	baked
recién:	newly
masa:	time
tibias:	pipes
hogazas:	loaves
pescado:	fish
rezumos:	resumes
aceites:	oils
sangrías:	indentations
ofrecíanse:	they offered
pimienta.:	pepper.
limón:	lemon
orégano:	oregano
rociada:	spray
humo:	in it
reventaban:	they burst
grasas:	fats
ajos:	garlic
hincado:	driven
ternero:	calf
pernil:	ham
hornilla:	stove
abanicaba:	fanned
hombre:	man
brisa.:	breeze.
giraba:	turned
librería:	bookshop
colgante:	pendant
Planisferio:	Planisphere
Melodiosa:	Melodious
Bota:	throw away
Tutilimundi:	It was caught
floreadas:	flowered
letras:	lyrics
tiempos::	time:
artesanías:	crafts
evocaba:	evoked
apostura:	pose
pequeños:	small
muestras:	samples
contemplar:	contemplate
estrechas:	narrow
aceras:	sidewalks
Remontando:	Reassembling
raras.:	rare.
tiendas:	stores
alrededores:	surroundings
orientarme:	guide me
traté:	I tried
oscuros.:	dark
espejuelos:	glasses
tuve:	I had
él:	he
comparecer:	attend
extraño:	strange
estanques:	ponds
inquietas:	restless
hebras:	strands
tejiéndose:	weaving
rebotando:	bouncing
lleno:	full
metido:	put
despertarla.:	wake her up.
apresuradamente:	hurriedly
vestí:	I dressed
mismo:	same
Por:	By
ingenuo.:	naive.
trataría:	would try
propósito:	purpose
empeñado:	pawned
Sabía:	Knew
víspera.:	eve.
obsesionaba:	obsessed
—la:	-the
indígenas:	indigenous
búsqueda:	search
iniciar:	start
aprovecharse:	take advantage
pensé:	think
acostarme:	go to bed
ganas:	desire
dieron:	they gave
volvió:	came back
profundamente:	deeply
suspiró:	sigh
despertarse:	wake up
abrió:	opened
volviéndome:	turning
reír:	laugh
eché:	I cast
vivía:	lived
desconocimiento:	ignorance
burlesco:	burlesque
advertir:	warn
constelaciones.:	constellations.
situación:	situation
exacta:	exact
—
fuera:	—
out
preguntarle:	ask him
inútil:	useless
Mouche.:	Fly.
estudio:	study
adornaría:	would adorn
figuraciones:	figurations
Cabellera:	Hair
Sagitario:	Sagittarius
Navio:	Ship
Hidra:	Hydra
vértices:	vertices
pintaban:	they painted
presentes:	gifts
estrellas:	stars
Allá:	There
cansancio.:	fatigue.
conducirme:	drive me
podido:	could
hora:	time
fruición:	fruition
rompía:	broke
borrosos:	blurry
exacto:	exact
significado:	meaning
revelaba:	revealed
llevar:	carry
dejando:	leaving
fatigada.:	fatigued
declaró:	declared
sortilegio:	spell
Roto:	Lake
tules:	in the fire
esfumarse:	vanish
entero:	whole
agitó:	stirred
cuatro:	four
tocado:	touched
introducción:	introduction
pomposa:	pompous
sonó:	rang
espineta:	spinet
sonoridad:	sonority
trópico:	tropic
nunca.:	never.
asistido:	assisted
nadie:	nobody
dispuesto:	willing
iluminadas.:	illuminated.
estancias:	stays
otras:	others
conducían:	they drove
corredores:	runners
advertía:	warned
tallados:	carved
24
:	24
encendidas:	lit
luces:	lights
tallo.:	three.
libélula:	dragon-fly
pequeñas:	small
volanta:	fly-wheel
paseando:	strolling
tres:	three
mostraba:	showed
exquisita:	exquisite
pintura:	paint
lado:	side
entorchados:	twisted
magnífico:	magnificent
descubriendo:	discovering
caras:	guys
Metimos:	We put
dorados.:	golden
cuadros:	paintings
adornado:	decorated
abrían:	they opened
musgoso:	mossy
soportales:	arcade
anchos:	wide
encontramos:	we find
hábitos:	habits
signos:	signs
aquí:	here
expresaba:	expressed
figura:	figure
genio:	genius
urbe:	city
verdad:	TRUE
evidente:	obvious
nocturnos:	nocturnal
establecimientos:	establishments
enseñas:	you teach
invariables:	invariable
luminosos:	luminous
caracteres:	characters
parpadearan:	will flash
modernos;:	modern;
agitación:	agitation
adivinaba:	guessed
abajo:	below
municipales.:	municipal.
vetustos:	the old
campanarios:	bell towers
criterio:	criterion
horas:	hours
marcando:	marking
mostraban:	they showed
relojes:	watches
saetas:	arrows
somormujo.:	sleeper
deleitoso:	delightful
metía:	put
traseras:	rear
patas:	paws
parado:	stopped
perro:	dog
tritones:	newts
estucos:	stuccos
sombras:	shadows
estilo:	style
frente.:	forehead.
acera:	pavement
resonaban:	resonated
pasos:	steps
nuestros:	our
maravilla::	wonder:
comprobar:	check
caminar:	walk
teniendo:	having
asombrados:	amazed
detenernos:	stop us
sonido:	sound
desiertas:	deserted
pesando:	weighing
deshabitadas:	uninhabited
abiertas:	open
espesándose:	thickening
portones:	gates
zaguanes:	hallways
llenando:	filling
entera:	whole
hacerse:	become
Volvía:	I was coming back
tránsito.:	transit.
estridencia:	stridency
momentáneamente:	momentarily
desgarrarla:	tear it apart
Podía:	I could
cargada:	loaded
solemnidad:	solemnity
valores:	values
impuso:	imposed
teatro::	theater:
encuentro:	meeting
llevaban.:	they carried
intelectual—:	intellectual-
prejuiciadas:	prejudiced
—siempre:	-always
conocía:	knew
previsibles:	predictable
críticas:	reviews
ciertas:	certain
antemano:	beforehand
neutralizar:	neutralize
Quería:	Wanted to
viaje.:	journey.
placeres:	be placed
mejores:	best
aguarme:	water me down
reacciones:	reactions
tipo:	type
agriamente:	agrily
discutí::	I discussed:
necesidad:	need
Sentía:	I felt
contrariado.:	upset.
butaca:	armchair
volviera:	came back
conseguir:	get
evocar:	evoke
argucia:	sophistry
Viendo:	Seeing
ópera.:	opera.
despreciar:	despise
generación:	generation
consigna:	slogan
sensibilidad:	sensitivity
escasa:	scarce
chocara:	will collide
momento:	moment
despreciaba:	despised
frecuentados:	frequented
artísticos:	artistic
ambientes:	environments
señas:	address
ignorara:	will ignore
contacto:	contact
hostilidad:	hostility
ponía:	put
suficiencia:	sufficiency
súbitamente:	suddenly
irritado:	irritated
sentí:	I felt
justeza:	fairness
carecía:	lacked
observación:	observation
Aunque:	Although
Lucía:	Lucia
«la:	"the
—decía—:	—he said—
aquello:	that
soportar:	endure
incapaz:	unable
declarado:	declared
intermedio:	intermediate
Llegado:	arrived
disfraces.:	disguises.
envidia:	nvidia
observaba:	observed
desconocidas:	unknown
reglas:	rules
fintas:	feint
desdenes:	sincenes
discreteos:	discreet
venían:	they came
noticias:	news
ahogadas:	drowned
abanico:	fan
cuchicheos:	whispers
ojeadas:	glimpses
intencionadas:	intended
miradas:	looks
mecanismo:	mechanism
vasto:	vast
melodioso:	melodious
sólo:	only
sabidas:	known
páginas:	pages
salido:	left
figuras:	figures
primeras:	first
cantaban:	they sang
desatención:	inattention
misma:	same
romántica;:	romantic;
función:	function
enrojecidos:	flushed
rostros:	faces
mismos:	themselves
público:	public
tonadilla:	tune
habría:	there would be
ni:	in
fanales:	lanterns
mecerían:	would rock
escarapela;:	cockade;
chisteras:	top hats
botas:	boots
altas:	high
cocheros:	coachmen
afuera:	outside
esparaban:	they expected
Ya:	Of
noche.:	evening.
esta:	this
corresponder:	match
cantada:	sung
di:	Of
descripción:	description
maravillada:	amazed
encontré:	I found
tabaco:	tobacco
vuelto:	turned
pétalos:	petals
página:	page
novia.:	bride.
diario:	diary
llevado:	carried
dama:	agitate
23
:	23
cerradura:	lock
marfil:	ivory
libro:	book
baúl:	trunk
descubierto:	uncovered
tarde:	afternoon
penuria.:	shortage.
óleo:	oil
vender:	sell
tuviera:	had
niñez:	childhood
soñar:	dream
hiciera:	did
tanto:	both
raso:	satin
vestida:	dressed
velados:	veiled
sensuales:	sensual
bisabuela:	great-grandmother
pálida:	pale
ardiente:	burning
conocido:	acquaintance
haberlo:	have
pudo:	could
mágico:	magical
remozar:	renew
imposible:	impossible
hacer:	do
maneras:	ways
comportamientos:	behaviors
complejo:	complex
colgadas;:	hanging;
telas:	screens
portentosa:	portentous
corazón:	heart
llevadas:	carried
perfilaban:	they profiled
cantantes:	singers
escenario:	scenery
excesivo;:	excessive;
profundas:	deep
cabelleras:	scalps
entibiado:	warmed
encajes:	lace
pañuelo:	handkerchief
generosos:	generous
terciopelo:	velvet
rotonda:	roundabout
añoranzas.:	longings
fragmentadas:	fragmented
remotas:	remote
imprecisos:	inaccurate
hecho:	made
indefinible:	indefinable
dominado:	dominated
sentía:	felt
ironía.:	irony.
aguzando:	hammers
estuviese:	was
mentideros:	lies
perspectivas:	perspectives
escenografía:	scenography
Lamermoore:	Lamermoor
jardín:	garden
telón:	curtain
alzado:	raised
fioritura.:	flowering.
representarse:	represent
ridículos:	ridiculous
divertirme:	have fun
Pensaba:	Thought
camafeo:	cameo
evocación:	evocation
invitaba:	invited
empolvada:	powdered
muelle:	dock
abundancia:	abundance
cierta:	true
hombros:	shoulders
atadura:	tie
plumas.:	feathers.
abanicos:	fans
impertinentes:	lorgnette
nácar:	nacre
gemelos:	twins
otro:	other
rescatadas:	rescued
ponían:	they put
desnudos:	nudes
emergían:	emerged
cálida:	warm
palcos:	stages
corrían:	they ran
encendían:	they lit
conocerse.:	meet.
Todo:	All
platea.:	audience.
alborotosas:	rowdy
cubiertos:	covered
orquesta:	orchestra
afinaban:	they tuned
borde:	should
dentículos:	denticles
encarnados:	red
terciopelos:	velvets
conducido:	driven
pasamano:	ledge
rococó:	rococo
curvas:	curves
escalera:	ladder
Hérold.:	Herald.
bustos:	busts
custodiadas:	guarded
Musas:	Muses
drapeados:	draping
marmóreos:	marbled
arañas:	spiders
acogieran:	would welcome
espectáculos:	shows
falta:	lack
anoche:	last night
Imperio:	Empire
Segundo:	Second
fachada:	facade
reconozco:	I recognize
barroco:	baroque
cornisamento:	horning
sosteniendo:	holding
clásicas:	classic
columnas:	columns
Gobernadores:	Governors
persianas.:	blinds.
mirar:	look
Vuelvo:	I'm back
sueño.:	dream.
despecho:	spite
hundir:	inside
venda:	sale
recurriendo:	resorting
somnífero:	sleeping pill
calmado:	calm
clima:	climate
convivencia:	coexistence
primera:	first
prometido:	promised
físicos:	physical
júbilos:	jubilations
acabando:	running out
cuarto:	room
alcanzó:	reached
cercano:	nearby
debida:	due
alegría:	happiness
víspera::	eve:
chasco:	disappointment
resquemado:	burnt out
largamente:	widely
piernas:	legs
enredando:	getting tangled up
sábana:	sheet
quitarse:	take off
trata:	treats
inhabitual:	unusual
molesta:	bothers
veves:	woven
queda:	is left over
atravesado:	crossed
dormida:	asleep
país.:	country.
góticas:	goths
eléctricos:	electrical
ignoran:	they ignore
cuerdas:	ropes
guindarse:	hang
conseguido:	achieved
parroquiales:	parish
ritmos:	rhythms
esos:	those
uno:	a
campanas:	bells
lejos:	far
amotinados.:	mutineers
invisibles:	invisible
presentar:	introduce
también:	also
bronce:	bronze
corbata:	tie
encrespamiento:	inking
tormentoso:	stormy
tiene:	has
procer:	tall
estatua:	the state
pelusas:	fluff
tempranera:	early
árboles:	trees
cabeza.:	head.
calamares:	squid
cesta:	way
lleva:	carry
pregón:	proclamation
melismático:	melismatic
concertado:	concerted
extrañamente:	strangely
tijeras:	scissors
amolador:	grinder
Oyese:	Listen
ambulante.:	walking.
triángulo:	triangle
burlado:	mocked
allá—:	there-
mañana:	tomorrow
—el:	-he
hábito:	habit
persianas:	blinds
ojeada:	look
larga:	long
reflexión:	reflection
necesito:	need
22
:	22
distancia.:	distance.
kilómetros:	kilometers
mapa:	map
acaso:	chance
sonando:	ringing
está:	this
despertador:	alarm clock
mármol:	marble
sobresaltada:	startled
(Jueves:	(Thursday
edición.:	edition.
reciente:	recent
habanera:	to Havana
probaba:	tried
mientras:	while
tamarindo:	tamarind
sombreaba:	shadowed
traspatio:	backyard
casados:	married
jugábamos:	we played
jardinero...—:	gardener...-
hija:	is
piel:	fur
encontraba:	found
removido:	removed
tiesto.:	pot.
plantada:	planted
albahaca:	basil
rozó:	rubbed
Zoroastro:	Zoroaster
Rastro:	Trail
misteriosa:	mysterious
enseña:	teaches
comercio:	trade
salir:	go out
verdaderas.:	true.
adornaba:	adorned
costoso:	costly
demasiado:	too much
vitrina;:	showcase;
hechura:	workmanship
afiligranado:	affiliation
querido:	darling
cosa.:	What.
literaria:	literature
polvorienta:	dusty
pagando:	paying
respondió:	responded
parte.:	part.
iguales:	equal
encontrarlos:	find them
podría:	could
observar:	notice
le:	the
aunque:	although
dijes:	KNOWLEDGE
camafeos:	cameos
hallado:	found
antojó:	whim
tauromaquia.:	bullfighting.
escenas:	scenes
compartía:	shared
querubines:	cherubs
alborotoso:	rowdy
cáliz:	chalice
saliendo:	leaving
coronadas:	crowned
profesas:	you profess
monjas:	nuns
retratos:	portraits
sostenidos:	sustained
Sobre:	On
salterio.:	psaltery.
valses:	waltzes
tocaban:	they played
montadas:	mounted
doradas:	golden
mariposas:	butterflies
unas:	nails
música:	music
caja:	box
mostró:	showed
atención:	attention
llamar:	call
interesaban:	were interested
baratillero-anticuario:	dealer-antique dealer
Nada:	Nothing
fachada.:	facade.
verdosa:	greenish
nacida:	born
musgosa:	mossy
polvorientos:	dusty
plumiparados:	feathered
loros:	parrots
unos:	some
dormitaban:	they dozed
todas:	all
enrevesadas:	convoluted
esperada.:	expected.
providencia:	providence
rastro:	trail
detuviéramos:	we would stop
populares:	popular
rodábamos:	we were rolling
llevaba.:	wore.
aguafiestas:	spoilsport
acallaría:	would silence
sabría:	would know
forasteros.:	outsiders.
estimadas:	estimated
provecho:	advantage
sacar:	withdraw
andanzas—:	wanderings-
cansado:	tired
explorador:	explorer
curiosos:	curious
—un:	— and
Sería:	I would be
encomendada.:	ordered.
colección:	collection
venta:	sale
deben:	they must
algún:	some
imaginado::	imagined:
hasta:	until
posibilidad:	possibility
pienso:	I think
venido.:	come.
escrúpulos.:	scruples.
vence:	wins
superioridad:	superiority
sensación:	sensation
repentina:	sudden
desconocida.:	unknown.
intérprete:	interpreter
guía:	guide
será:	it will be
instante:	instant
partir:	leave
señalo:	I point out
ortografía:	spelling
faltas:	fouls
Precidente:	Previous
¿Biva:	It happens
caricatura:	cartoon
hace:	does
maleteros:	trunks
jerga:	jargon
deforma:	deforms
ríe:	laugh
espera;:	wait;
ventanales:	windows
veo:	I see
letreros:	signs
estampa:	print
idioma:	language
años:	years
seis:	six
cortaron:	they cut
mechón:	lock
guardada:	saved
gramática:	grammar
pequeña:	small
interjección:	interjection
ejemplo:	example
olvido:	forgot
mente:	mind
vuelve:	comes back
agora.:	now.
servirme.:	serve me
pudiera:	could
chistes:	jokes
eso:	that
sorprendente:	surprising
hechos:	facts
cuestión:	question
servicio:	service
llegar:	arrive
jaulas:	cages
pasar:	market
pájaros:	birds
próxima:	next
asfalto:	asphalt
hubieran:	they would have
balas:	answer
puertas:	doors
huir:	flee
desde:	from
estos:	these
ametralladoras.:	machine guns.
cementerio:	cemetery
aceite:	oil
harina:	flour
mucho:	a lot
hombres:	men
varios:	several
súbito:	sudden
detenía:	stopped
menos:	less
sueño:	dream
verme:	don't give
ignoraba:	I ignored
olvidada:	forgotten
cortinas:	curtains
Luego:	Then
De:	Of
junto:	together
salón:	salon
tejado:	roof
casona:	mansion
prisa:	hurry
lengua:	language
varias:	several
hizo:	those
arcadas:	arcades
podía:	could
nada:	nothing
realmente:	really
ciertos:	some
veía:	saw
posición:	position
así:	So
dejado:	left
juego:	game
servía:	served
apenas:	just
contemplaba:	contemplated
debía:	should
días:	days
toda:	all
moderna:	modern
recuerdos:	memories
encanto:	charm
bien:	GOOD
tradiciones:	traditions
iba:	others
ópera:	opera
encajes.:	lace
senos:	old
escotes:	necklines
siglo:	century
movimiento:	motion
brazos:	arms
risas:	laughter
mundo:	world
conversaciones:	conversations
Más:	Further
calor:	heat
mí.:	my.
falsas:	fake
modo:	way
blancas:	white
brisa:	breeze
comprender:	grasp
echando:	of winter
arriba:	above
busca:	search
detuve:	I stopped
mano:	thousand
resultó:	it turned out
cualquier:	any
hipocampo:	hippocampus
revuelo:	stir
vasos:	vases
cubiertas:	covers
especie:	species
otros:	others
sabía:	knew
vegetación:	vegetation
balcones:	balconies
cuyos:	whose
viejos:	old
rejas:	bars
hice:	I did
pareció:	it seemed
dentro:	within
entonces:	so
encontrar:	find
cosas:	things
pensado:	thought
hubiese:	would have
objetos:	objects
alguien:	someone
increíble:	incredible
fue:	was
lugar:	place
últimos:	last
Esta:	This
orgullo:	pride
tenía:	had
pelo:	for the
estar:	be
debe:	has to
dado:	given
tras:	after
dolor:	pain
¡ay:	yes
país:	country
acontecimientos:	events
sabor:	flavor
esquina:	corner
El:	He
Cuando:	When
estaban:	were
propio:	own
frente:	forehead
Un:	And
presencia:	presence
silencio:	silence
salí:	I went out
detrás:	behind
tenían:	they had
parecía:	it seemed
encima:	on
sido:	been
cada:	each
hallar:	cases
porque:	why
estaba:	was
ventanas:	windows
mí:	my
vendedor:	seller
comercios:	shops
Estos:	These
ser:	to be
cristales:	crystals
pues:	well
eran:	were
tiempo:	time
fondo:	bottom
antes:	before
ojos:	eyes
medio:	half
veces:	times
teatro:	theater
grandes:	big
La:	The
si:	and
aquel:	that
pero:	but
aquella:	that
fuera:	out
tal:	of
cuya:	whose
este:	it is
retrato:	portrait
parte:	part
poco:	bit
habían:	had
allá:	there
Una:	A
parecían:	they seemed
calles:	streets
instrumentos:	instruments
quien:	who
ahora:	now
todo:	all
En:	In
luego:	then
bajo:	low
hubiera:	had
vez:	time
cuando:	when
ese:	that
Pero:	But
noche:	evening
hacia:	toward
ya:	of
cuyas:	whose
alguna:	some
donde:	where
algo:	something
muy:	very
Mouche:	Fly
sus:	their
entre:	between
su:	are
sobre:	on
para:	to
había:	there was
como:	as
más:	further
del:	of the
se:	with
por:	by
una:	a
un:	and
el:	he
la:	the
en:	in
que:	what
de:	of
