34
:	34
cantar:	sing
gallos:	roosters
pintora.:	painter
amanezca»:	"dawn"
llevaremos:	we will take
«La:	"The
nervios.:	nerves.
desplomada:	collapsed
Hallé:	I found
crecía.:	grew.
mujeres.:	women.
cabelleras:	scalps
corriendo:	in a hurry
zumbando:	buzzing
mármol.:	marble.
sollozando:	sobbing
hundieron:	sank
bailado:	danced
mallas:	tights
tules:	in the fire
aún:	still
vestidas:	dressed
ellas:	they
Dos:	Of the
espectros.:	spectra.
bailarinas:	ballerinas
macilentas:	weak minded
Flacas:	Skinny
letrinas.:	latrines.
entero:	whole
agrio.:	sour.
sudor:	sweat
olían:	the oil
entrando:	entering
pasmado:	stunned
estiradas:	stretched
sucias:	dirty
rasurar:	Rasuraar
rodeaban::	They surrounded:
Miré:	Look
imprudentemente:	recklessly
acercarse:	approach
sien:	see
recibida:	received
fría:	cold
derribado:	felled
encendidas::	lit:
velas:	candles
apropiados—:	appropriate—
sostenían:	they held
pámpanos:	branches
adornos:	ornaments
candelabros:	chandeliers
Cuatro:	Four
solapas:	lapels
crucifijo:	crucifix
yacía:	lay
túmulo:	tomb
transformada:	transformed
nogal:	rather
estupefacto::	thunderstruck:
detuve:	I stopped
entré:	between
abrieron:	opened
llegué:	I arrived
sargento:	sergeant
acompañar:	accompany
Haciéndome:	making me
atravesar.:	cross.
tocaba:	played
tramo:	section
cubrían:	covered
regulares:	regular
tropas:	troops
abandonado:	abandoned
tienda.:	store.
lugar:	place
alcanzando:	reaching
soportales:	arcade
columnas:	columns
tras:	after
lentamente:	slowly
progresar:	to progress
soldados:	soldiers
ametralladoras.:	machine guns.
largas:	long
infantería:	infantry
patrullas:	patrols
aparecer:	to appear
cercana.:	close.
dentro;:	within;
conmoción:	shock
sorda:	deaf
otras.:	others.
encendieron:	they lit
apagaron:	they turned off
llamadas:	calls
llantos:	cries
gritos:	shouting
Sonaron:	They sounded
tiempo.:	time.
quebraron:	they broke
risas:	laughter
músicas:	songs
ocurrió:	occurred
venir.:	come.
prefiguración:	prefiguration
advertencia:	warning
insalvable:	insurmountable
ensanchaba:	widened
cauce:	channel
insinuó:	hinted
sé:	see
huella.:	fingerprint.
acoplamientos:	couplings
acostumbradas:	accustomed
incontables:	uncountable
oscuras:	dark
confusión:	confusion
vigilancia.:	surveillance.
peso:	weight
ebriedad:	drunkenness
habitado:	inhabited
saberla:	know it
tolerar:	tolerate
encima.:	on.
quitarme:	take off
arrostrar:	roast
valía:	worth
envolvía.:	wrapped
anormalidad:	abnormality
propiciada:	propitiated
insólita:	unusual
experiencia:	experience
prestarse:	lend
inducirla:	induce her
razonamientos-
pretextos:	reasoning-
pretexts
justificadoras:	justifying
intelectual:	intellectual
formación:	training
recelo;:	suspicion;
eterno:	eternal
suspicacia:	suspicion
fundar:	meeting
conocíamos.:	we knew
concreto:	concrete
formular:	formulate
podido:	could
nunca:	never
físicas:	physics
perfidias:	treachery
capaz:	able
creía:	believed
aborrecible:	abhorrent
Pensándola:	Thinking about it
confianza:	trust
poca:	little
presente:	gift
impaciencia:	impatience
corredores.:	corridors.
tantos:	so many
viajar:	travel
impulsado:	driven
Repetíase:	It was repeated
exasperado:	exasperated
volver:	return
deseo:	desire
reconocer:	recognize
nada.:	nothing.
ganar:	gain
perderlo:	lose it
arriesgarme:	take a risk
cálculo:	calculation
intervenía:	intervened
fatalidad:	fatality
proyectil.:	projectile.
trayectoria:	path
encontraría:	would find
33
:	33
incidencia:	incidence
ángulo:	angle
pudiera:	could
evidencia:	evidence
aterraba:	terrified
externo:	external
espacio:	space
cortaban:	they cut
designios:	designs
ajenas:	alien
tino:	really
disparadas:	shot
esas:	those
tablado.:	platform.
cruce:	cross
arroja:	throws
asociación:	association
inesperada:	unexpected
Pensaba:	Thought
librara:	library
bastarían:	would be enough
frente;:	forehead;
acera:	pavement
tardaría:	it would take
nada:	nothing
Unos:	Some
despejada.:	clear.
vaqueta:	cow
—un:	— and
vaciaba:	emptied
apostado:	bet
solitario:	lonely
disparo.:	shooting.
otro:	other
oyó:	heard
nuevamente:	again
preguntaba:	I asked
rasgara:	tear
minutos:	minutes
Más:	Further
propia:	own
zancadilla:	trip
darme:	give me
cambio:	change
uno.:	a.
retroceder:	back
repartía:	distributed
riesgo:	risk
distinta::	different:
Estado:	State
intérprete:	interpreter
vivida:	lived
ciertamente;:	certainly;
atroz.:	atrocious.
miedo:	fear
Retrocedí:	I backed away
pecho.:	chest.
pudo:	could
altura:	height
zumbó:	buzz
—uno:	-a
sonó:	rang
dispuse:	DISPOSED
almacenista:	storekeeper
Estreché:	I narrowed
bailaba.:	danced
entresuelo:	mezzanine
appogiaiuras.:	appoggiaturas.
ornamentos:	ornaments
descarrilaban:	derailed
dedos:	fingers
bebidas:	drinks
muchas:	many
estudiadas:	studied
piezas:	parts
algunas:	some
ejecutando:	running
Les:	THE
compases:	compasses
primeros:	first
seguida:	followed
aplausos.:	applause.
marquesina.:	marquee.
rejas:	bars
divisaban:	they saw
brillaba:	shined
rodeaban:	surrounded
tinieblas:	darkness
miré:	Look
Entreabrí:	I half opened
tiros.:	shots.
oían:	they heard
reloj:	clock
segundos.:	seconds.
circundante:	surrounding
devolvían:	they returned
cabeceadas:	nods
modorra::	drowsiness:
sumieron:	sumiero
antiguo:	ancient
tinajero:	jar
filtraba:	filtered
gota:	drop
granado:	pomegranate
crecían:	they grew
jazmines:	jasmine
calma:	calm
contado.:	counted.
opulencia:	opulence
crédito:	credit
miseria:	misery
litografía:	lithography
breva:	the letter
fumando:	smoking
silencio:	silence
miraba:	looked
tendero:	shopkeeper
espaciados.:	spaced.
disparos:	shots
Ahora:	Now
olvidado.:	forgotten.
pinta:	surface
españoles:	spanish
espadas:	swords
oros:	golds
bastos:	rude
reconociendo:	recognizing
mostrador:	counter
dejados:	left
naipes:	suits
Volteé:	I turned
garganta.:	throat.
atravesó:	crossed
abadejo:	pout
salmuera:	brine
olor:	smell
abejeaban:	they bee
femeninas:	feminine
voces:	you
trastienda:	back room
rebeldes.:	rebels.
persecución:	persecution
vitales:	vital
centros:	centers
refería:	referred
tal:	of
terminado:	finished
palabras:	words
confiar:	trust
cometida:	committed
imprudencia:	imprudence
dándome:	giving me
senté:	sat
batientes.:	swings.
trancas:	bars
gruesas:	thick
pasando:	passing
apresuradamente:	hurriedly
cerró:	hill
dueño:	owner
crestería.:	crest
pistolas:	pistols
respondieron:	they responded
vertiente:	slope
apostados:	bet
Varios:	Several
próxima.:	next.
recia:	strong
paquetes:	packages
veinte:	twenty
correr.:	run.
crucé:	crossing
comercio:	trade
cerrara:	will close
temor:	fear
urgido:	urged
escaleras:	stairs
Bajé:	I went down
colillas.:	butts.
aprovechar:	leverage
aquello:	that
señalé:	I pointed out
fumar:	smoke
lacerante:	lacerating
despertado:	woken up
Como:	As
prendido.:	on.
recién:	newly
veguero:	i will see
cargando:	charging
brazo.:	arm.
colgada:	hung
cesta:	way
rasando:	rage
acercaba:	approached
dar:	but
pequeña:	small
32
:	32
abría:	opened
vigas:	beams
colgadas:	hanging
ajos:	garlic
ristras:	strings
Dios:	God
nombre:	name
atención:	attention
llamado:	called
víveres:	provisions
interesó::	interested:
ello:	it
mofa:	mold
comedor.:	dining room.
bajar:	lower
atuendo:	attire
lucido:	lucid
mujeres:	women
pasaba:	was passing
atardecer:	sunset
abrí:	I opened
cesado:	ceased
desenfado:	abandon
ardido:	burned
ganas:	desire
indeciso:	undecided
Permanecí:	I stayed
elocuencia.:	eloquence.
conservada:	preserved
lengua:	language
reliquia:	relic
horripilante:	horrifying
profesas:	you profess
flagelaban:	they flagellated
artesonados:	coffered ceilings
barrocos:	baroque
altares:	altars
convento:	convent
silvestres:	wild
hortensias:	hydrangeas
florecidos:	flowered
paseos:	walks
hablaba:	spoke
consultarme:	consult me
invitación:	invitation
aceptado:	accepted
réplica:	replica
bagatela:	trifle
conseguida:	achieved
siglo:	century
estudio:	study
Allí:	Over there
policiales.:	police.
disposiciones:	provisions
blandamente:	blandly
aplicaban:	applied
platería:	silversmith's
talleres:	workshops
causa:	cause
extranjeros:	foreigners
favorecida:	favored
veraneo:	summer
población:	population
apacible:	gentle
días:	days
pasáramos:	it's noisy
pidió:	asked
Fue:	Was
convulsiva.:	convulsive.
fuerza:	force
alivio:	relief
impresión:	impression
hechos:	facts
conformidad:	accordance
atribuí:	attributed
contrariada:	upset
menos.:	less.
semana:	week
pasajes:	tickets
darnos:	give us
podrían:	could
semejantes:	similar
solicitudes:	requests
excedidas:	exceeded
aviación:	aviation
compañías:	companies
empresa.:	enterprise.
vana:	old
gastado:	spent
devolver:	return
eximido:	exempt
vacías:	empty
Curador:	Curator
presentarme:	introduce myself
permitiría:	would allow
además:	besides
regreso:	return
hablé:	I spoke
viaje:	journey
restaba:	remained
engorro:	nuisance
hora.:	time.
hallado:	found
fuera:	out
sanciones:	sanctions
severísimas:	very severe
seis:	six
queda:	is left over
regiría:	would rule
indefinido:	indefinite
avisó:	warning
encierro:	confinement
alegrarme:	rejoice
frecuente.:	frequent.
prisión:	prison
poder:	can
tránsito:	transit
dicho:	saying
gobierno:	government
miembros:	members
encarcelamiento:	imprisonment
vencedor:	winner
partido:	party
anunciando:	advertising
estaciones:	stations
respuesta.:	answer.
modo:	way
revolución»:	revolution"
mediodía:	average
Pregunté:	I asked
adolescente.:	adolescent.
golosa:	greedy
contrastaba:	contrasted
estatuaria:	statuary
impavidez:	impudence
tozuda:	and the diagram
recta:	straight
nariz:	nose
anguloso:	angular
encontrarme:	find me
tercera:	third
habíamos:	we had
llamaban.:	they called
oí:	I heard
Tenía:	Had
calor:	heat
divagaban:	they rambled
pesadillas:	nightmares
atormentó:	tormented
sueño:	dream
sumiéndome:	sinking
dejé:	I left
penumbras:	shadows
piernas.:	legs.
arrastraban:	they dragged
odre:	oder
pesadez:	heaviness
importarme:	care
equívocas.:	mistakes.
curiosidades:	curiosities
lindero:	boundary
llevarla:	take her
significara:	would mean
sentidos:	senses
solicitud:	application
particularmente:	particularly
tornaba:	returned
bebía:	drank
buscar:	look for
empeño:	endeavor
arrojó:	daring
ocurrencia:	occurrence
produjo:	produced
cumpliendo.:	complying.
cargada:	loaded
hembra:	female
Sísifo:	Sisyphus
única:	unique
Gusano:	Worm
Teoría:	Theory
recordó:	remembered
superpuesto:	overlapping
absurdo:	absurd
criados.:	created.
31
:	31
intemperie:	bad weather
guarecer:	shelter
cristales:	crystals
engomado:	gummed
remiendos:	patches
cemento:	cement
acantos:	acanthus
yesos:	plasters
desnudaba:	undressed
subir:	rise
agobiaba:	overwhelmed
dejaban:	they left
alineamiento:	alignment
buscaba:	I was looking for
quién:	who
partida:	match
devolverme:	return me
servía:	served
prisa:	hurry
hora:	time
obsesión:	obsession
perenne:	perennial
laberinto:	maze
—cronología:	-chronology
empotradas:	built-in
calendario:	calendar
tablas:	tables
cifras:	figures
eternidad:	eternity
condena:	condemn
atroz:	atrocious
cumpliendo:	fulfilling
dejadas:	left
herramientas:	tools
servidumbre:	servitude
abandonadas:	abandoned
escobas:	brooms
comprimido:	pill
oprimido:	oppressed
sentí:	I felt
colmena:	hive
noción:	notion
Vuelto:	Turned
cuerpo.:	body.
calambre:	electric shock
pasó:	passed
movido:	moved
haberme:	have me
Inclinada.:	Inclined.
Niágara:	Niagara
Jungfrau:	Virgo
representaba:	represented
cromo:	chrome
manera:	manner
idéntica:	identical
dispuestos:	willing
objetos:	objects
enseres:	equipment
muebles:	furniture
cuales:	which
guarismos:	figures
raso:	satin
pisaba:	stepped
también:	also
instrucciones;:	instructions;
placa:	plate
estilo.:	style.
mansión:	mansion
cotidianos:	everyday
tránsitos:	transits
allá:	there
viajado:	traveled
extraña:	strange
sensación:	sensation
titubeando:	hesitating
detenerme:	stop me
conocida:	known
forma:	shape
impuesto.:	tax.
fuese:	was
contando:	counting
numeradas—:	numbered—
numeradas:	numbered
anchura:	width
encarnada:	red
interminables:	endless
Recorría:	I walked
pasar.:	market.
dejarme:	leave me
burlonamente:	mockingly
apartaban:	they separated
quienes:	who
gesto:	gesture
distraía:	distracted
tenacidad:	tenacity
obstinado:	obstinate
sudoroso:	sweaty
proseguía:	continued
muchísimo:	lot
amarilla:	yellow
especie:	species
angostos:	narrow
oscuridad.:	darkness.
tienta:	probe
ciego:	blind
pasamanos:	railing
yendo:	going
ebrio:	drunk
súbitamente:	suddenly
conocidos:	acquaintances
alcoholes:	alcohols
amelazado:	he is asleep
sabor:	flavor
aguardiente:	schnapps
añadidura:	addition
marmóreo.:	marble.
empaque:	packing
solemne:	solemn
cariátides:	caryatids
tomando:	taking
empresa:	enterprise
importante:	important
acomete:	affects
Partí:	Party
buscarla.:	search for it
impuso:	imposed
cargados:	loaded
vasos:	vases
bebido:	drunk
esperarla:	wait for her
tampoco:	neither
vistiendo.:	dressing
pensé:	think
verla:	see it
extensión;:	extension;
regresado:	returned
Creía:	I believed
carroña.:	carrion.
buitre:	vulture
vuelo:	flight
surcaba:	furrowed
nubes:	clouds
cerradas:	closed
reverberación:	reverberation
veía:	saw
palmeras:	palm trees
mirar:	look
orquesta.:	orchestra.
fortissimo:	very strong
brazos:	arms
larguísimos:	very long
estirando:	stretching
rugía:	roared
«¡Aquí:	"Here
conmociones».:	"shocks."
febriles:	feverish
locas:	crazy
librada:	delivered
«por:	"by
domada:	tamed
naturaleza:	nature
evocaba:	evoked
despecho:	spite
ensayos:	essays
malogrado:	spoiled
agitados:	agitated
imprecando:	swearing
talante:	talent
pésimo:	appalling
Sólo:	Only
partes.:	parties.
penetrante:	penetrating
desaforado:	unbridled
transformado:	transformed
últimas:	latest
nerviosa:	nervous
tensión:	strain
gramófonos.:	gramophones.
sustituyendo:	substituting
basamento:	base
subiendo:	going up
trasiego:	racking
contagiosa.:	contagious.
alegría:	happiness
30
:	30
promovió:	promoted
informe:	report
Nuestro:	Our
mano.:	thousand.
teníamos:	we had
vasija:	vessel
cuanta:	how much
bebiendo:	drinking
canillas:	shins
encontrarnos:	find us
bajaron:	they went down
regresábamos:	we were returning
tiempo...:	time...
toneles:	barrels
licores:	liquors
inspeccionar:	inspect
fuimos:	went
buen:	good
Puestos:	Positions
molicie.:	softness.
invitaba:	invited
larderos:	larders
gratos:	grateful
dependencia:	dependence
húmedo:	wet
serrín:	sawdust
Pisábamos:	we stepped
cocinas.:	kitchens.
servirnos:	serve us
iríamos:	we would go
nosotros:	us
sencillo:	simple
guisado:	stew
comida:	food
preparar:	prepare
comprometía:	committed
extranjero:	foreign
auxiliado:	assisted
existente.:	existing.
abusar:	abuse
condición:	condition
semanas:	weeks
unas:	nails
asedio:	siege
resistir:	resist
vimos:	we saw
subsistencias.:	subsistence.
recuento:	count
proceder:	proceed
bajé:	I went down
llamada:	call
Dejé:	I left
situación.:	situation.
produciría:	would produce
afirmando:	stating
contrariedad:	annoyance
virtud:	virtue
tomaba:	took
país:	country
Conocía:	I knew
presentado:	presented
atractiva:	attractive
cantarina:	singsong
acompañaba:	accompanied
tomar:	take
bañarse:	take a bath
balde:	bucket
apenas:	just
quejándose:	complaining
felpa:	Sweatshirt
bata:	child
cordón:	cord
anudando:	grants
entró:	entered
Cansada:	Tired
cabezas.:	heads.
insistencia:	insistence
exasperante:	infuriating
multiplicado:	multiplied
hubieran:	they would have
Además:	Besides
caoba.:	mahogany.
revestimiento:	coating
remataba:	was over
ménsula:	bracket
abiertas:	open
tenerse:	have
exteriores:	exteriors
ventanas:	windows
únicas:	unique
muerto:	dead
cadáver:	corpse
Algún:	Some
Testamento:	Testament
ejemplo:	example
invocando:	invoking
ánimos:	encouragement
racionamiento.:	rationing.
impondría:	would impose
mandar:	to send
habituado:	accustomed
él:	he
caso:	case
edificio;:	building;
alimentos:	food
exacta:	exact
rindiera:	would surrender
nombramiento:	appointment
exigió:	demanded
alarmistas:	alarmists
pusilanimidad:	pusillanimity
afeó:	ugly
acostumbrado:	used to
autoridad:	authority
Usando:	Using
aliviar:	relieve
poderes:	powers
extraordinarios:	extraordinary
investido:	invested
hubiese:	would have
expectación:	expectation
esperanzada:	hopeful
mirábamos:	we looked
silencio.:	silence.
cejuda:	cried
severa:	severe
mirada:	look
cabeza:	head
presentes.:	gifts.
gritadas:	shouted
discusiones:	discussions
batuta:	combined
apareció:	appeared
colmo.:	full.
llegaba:	arrived
nerviosidad:	nervousness
insectos.:	insects.
explosión:	burst
Una:	A
sitiada.:	besieged
invadieran:	would invade
interiores:	interiors
sequía:	drought
aprovechando:	taking advantage
criaturas:	creatures
bastado:	enough
edificado:	built
desatención:	inattention
desorden:	disorder
Unas:	Nails
cerraduras.:	locks.
miraban:	they looked
alfombras:	rugs
debajo:	below
alimañas:	vermin
hormigas:	ants
ascensión:	rise
atraía:	attracted
velador:	pedestal table
dejado:	left
azucarada:	sugary
poción:	potion
pomo:	help
haciéndose:	making
patas:	paws
quedaban:	were left
resbalón:	slip
enceradas:	waxed
maderas:	woods
inhábiles:	unskilled
fugas:	leaks
promovido:	promoted
súbito:	sudden
rascada:	scratch
roído:	born
imperceptibles:	imperceptible
ruidos:	noises
llenaban:	they filled
armarios:	wardrobes
movía.:	moved.
sacar:	withdraw
desconfiadas:	suspicious
avizoraban:	they envisioned
antenas:	antennas
surgían:	arose
grifos:	emphasis
bocas:	mouths
cobre.:	copper.
espiral:	spiral
diminuta:	tiny
inmóviles:	motionless
quedando:	staying
susto:	fright
menor:	smaller
ovillaban:	on the door
ciempiés:	centipede
jabón:	soap
29
:	29
moteados:	speckled
caparachos:	shells
cochinillas:	mealybugs
obleas:	wafers
liendres:	nits
raras:	rare
llegaban:	they arrived
remotos:	remote
hipos:	Hush
llenas:	full
cañerías:	pipes
extrañas.:	strange
bestezuelas:	in other words
multitud:	crew
sacando:	taking out
manifestado:	manifested
vida:	life
suelas.:	soles.
nivel:	level
ocurría:	it happened
sorprendente:	surprising
tejados:	roofs
otear:	otter
Cansado:	Tired
peligro.:	danger.
afuera:	outside
mirarse:	look
cual:	which
ventanilla:	window
lanzarme:	throw me
obedecerle:	obey him
exaspera:	exasperates
pensaba:	thought
Gusano.»:	Worm."
catastrófico.:	catastrophic.
acabado:	finish
chiste:	fund
repitiendo:	repeating
Gusano»:	Worm"
hablar.:	talk.
hacerlos:	make them
golpeaban:	they hit
zarandeaban:	when you are
irritados:	angry
muchos:	many
reclamaciones:	claims
gancho:	hook
colgándoles:	colgandoles
derecho:	right
mancos:	missing
inútiles:	useless
mudez:	muteness
corriente:	current
teléfonos:	phones
Consulado::	Consulate:
comunicarse:	communicate
trató:	deal
Alguien:	Someone
acrecentadas:	increased
serían:	they would be
plagas:	pests
epidemias:	epidemics
habló:	speak
pocas.:	few.
reservas:	reservations
nuestras:	our
contar:	count
podríamos:	we could
comprendimos:	we understood
tritón:	triton
brotaba:	gushed
chorro:	jet
corrió:	ran
tirolesa:	zipline
aspirando:	aspiring
herrumbrosa:	rusty
gárgara:	gargle
escupió:	spat
grifo:	tap
eso:	that
llorar.:	cry.
rompió:	broke
ánimos.:	Cheers.
acudieron:	they came
ocupaciones:	occupations
Abandonando:	Abandoning
huéspedes.:	guests.
verdadero:	TRUE
producir:	produce
tuvo:	had
alarmante:	alarming
noticia:	news
Esta:	This
revolución.:	revolution.
sumarse:	join
marchado:	left
fieles:	faithful
sirvientes:	servants
últimos:	last
supo:	knew
observé:	observed
impaciencia—:	impatience-
—hora:	—time
brujería.:	witchcraft.
sucesos:	events
playas:	beaches
arrojados:	thrown
cetáceos:	cetaceans
tormentas:	storms
referían:	they referred
lejanas:	distant
localidades:	locations
informaciones:	information
viejos:	old
sumí:	sumi
preguntas.:	questions.
renuncié:	I resigned
dominar:	dominate
apellidos:	surnames
inexpresividad:	deadpan
ardía.:	It burned.
cuartel:	barracks
afirmaban:	they claimed
incendio:	fire
aislados.:	isolated.
tiros:	shots
sonaban:	they sounded
azoteas:	roofs
techos:	roofs
disparadas.:	shot.
precipitación:	precipitation
juzgar:	judge
implacables:	relentless
cortas:	short
batallas:	battles
librando:	freeing
distintos:	distinct
enfrentaban:	they faced
pequeños:	small
disminuido:	diminished
tiroteo:	shooting
cerrada.:	closed.
acerqué:	I approached
expendio:	expended
vaciando:	emptying
provisión:	provision
precavidos:	cautious
alarma:	alarm
cerámica:	ceramics
ranas:	frogs
mosaicos:	mosaics
baños:	bathrooms
tomaban:	they took
inactivos:	inactive
resguardado:	sheltered
traje:	lasts
publicaciones.:	publications.
policíaca:	police
novela:	novel
revista:	magazine
imaginario.:	imaginary.
vasto:	vast
fugadas:	escapes
entradas:	entries
dando:	giving
gestos:	gestures
dirigía:	directed
Filarmónica:	Philharmonic
invitado:	guest
austríaco:	Austrian
espejo:	mirror
Frente:	Forehead
becerro.:	calf.
carteras:	wallets
contenido:	content
revolvían:	they stirred
negociantes:	dealers
correspondencia:	correspondence
salón:	salon
encerado:	waxed
arabescos:	arabesques
lentos:	boards
perfilaba:	profiled
28
:	28
compañía:	company
segundas:	Mondays
duras.:	hard.
teclas:	keys
clavicémbalo:	harpsichord
sonoridades:	sounds
buscando:	searching
clásico:	classic
rondó:	rondo
mordentes:	mordants
trinos:	trills
ejecutaba:	executed
música:	music
estrado:	platform
empeño.:	endeavor.
permanencia:	permanence
afincarse:	settle
anormales:	abnormal
situaciones:	situations
demostrar:	demonstrate
oficina:	office
armar:	arms
Quien:	Who
algo.:	something.
defendían:	they defended
traducido:	translated
trágica:	tragic
pereza:	laziness
inducir:	induce
lejos:	far
acontecimientos.:	events.
imponían:	they imposed
cuarentena:	quarantine
sitiado:	besieged
acomodarnos:	accommodate us
tratamos:	we treat
impedidos:	prevented
siguiente:	following
(Viernes:	(Friday
drogas.:	drugs.
antifaz:	mask
descanso:	rest
primera:	first
ésa:	that
dormidos:	asleep
quedamos:	we stay
coronaba:	crowned
estuco:	stucco
roturas:	breaks
incrustaban:	embedded
imposible—:	impossible-
grado:	degree
absorción:	absorption
llevar:	carry
—de:	-of
estrecharnos:	tighten
macabras:	macabre
danzas:	dances
amantes:	lovers
frenesí:	frenzy
entregaban:	they delivered
abrazarnos:	hug us
aguda:	acute
voluptuosidad:	voluptuousness
hacerlo:	do it
suficiente:	enough
hallada:	found
envolvía;:	wrapped;
pensar:	think
encerrados:	locked up
desaforadamente:	wildly
cayó:	fell
disimulaban:	they concealed
puesta:	putting
llevadas:	carried
conversaciones:	conversations
cartas:	cards
partidas:	matches
deshilvanadas:	Desilawandas
lecturas:	readings
rapidez:	speed
increíble:	incredible
futuros:	futures
banquetes:	banquets
anunciaba:	announced
fiambres:	cold cuts
almuerzo:	lunch
acera.:	pavement.
acababan:	they finished
cadáveres:	corpses
hiciese:	did
fuerte:	strong
apurar:	ascertain
alguien:	someone
conversación:	conversation
dejar:	leave
oportunidad:	chance
Aproveché:	I took advantage
centroamericano.:	Central American.
diplomático:	diplomatic
divorciada:	divorced
presentó:	presented
engolado:	haughty
cantarína:	sing-song
exclamó:	he exclaimed
c'est:	It is
martillazo.:	hammer blow
sonoro:	sonorous
topaba:	bumped
campanas:	bells
cuyas:	whose
Catedral:	Cathedral
abrir:	open
acababa:	ended
mortero:	mortar
ambulancias.:	ambulances.
ulular:	adults
desgarrado:	torn
apoyado:	supported
estruendo:	noise
volvíase:	was turning
ametralladora:	machine gun
irrumpía:	broke in
golpeaba:	hit
vecindario:	neighborhood
enfermo:	sick
llanto:	crying
escuchaba:	I listened
terminado.:	finished.
repentina.:	sudden.
pausa:	break
producía:	produced
fondo.:	bottom.
embates:	clashes
viento:	wind
soplara:	will blow
alejaba:	moved away
acudía:	came
deflagración:	deflagration
ininterrumpida:	uninterrupted
estremeciendo:	extremeciendo
aislado:	isolated
compacto:	compact
fragor:	roar
momentos:	moments
fundían:	melted
descargas:	downloads
inmediaciones:	vicinity
cobrado:	charged
combate:	fight
cremalleras:	zippers
trueno:	thunder
—desechos:	-waste
blindados:	armored
carros:	cars
pasaron:	bird
invocaban.:	they invoked.
razones:	reasons
caras:	guys
ahora:	now
empezaron:	they started
luces:	lights
qué:	that
foso:	pit
borrachera:	drunkenness
debía:	should
posibilidades:	possibilities
tablado:	platform
varilla:	rod
jugador:	player
segundos:	seconds
muerte:	death
Aquí:	Here
dependía:	it depended
tiro:	number
Todo:	All
aquella:	that
dormir:	sleep
vendió:	sold
copas:	glasses
varias:	several
tejado:	roof
francotiradores:	snipers
fusilería:	musketry
abrió:	opened
Ya:	Of
raro:	down
tienda:	store
noche.:	evening.
falta:	lack
menos:	less
cualquier:	any
Iba:	Different
dijo:	said
estado:	state
cuyo:	whose
volvía:	came back
conocido:	acquaintance
aunque:	although
toda:	all
Mouche.:	Fly.
llegar:	arrive
recuerdo:	memory
habitaciones:	rooms
estuviera:	was
fuga.:	leak.
esos:	those
conocía:	knew
trabajo:	job
iba:	others
dónde:	where
tener:	have
comprendí:	I understood
peldaños:	steps
voluntad:	willpower
cuarto.:	room.
hacia:	toward
palabra:	word
arrancaba:	started
revolución:	revolution
seguía:	continued
todas:	all
licor:	liqueur
corredores:	runners
mismos:	themselves
sótano:	basement
respondiendo:	responding
desenlace:	outcome
víspera.:	eve.
dado:	given
le:	the
volando:	flying
moscas:	flies
parecía:	it seemed
estar:	be
peligro:	danger
algún:	some
terminó:	term
hombres:	men
existencia:	existence
cuanto:	how much
cuenta:	account
comisión:	commission
inmediato:	immediate
sido:	been
atraído:	attracted
Volví:	I returned
arañas:	spiders
correr:	run
todavía:	still
papel:	paper
casi:	almost
cuerpo:	body
De:	Of
sombras:	shadows
subterránea:	underground
advertí:	I warned
cuarto:	room
explicación:	explanation
decía:	said
clima:	climate
sólo:	only
instante:	instant
caer:	fall
suerte:	luck
luego:	then
aplacar:	placate
pánico:	panic
mayormente:	mainly
seguían:	they followed
esperaba:	I expected
Dieron:	They gave
menudo:	slight
diversión:	fun
mí:	my
así:	So
grupos:	groups
Afuera:	Outside
bronce:	bronze
reja:	NEW
cuya:	whose
entrada:	Prohibited
cigarrillos:	cigarettes
tabaco:	tobacco
hecho:	made
huéspedes:	guests
Noté:	Note
tiestos:	pots
pocos:	few
puertas:	doors
baño:	bathroom
busca:	search
periódicos:	newspapers
puesto:	position
lectura:	reading
quedaba:	remained
magníficos:	magnificent
Réquiem:	Requiem
grandes:	big
escribir:	write
Sonaban:	They sounded
arrimadas:	piled up
hacían:	they did
partes:	parts
pianista:	pianist
comedor:	dining room
necesario:	necessary
trataba:	tried
oficio:	job
necesidad:	need
estas:	is
calles:	streets
realidad:	reality
ni:	in
persianas:	blinds
balas:	answer
afán:	eagerness
muerte.:	death.
juegos:	games
otros:	others
hallando:	finding
cuerpos:	bodies
juego:	game
despreocupación:	unconcern
beber:	to drink
dimos:	we gave
angustia.:	distress.
cosa:	What
otra:	other
tarde:	afternoon
transcurrieron:	elapsed
Luego:	Then
ahí:	there
cercana:	close
presencia:	presence
olvidar:	forget
voz:	voice
bien:	GOOD
cerca:	fence
cantaba:	sang
según:	according to
estampido:	stamped
oír:	hear
dejaba:	left
intensidad.:	intensity.
varios:	several
momento:	moment
peores:	worst
podían:	they could
antes:	before
frente:	forehead
vez:	time
través:	through
punto:	point
dentro:	within
paralelas:	parallel
muy:	very
esto:	this
andar:	to walk
rostro:	face
allí:	over there
botellas:	bottles
dos:	of the
durante:	during
posible:	possible
carroña:	carrion
hedor:	stench
insectos:	insects
hasta:	until
mano:	thousand
tanto:	both
hombre:	man
hacía:	toward
caños:	pipes
habría:	there would be
gerente:	manager
todos:	all
efecto:	effect
después:	after
entonces:	so
cierta:	true
acontecimientos:	events
parecían:	they seemed
tenían:	they had
algunos:	some
eran:	were
alguna:	some
abierto:	open
máquinas:	machines
demás:	others
situación:	situation
salir:	go out
día:	day
tiempo:	time
fue:	was
alfombra:	rug
mismo:	same
mientras:	while
demasiado:	too much
noche:	evening
Cuando:	When
mente:	mind
junto:	together
canadiense:	Canadian
mujer:	women
lado:	side
Un:	And
siempre:	always
Parecía:	It seemed
veces:	times
pareció:	it seemed
aquí:	here
sabía:	knew
este:	it is
cada:	each
mañana:	tomorrow
hizo:	those
arriba:	above
Por:	By
escalera:	ladder
poco:	bit
parte:	part
unos:	some
pues:	well
bajo:	low
hacer:	do
reinaba:	reigned
mucho:	a lot
edificio.:	building.
detrás:	behind
torno:	lathe
habitación:	room
horas:	hours
pintora:	painter
ese:	that
El:	He
esta:	this
quien:	who
podía:	could
estaban:	were
medio:	half
pero:	but
Kappelmeister:	Bandmaster
Había:	There was
nuestro:	our
nuestra:	our
edificio:	building
si:	and
algo:	something
ser:	to be
aquel:	that
desde:	from
todo:	all
ya:	of
La:	The
Pero:	But
hubiera:	had
donde:	where
habían:	had
sus:	their
tenía:	had
entre:	between
Mouche:	Fly
En:	In
estaba:	was
sobre:	on
cuando:	when
más:	further
había:	there was
como:	as
para:	to
su:	are
por:	by
del:	of the
se:	with
un:	and
una:	a
el:	he
en:	in
que:	what
la:	the
de:	of
