44
:	44
mejor:	better
altares:	altars
lucirla:	show it off
medios:	media
tía:	aunt
custodia:	custody
confiada:	confident
milagros:	miracles
verdaderos:	true
familia:	family
debía:	should
devoción:	devotion
Auxiliares:	Assistants
Catorce:	Fourteen
estampa:	print
enfermo:	sick
llanos:	plains
selvas:	jungles
pasando:	passing
islas:	islands
muchas:	many
atravesando:	passing through
páramos:	wastelands
desiertos:	deserts
cruzando:	crossing
extremo:	extreme
deber.:	duty.
piadoso:	pious
llevada:	carried
trecho:	excerpt
tocaría:	would touch
interrogarla:	interrogate her
atreví:	I dared
rato:	mouse
penosa.:	painful
preocupación:	worry
dominada:	dominated
alzar:	raise
desconocidos:	unknown
cuyos:	whose
platos:	dishes
Pidió:	asked
corpiño.:	bodice.
prendido:	on
oscuro:	dark
lazo:	ribbon
Llevaba:	I was wearing
prestidigitador.:	conjurer.
romántico:	romantic
costurero:	sewing box
baraja:	deck
tieso:	stiff
almidonado:	starched
crudo:	raw
cintas:	ribbons
fruncidos:	puckers
calados:	silent
combinación:	combination
intrincada:	intricate
vestida.:	dressed.
atavío:	attire
gracioso:	funny
detallar:	details
divertí:	I had fun
arreglada:	fixed
mañana:	tomorrow
rescatada:	rescued
sentándose:	sitting
silueta:	silhouette
Contemplaba:	I contemplated
hoguera.:	bonfire.
claror:	of course
perezoso:	lazy
chivo:	billy goat
olor:	smell
montañés:	Highlander
recio:	tough
maíz:	corn
leña.:	firewood.
chimenea:	chimney
ardía:	burned
dependencia:	dependence
prolongación:	extension
comedor:	dining room
fui:	I went
reducía:	reduced
habitación:	room
dejé:	I left
remedio.:	remedy.
acto:	act
acostarse:	lie down
febril:	febrile
dolor:	pain
Tenía:	Had
altitud.:	altitude
extenuante:	strenuous
resultado:	result
jornada:	day
desmadejada:	limp
brazo:	arm
prendió:	caught
cumbres.:	summits.
largas:	long
Traída:	Betrayed
niebla.:	fog.
asperjándolos:	sprinkling them
mecían:	rocked
gruesas:	thick
colgaban:	they hung
copas:	glasses
espesura.:	thickness.
parecían:	they seemed
conseguidos:	achieved
claros:	clear
fríos:	cold
bosques:	forests
oscura:	dark
vegetación:	vegetation
adosadas:	semi-detached
calizas:	limestone
aldea:	village
encontrábamos:	we found
desperté:	I woke up
adolescencia.:	adolescence.
tenido:	had
recordaba:	I remembered
facultad:	faculty
recuperaba:	recovered
emprendido:	undertaken
semana:	week
notando:	noticing
dispuse:	DISPOSED
fruta:	fruit
modorra.:	drowsiness.
viajeros:	travelers
sumido:	gone
atmósfera:	atmosphere
cristales.:	crystals.
empañando:	tarnishing
intensidad:	intensity
monótona:	monotonous
repente:	suddenly
lluvia:	rain
planeta.:	planet.
ignorantes:	ignorant
permanecieron:	they remained
milenios:	millennia
distintas:	distinct
apartadas:	set aside
encrucijadas:	crossroads
malaxara:	malahara
consanguíneos:	consanguineous
volcado:	dump
hora.:	time.
nuevos»:	new»
«cristianos:	«Christians
celtas:	celts
América:	America
reunión:	meeting
lugares:	places
habidos:	had
formidables:	great
preferibles:	preferable
cepas:	strains
transplante:	transplant
amalgamas:	amalgams
aún::	still:
mediterránea.:	Mediterranean.
mestizado:	mixed
siglos:	ages
mezclada:	mixed
surgida:	arisen
viajera:	traveler
notar:	uses
Parisiense:	Parisian
asociación:	association
sien.:	see.
tinta:	ink
miran:	another
arcaicos:	archaic
figuras:	figures
43
:	43
negrura:	blackness
matices:	nuances
sorprendentes:	surprising
viviente:	living
equipajes.:	luggage.
rejilla:	rack
ropa:	clothes
poner:	put
levantarse:	get up
verla:	see it
advertir:	warn
acababa:	ended
cadera:	hip
anchura:	width
redondez:	roundness
sólida:	solid
nariz:	nose
mediterránea:	mediterranean
pómulos:	cheekbones
pelo:	for the
mezcladas:	mixed
evidente:	obvious
celuloide.:	celluloid.
peinetas:	combs
recogida:	collection
cabellera:	hair
pesada:	heavy
modelado:	modeling
valores:	values
fuertes:	strong
acusaba:	accused
fuga:	leak
delgada:	slim
mejilla:	cheek
alcanzando:	reaching
espesa:	thick
orgullosos:	proud
impasibles:	impassible
rasgos:	traits
inesperadamente:	unexpectedly
nariz;:	nose;
puro:	pure
perfil:	profile
ceja.:	eyebrow.
arcada:	arcade
voluntariosa:	willful
profunda:	deep
ahondaba:	delved
sien:	see
alargado:	elongate
pómulo:	cheekbone
semblante:	countenance
mitad:	half
acertaba:	was right
hallaba:	found
Desde:	From
simpatía.:	sympathy.
mirarla:	look at her
oportunamente:	opportunely
pronunciado:	pronounced
fijaba:	fixed
allí.:	over there.
partes:	parts
consumían:	they consumed
domingos:	Sundays
añadidura:	addition
viernes:	Friday
lentejas:	lentils
sábados:	Saturdays
quebrantos:	brokenness
duelos:	duels
noches:	nights
salpicón:	splash
carnero:	SHEEP
olla:	be
llamaba:	called
recorrer:	resort
íbamos:	we were going
flanco:	flank
curva:	curve
ancha:	much
señaló:	pointed out
nieblas:	fogs
rescatado:	rescued
segunda:	second
resurgía:	resurfaced
olvido:	forgot
enojaba:	angry
corredor.:	corridor.
lograba:	achieved
completo:	full
párrafo:	paragraph
memoria:	memory
sabido:	known
clase.:	class.
éramos:	we were
rapaces:	boys
veinte:	twenty
recitar:	recite
enseñara:	will teach
trabajo:	job
recordar:	remember
orgulloso:	proud
corredor...:	hallway...
flaco:	skinny
rocín:	nag
adarga:	adar
astillero:	shipyard
vivía:	lived
acordarme:	remember
quiero:	wanna
nombre:	name
contemplaba.:	contemplated.
caserón:	mansion
lectura:	reading
lección:	lesson
ilustraba:	illustrated
recordó:	remembered
recuas.:	retreat
vericuetos:	twists and turns
rematando:	ending
desembocaban:	flowed
alrededor:	around
enracimados:	rooted
barroca:	baroque
sorprendente:	surprising
torrentes:	torrents
rodeada:	surrounded
redonda:	round
meseta:	plateau
apareció:	appeared
frías.:	cold
agujas:	needles
hincada:	kneeling
cobraba:	charged
respiración:	breathing
distantes.:	distant.
visión:	vision
despejando:	clearing
flecos:	fringes
desgarraba:	tore apart
encima:	on
nuevamente:	again
hubiéramos:	we would have
rápidamente.:	quickly.
descendíamos:	we descended
funerarias.:	funeral homes.
máscaras:	masks
transparentes:	transparent
cubría:	covered
fijas:	fixed
inmovilizara:	immobilize
suspenso:	suspended
sentados:	sitting
Allí:	Over there
sorprendidos:	surprised
científica:	scientific
misión:	mission
miembros:	members
vitrinas:	showcases
propio:	own
metidos:	stuck up
siglo:	century
ocultando:	hiding
volcán:	volcano
afirmar:	assert
Alguien:	Someone
diaria.:	daily.
percances:	mishaps
hablara:	will speak
placenteramente:	pleasantly
narrados:	narrated
sucedidos:	successful
muerta:	dead
anécdotas:	anecdotes
chanzas.:	jokes
angustia:	distress
deshizo:	undid
sorbo:	sip
cuerpo:	body
cobró:	collection
bajamos:	we go down
maleza.:	evil.
tragar:	swallow
acabó:	just
dejó:	let
torpes:	clumsy
pasos:	steps
muerta.:	dead
comprendía:	understood
42
:	42
somnolencia:	sleepiness
peligros:	dangers
conocedora:	knowledgeable
creían:	they believed
gentes:	people
imprudentemente:	recklessly
traída:	betrayed
morir:	to die
dejaran:	they will leave
implorando:	begging
agarró:	grab
grito:	shout
repentinamente;:	suddenly;
cráter.:	crater.
despedidas:	goodbyes
empezaron:	they started
arremolinando:	swirling
cabezas:	heads
retumbó:	boom
lejano:	far
alud:	avalanche
contén.:	contain
apoyarse:	lean
fuese:	was
sorpresa.:	surprise.
descubriendo:	discovering
Parecía:	It seemed
expresión.:	expression.
tener:	have
volvieron:	they came back
mascar:	chew
entendiendo:	understanding
tragar.:	swallow.
obligarla:	force her
firmemente:	firmly
apretando:	squeezing
maleza:	evil
tableta:	tablet
viajaban:	they were traveling
Uno:	A
suelto.:	loose.
nudo:	naked
pañuelo:	handkerchief
cubierta:	deck
levemente:	slightly
meciendo:	rocking
temblorosos:	trembling
labios:	lips
empañada:	pie
estupefacta:	stupefied
Le:	The
dejados:	left
conten:	contain
sentada:	sitting
caída.:	drop.
atronadores:	thunderous
veían:	they saw
lecho:	litter
tendido:	lying
detuvo:	stopped
frenazo:	braking
vertiente:	slope
estábamos:	we were
Ya:	Of
horas.:	hours.
bajada:	descent
doblando:	bending
penaba:	I was sorry
rodábamos:	we were rolling
alivio:	relief
inmenso:	immense
observé:	observed
limalla:	with slime
faldas:	skirts
entrañaba:	entailed
telúrica:	telluric
amenaza:	threat
sorda:	deaf
Agobiado:	Overwhelmed
nuestro.:	our.
tormentas.:	storms.
órganos:	organs
abismos:	abysses
gargantas:	throats
bramarían:	they would roar
hombre:	man
brisas;:	breezes;
bestias:	beasts
ajeno:	unaffiliated
distinto:	distinct
blanquecía:	whiteness
entero:	whole
inconmovible:	immovable
pensada:	thought
distancia:	distance
vacío:	empty
consistencia:	consistency
evanescente:	evanescent
posibilidad:	possibility
sugería:	suggested
descubierto:	uncovered
misterio:	mystery
simas.:	sim
pluralidad:	plurality
silencioso:	silent
petrificados:	petrified
animales:	animals
tristes:	sad
peñas:	rocks
erizados:	bristling
negruras:	blackness
pavorosas:	dreadful
geológicos:	geological
escombros:	debris
llenos:	full
cráteres:	craters
borde:	should
llegábamos:	we arrived
Océano:	Ocean
trataban:	they tried
vientos:	winds
diezmaban:	decimated
rompían:	they broke
nieves:	snow
flanqueantes:	flanking
medialunados:	crescents
andinos:	andean
allí:	over there
vértebras:	vertebrae
fabulosas:	fabulous
espinazo:	spine
Estábamos:	we were
escala.:	scale.
conocidas:	known
verían:	they would see
daban:	different
quedado:	left
hulla:	corpse
liquen:	lichen
agarrado:	grabbed
fieltro:	felt
cacto:	cactus
foliácea:	foliation
subsistía:	subsisted
yertas:	stiff
mudos:	dumb
ínfimos:	tiny
Eramos:	we were
cesado:	ceased
humano:	human
cesó:	ceased
volcanes:	volcanoes
aparecieron:	appeared
peldaños:	steps
ventiscas:	the wind
divisores:	dividers
quebradas.:	ravines.
soplo:	breath
trastornado:	deranged
tallado:	carving
sílex:	flint
asperezas:	roughness
adustas:	burnt
traseras.:	rear.
redondas:	round
empujándose:	pushing
rocas:	rocks
hermano:	brother
minimizaba:	minimized
41
:	41
vehículo:	vehicle
anteriores.:	previous ones.
magnas:	big
ponían:	they put
helados:	ice cream
enrevesada:	convoluted
abrupta:	abrupt
descubría:	discovered
creíamos:	we believed
revueltas:	revolts
vueltas:	turns
cien:	hundred
subida:	climb
nuevas.:	new.
proporciones:	proportions
afirmación:	affirmation
aplastante:	overwhelming
dilataba:	dilated
circundante:	surrounding
inacabable.:	unending
bramido:	bellow
viento:	wind
inmensas:	immense
hoscas:	sullen
estiradas:	stretched
sumaban:	they added
aclaraba:	clarified
barranca;:	ravine;
verticales:	vertical
vertientes:	slopes
afincándose:	settling down
ruedas:	wheels
agarrándose:	holding on
techo:	ceiling
desajustada.:	misadjusted.
armazón:	warehouse
indecibles:	unspeakable
sufrimientos:	sufferings
vencida:	defeated
precipicios:	cliffs
inclinado:	inclined
cierzo:	north wind
espolvoreando:	sprinkling
gimiendo:	moaning
trepaba;:	climbed;
Descubrimiento.:	Discovery.
iniciaría:	would start
bruma:	Hoar
saliéramos:	we would go out
tacto.:	touch.
conocer:	know
propusieran:	would propose
hablarme.:	talk to me
vuelto:	turned
azules:	blue
batientes:	swings
albahacas:	basils
bastos:	rude
oros:	golds
tinajero:	jar
granado:	pomegranate
creyera.:	believe
hondamente:	deeply
sabores:	flavors
albores—:	dawn—
adolescencia:	adolescence
remontarme:	soar
—un:	— and
retroceso:	recoil
suspiros.:	sighs.
lastimosos:	pitiful
hombro:	shoulder
adormeciendo:	falling asleep
estuviera:	was
olvidado:	forgotten
pudiera:	could
solitariamente:	alone
gozar:	to enjoy
encerré:	close
fingido:	pretended
creer:	believe
fingir:	to fake
pasaban:	they passed
pues:	well
horas:	hours
enferma:	sick
fingiría:	I would pretend
Sabiendo:	knowing
amanecer.:	sunrise.
adentraba:	entered
carretera:	road
rodar:	rotate
empezamos:	we start
semanas.:	weeks.
unas:	nails
duraría:	would last
regresáramos:	we would return
disponiendo:	arranging
hablando:	talking
estuvo:	was
último:	last
bufandas.:	scarves.
cuello:	neck
apretadas:	tight
felpa:	Sweatshirt
toallas:	towels
mantas:	belongings
lleno:	full
instalamos:	we install
hacerle:	do
maletas:	suitcases
Cerré:	I closed
verdad.:	TRUE.
toser:	cough
garganta:	throat
irritarse:	get irritated
tosió:	cough
escalofríos;:	shivers;
quejándose:	complaining
fresca:	fresh
resfriada;:	cold;
sintió:	felt
medianoche.:	midnight.
duró:	hard
discusión:	discussion
junio):	June)
Chilam-Balam:	I was Balaam
Libro:	Book
sobrecarga.:	overload.
suelte:	release
tragó:	drink
vomite:	vomit
hable:	speak
desate:	untie
...será:	...it will be
TERCERO:	THIRD
CAPITULO:	CHAPTER
40
:	40
voluntad.:	willpower.
imponerle:	impose
capaz:	able
Mouche::	Fly:
tensara:	will tighten
importaba:	mattered
madrugada.:	dawn.
pasajes:	tickets
tabernero:	innkeeper
compré:	I bought
darme:	give me
encomendada.:	ordered.
honestamente:	honestly
llevando:	carrying
Curador:	Curator
cumpliendo:	fulfilling
quedaba:	remained
vacaciones:	vacation
emplear:	use
interesante:	interesting
sencillo:	simple
moneda:	currency
subido:	uploaded
dineros:	monies
contrariaban:	they contradicted
circunstancias:	circumstances
imaginada:	imagined
estafa:	scam
viviendo:	living
seguiríamos:	we would continue
Sur.:	On.
alcanzar:	reach
cual:	which
conducían:	they drove
autobuses:	bus
precisamente:	precisely
partían:	they left
recapacitaciones.:	retraining.
reflexiones:	reflections
proceso:	process
culminar:	culminate
venía:	permission
decisión:	decision
tradujo:	translated
ingrata—:	ungrateful—
—para:	-to
estrechar:	narrow
vendría:	would come
evidencia:	evidence
desagradable:	disgusting
informado:	informed
Fui:	I went
taberna.:	bar
cierre:	closing
ordenó:	ordered
policía:	police
linternas:	lanterns
capas:	layers
llegaron:	they arrived
eso:	that
sonaba.:	sounded.
provechosamente:	profitably
informara:	will inform
arrastrado:	dragged
traer:	bring
pruebas.:	evidence.
semejantes:	similar
sometido:	lost
sistema:	system
tiempos:	time
compases:	compasses
desenfado:	abandon
corrían:	they ran
binarios:	binary
ritmos:	rhythms
movimiento:	motion
vertiginoso:	vertiginous
Danzas:	Dances
danzas.:	dances
fueron:	were
músico.:	musician.
escamosos:	scaly
tobillos:	ankles
afianzaba:	strengthened
cónico:	conical
resonancia:	resonance
caja:	box
pálpito:	palpito
hallando:	finding
laúd:	lute
improvisación:	improvisation
Aquella:	That
presente.:	present.
compositores:	composers
válidas:	valid
búsquedas:	searches
primitivismo:	primitivism
alcanzándose:	reaching
eclesiásticos:	ecclesiastics
tonos:	tones
antiguos:	ancient
manejo:	management
magistral:	highway
obedecía:	obeyed
impresión:	impression
exenta:	exempt
mantenerse:	keep
ejecutante:	performer
aldeano:	villager
arbitraria:	arbitrary
afinación:	tuning
Edad:	Age
preámbulos:	preambles
grandeza:	greatness
festiva:	festive
amplios:	wide
majestuosos:	majestic
acordes:	chords
interrumpidos:	interrupted
recitativos:	recitatives
admiración.:	admiration.
dedos:	fingers
desentumecer:	loosen up
preludiar:	prelude
inspiración:	inspiration
entregándose:	surrendering
cuerda:	rope
colocó:	placed
rito:	here
oficia:	officiate
gravedad:	gravity
silencio:	silence
Hubo:	Was
arte:	until
entonarse:	get into tune
pretendía:	intended
Invención:	Invention
trente:	thirty
promesa:	promise
cumplir:	achieve
Tembladeras:	Tremors
Distrito:	District
39
:	39
música.:	music.
permiso:	permission
pidió:	asked
espalda:	back
terciado:	plywood
Descalzo:	Barefoot
mostrador.:	counter.
leña:	firewood
humo:	in it
muertas:	dead
avispas:	wasps
vientre:	belly
nacían:	were born
cardos:	thistles
Viernes:	Friday
hacha:	axe
hería:	wound
sangraban:	they bled
Arrebujados:	Wrapped up
moras.:	blackberries.
taberna:	bar
bajando:	going down
Seguí:	I continued
tierras.:	land.
recetas:	recipes
usadas:	used
país;:	country;
atonalismo:	atonalism
apostado::	bet:
crispado:	twitched
inicial:	initial
bemol:	flat
repetida:	repeated
ninguna:	none
doce:	sweet
conté:	contains
tocar.:	tap.
acordes—:	chords—
tras:	after
revelaba:	revealed
pulsación:	pulsation
dureza:	hardness
—la:	-the
acordes.:	chords.
tanteo:	score
inició:	start
Arriba:	Above
urbano.:	urban.
orillas:	shores
bajé:	I went down
salí:	I went out
componer:	compose
Irritado:	Irritated
Nieblas.:	Mists.
chirriaba:	screeched
carreta:	cart
aguda:	acute
tonalidad:	tonality
ranas:	frogs
diapasón:	diapason
hallar:	cases
hablan:	they talk
voces:	you
acallar:	silence
Hubiera:	Had
intolerables.:	intolerable.
«modernidad»:	"modernity"
temas:	themes
singularmente:	singularly
colmillos;:	fangs;
contenida:	contained
rojiverdes:	red-green
alfalfas:	alfalfa
reptaban:	crawled
criaturas:	creatures
mojados:	wet
henos:	blank
olía:	oil
cortante:	cutting
sordamente:	deafly
bullía:	bustled
balcón:	balcony
divertido:	fun
discusiones:	discussions
alcanzaban:	they reached
años.:	years.
aborrecidas:	boring
negadas:	denied
serían:	they would be
tanto»:	both"
consideraban:	they considered
cuantos:	how many
dicho:	saying
cotidianamente:	daily
obscuro:	obscure
llevado:	carried
haberlas:	have them
Ciertas:	Certain
devorar:	devour
hacerse:	become
intelectuales:	intellectuals
laberintos:	labyrinths
teorías:	theories
llevados:	taken
generación:	generation
encandilamiento:	dazzle
fácil:	easy
desorientarme:	disorient me
contribuido:	contributed
adolescencia;:	adolescence;
mío:	mine
desarraigo:	uprooting
temprano:	early
daño:	damage
mirarlos:	look at them
percibía:	perceived
cosas.:	things.
poniendo:	putting
Adán:	Adam
valores::	values:
índole:	nature
revelando:	revealing
oportuna:	timely
única:	unique
emprender:	undertake
ánimo:	cheer up
quebrados:	broken
arrestos:	arrests
vacía:	empty
países:	countries
regresarían:	they would return
empresa:	enterprise
propio.:	own.
derecho:	right
desesperadamente:	desperately
tratando:	treating
atrás:	back
olvidados:	forgotten
maleado:	malevolent
perdida:	lost
lumbre:	fire
estudios:	studies
empalidecer:	pale
enflaquecer:	weaken
Sinfonía.:	Symphony.
desatarse:	untie
habría:	there would be
prefiguración:	prefiguration
agorera:	ominous
muniquense:	Munich
estilo:	style
velador:	pedestal table
uniforme:	uniform
luciendo:	showing off
retratar:	portray
oficial:	official
invocador:	summoner
decirles:	tell them
delirio»:	delirium"
vivos:	alive
aparición:	appearance
liberación;:	release;
salvajada:	savagery
éxtasis:	ecstasy
«dios:	"God
culto:	cult
abrazar:	embrace
haría:	would
delirios:	delusions
maestre:	teachers
Algún:	Some
transeúnte.:	passerby.
disparar:	shoot
cadáveres:	corpses
necesidad:	need
suicidio:	suicide
ventajas:	advantages
evasión:	evasion
hablarían:	they would talk
pesebre:	manger
encendida:	lit
guiados:	guided
38
:	38
caerían:	would fall
cordeles:	twine
entretejidas:	Entretejidas
mismas:	themselves
vías:	ways
pintaban:	they painted
arteria:	artery
cortando:	cutting
Entre:	Between
azules::	blue:
figuradas:	figured
despiertos:	awake
soñar:	dream
confesión:	confession
propia:	own
dados:	data
compañeros:	companions
intelectual:	intellectual
topografía:	topography
regresándose:	returning
activos:	assets
estuvieran:	were
creación:	creation
pensamiento:	thought
artista:	artist
—afirmaba:	—he stated
cultura:	culture
carcajes.:	quivers
arcos:	bows
coleccionar:	collect
ávidos:	greedy
forasteros:	outsiders
dejaban:	they left
viajes:	trips
anduviera:	walked
encongiéndose:	shrinking
respondió:	responded
pregunté:	I asked
Les:	THE
conversación.:	conversation.
desvío:	detour
resultaba:	it turned out
grato:	grateful
cuan:	how
populares:	popular
balbuceos:	babbling
primeros:	first
interrogaba:	interrogated
lucimiento:	show off
oportunidades:	opportunities
quitar:	remove
propósito:	purpose
maligno:	malignant
conversación:	conversation
irrumpido:	burst in
habiendo:	having
ellos.:	they.
perderse:	be lost
esencia:	essence
preciosa:	lovely
anécdota:	anecdote
traducir:	translate
dignara:	dignified
implorantes:	imploring
contaba:	counted
entender:	to understand
inglés:	English
francés:	French
conocimiento:	knowledge
defensores.:	defenders.
teniendo:	having
figurativa:	figurative
pintura:	paint
polémica:	controversy
reconciliado:	reconciled
escritor;:	writer;
frecuentado:	frequented
determinado:	determined
querían:	they wanted
conocer;:	know;
jactara:	thrown away
escuela:	school
jefe:	boss
físico:	physical
detalles:	details
pedir:	ask
Lugares.:	Places.
peregrino:	pilgrim
interrogar:	question
Medioevo:	Middle Ages
cristianos:	Christians
interrogaban:	they interrogated
estos:	these
observaba:	observed
París.:	Paris.
tema:	him
adoración.:	worship.
prestándose:	stopping
hacían:	they did
recostada:	lying down
perezosamente:	lazily
rodear:	surround
verles:	see them
pude:	could
crepúsculo.:	dusk.
encerrarse:	lock up
huyendo:	fleeing
artistas:	artists
Tres:	Three
copas.:	drinks
trasiego:	racking
estudio:	study
alboroto:	riot
tremendo:	tremendous
inesperado::	unexpected:
aguardaba:	I was waiting
evidencia.:	evidence.
llegar:	arrive
Apreté:	I squeezed
asaltado:	assaulted
desiertas:	deserted
quietud:	stillness
hispanoamericano.:	Spanish American.
transcurrida:	elapsed
educación:	education
animalidad:	animality
atribuiría:	would attribute
enojo:	anger
provocar:	provoke
ridículo:	ridiculous
encogería:	would shrink
torturas:	torture
confiara:	will trust
tormenta:	storm
sabía:	knew
marido:	husband
comportarme:	behave
dispuesto:	willing
unía:	united
sentidos:	senses
hábito:	habit
repetido:	repeated
haberme:	have me
físicas:	physics
posibilidades:	possibilities
odiosas:	hateful
concreta:	concrete
imaginación:	imagination
hembras.:	females.
convenio:	agreement
urdirse:	if hit
deleitoso:	delightful
«algo»:	"something"
representación:	representation
simulación:	simulation
perfidia:	treachery
tolerar:	tolerate
mismo.:	same.
ello:	it
aborrecible:	abhorrent
sensación:	sensation
insoportable:	unbearable
celos::	jealousy:
peor:	worse
sufría:	suffered
grotesco.:	grotesque.
proceder:	proceed
decían:	they said
cinismo:	cynicism
alardes:	boasting
ambientes:	environments
frecuentación:	frequency
prolongada:	prolonged
resultado.:	result.
menor:	smaller
contradictorias:	contradictory
desconcertantes:	disconcerting
37
:	37
sorprenderlas:	surprise them
trataba:	tried
revelador;:	developer;
sentido:	sense
buscándoles:	looking for them
dicha:	bliss
pensaba:	thought
entendida;:	understood;
sorprender:	surprise
tenazmente:	tenaciously
observado:	observed
vedados:	sealed
dominios:	domains
regresara:	will return
—como:	-as
suficiencia:	sufficiency
fría:	cold
indiferencia:	indifference
qué:	that
sé:	see
ocurría.:	was happening.
victorioso:	victorious
partido:	party
triunfo:	triumph
celebraba:	celebrated
multitud:	crew
extraviadas:	lost
caminando:	walking
reaparecieron:	they reappeared
ambas:	both
parecer:	opinion
gamuzas.:	have fun
picaportes:	doorknobs
bruñían:	burnished
muebles:	furniture
colocaban:	they placed
sirvientes:	servants
vueltos:	turned
Adentro:	Inside
asfalto.:	asphalt.
revoloteaban:	they fluttered
moscas:	flies
enjambres:	swarms
herraduras:	horseshoes
huesos:	bones
cascos:	helmets
machetazos:	machetes
cortaban:	they cut
carro:	car
cabían:	fit
buitres:	vultures
descarnadas:	stark
encierro:	confinement
sentir:	to feel
hedor:	stench
carroña:	carrion
llevarse:	take away
procedían:	proceed
barrenderos:	sweepers
país—:	country-
olorosas:	smelly
—demasiado:	-too much
mortuorias:	mortuaries
pétalos:	petals
quedaban:	were left
huéspedes:	guests
comisión:	commission
adonde:	where to
cementerio:	cemetery
Kappelmeister.:	Bandmaster.
entierro:	burial
lacerante:	lacerating
demostraba:	demonstrated
inquietud:	concern
corazonada:	hunch
intolerables:	intolerable
transcurrían:	were passing
mientras:	while
empezado.:	started.
repentinamente:	suddenly
pensado:	thought
concluían:	they concluded
efusivas;:	effusive
duraban:	lasted
exasperarme.:	exasperate me
desasosiego:	unrest
atenciones:	attentions
dedicación:	dedication
entregaba:	delivered
idioma»:	language"
«hablaba:	«spoke
casos:	cases
decía:	said
frecuente:	frequent
consigo.:	with you.
acarreaba:	carried
sueños:	dreams
interpretación:	interpretation
astrología:	astrology
surrealismo:	surrealism
terrenos:	land
moverse:	move
volvía:	came back
alborozada:	exhilarated
Ana:	Well
ensayos:	essays
amante:	lover
florecida.:	flowered
religiosa:	religious
miniatura:	miniature
adquirir:	acquire
podido:	could
polvoriento:	dusty
hipocampo:	hippocampus
comprando:	buying
válida:	valid
opinión:	opinion
formular:	formulate
incapaz:	unable
desconcertada:	bewildered
anunciado:	announced
arquitectura:	architecture
tipo:	type
asociable:	associable
difícilmente:	hardly
ignorado:	ignored
objeto:	object
musgos:	mosses
umbroso:	shady
musgoso:	mossy
Iba:	Different
momento.:	moment.
estética:	aesthetics
consigna:	slogan
respondían:	they responded
juicios:	trials
generalizado.:	widespread.
uso:	use
sorbos:	sips
tomadas:	sockets
oídas:	hearsay
leídas:	read
puestas:	set
oportunas:	timely
citas:	others
penumbras:	shadows
curvas:	curves
claustro:	cloister
Puertas:	Doors
Cuatro:	Four
intimidad:	privacy
femenina:	feminine
Letrán:	Lateran
cielos:	Heavens
querubines:	cherubs
obsesión:	obsession
ventanas:	windows
sensualidad:	sensuality
misteriosa:	mysterious
observaciones:	observations
agudas:	acute
respecto:	regard
libresca:	bookish
formación:	training
indocumentados:	undocumented
sorpresa:	surprise
agarraba:	grabbed
desafortunadas:	unfortunate
falsas:	fake
cuán:	how
encuentro.:	meeting.
inteligentemente:	intelligently
realidad.:	reality.
36
:	36
evidentemente:	evidently
aburrimiento.:	boredom.
indicios:	clues
todavía—:	still-
confesara:	confess
—aunque:	-although
advertían:	they warned
equilibrio:	balance
especie:	species
operando:	operating
idioma:	language
costumbres:	traditions
trastorno:	disorder
limpidez:	clarity
Mientras:	While
atrás.:	back.
realidades:	realities
orden:	order
días—:	days-
pocos:	few
echaba:	threw
reveladora:	revealing
importancia:	importance
concedía:	granted
halagándolas.:	twelve
observando:	watching
constantemente:	constantly
complacer:	please
denotaban:	denoted
hablaba:	spoke
descansar:	rest
quedarme:	stay
ostentoso:	ostentatious
emprendía:	undertook
desistir:	to give up
conmigo:	with me
acuerdo:	agreement
minutos:	minutes
albergaba:	housed
razón:	reason
antojos:	cravings
afecta:	affects
carácter.:	character.
impropia:	improper
mansedumbre:	meekness
acataba:	complied
afirmada:	asserted
autoridad:	authority
afectaban:	affected
decisiones:	decisions
menudas:	petite
orientadas:	oriented
estudiada:	studied
Cierta:	true
contrariante.:	contrary.
fuerza:	force
principio:	principle
incolora:	colorless
figura:	figure
Quien:	Who
estimación:	estimate
crecimiento:	growth
irritante:	irritating
otra—:	other-
aceptado:	accepted
—aceptando:	—accepting
prestado:	provided
personaje:	character
Debo:	I must
pintora.:	painter
andando:	going
bajaba:	went down
frío:	cold
Sobrecogido:	Overcogado
montaña.:	mountain.
resto:	rest
advertían.:	they warned.
luces:	lights
salpicada:	splashed
estrellas:	stars
terminaba:	it ended
Ahí:	There
viento.:	wind.
batía:	beat
montículos:	mounds
plantadas:	planted
iluminaba:	illuminated
cimera:	summit
cerrada.:	closed.
curas.:	cures.
molestar:	annoy
encargado:	in charge
comunistas:	communists
conquistadores:	conquerors
sagitario:	Sagittarius
esperaba:	I expected
penúltimo:	penultimate
velorios.:	wakes.
nacimientos:	births
pequeñas:	small
anafes:	anafis
velas:	candles
temblequeante:	trembling
faja:	wad of bills
lentas.:	ribbons.
corrientes:	currents
neblina:	fog
cortar:	cut
llovido:	rained
bronce:	bronze
caudillo:	leader
jineteado:	ridden
encabritaba:	reared
decimotercer:	thirteenth
cono:	Pussy
varones:	men
verano:	summer
retretas:	portraits
servía:	served
rayo:	ray
abierta:	open
cúpula:	dome
dórica:	doric
glorieta:	roundabout
siguiente:	following
compartía:	shared
cuartel:	barracks
Enfrente:	Opposite
onceno:	eleventh
definida:	defined
arboleda:	grove
Convento:	Convent
foco.:	focus.
décimo:	tenth
ocupaba:	occupied
Logia:	Lodge
edificio:	building
abierto:	open
Compás:	Compass
sostenían:	they held
salomónicas:	Solomon Islands
columnas:	columns
encuadrado:	framing
misterioso:	mysterious
pomos.:	we put.
conservadas:	preserved
región:	region
venenosas:	poisonous
serpientes:	snakes
completa:	complete
colección:	collection
máquina:	machine
Napoleón:	Napoleon
retrato:	portrait
Quijote:	Quixote
párrafos:	paragraphs
copiado:	copied
arroz:	rice
grano:	grain
Riscos:	Risks
Campaña:	Campaign
héroe:	hero
colgada:	hung
argolla:	ring
35
:	35
guardaba:	kept
patrióticas:	patriotic
conmemoraciones:	commemorations
culturales:	cultural
noveno:	ninth
vecindario.:	neighborhood.
desvergonzadas:	shameless
cuentas:	accounts
rendirían:	would yield
Juicio:	Judgment
próximo:	next
siete:	seven
beatas:	blessed
cuarenta:	forty
dormidas:	overnight stay
saetas:	arrows
reloj:	clock
poste:	afterwards
colgado:	hanging
oscuridades:	darkness
acusados:	accused
contrafuertes:	buttresses
catedral:	cathedral
pórtico:	portico
rosal:	rose
verdinegro:	green and black
pertenecía:	belonged
séptimo:	seventh
lugar.:	place.
existiera:	existed
verdadera:	true
gruta:	cave
tapiar:	wall up
necesario:	necessary
hacerla:	do it
piensa:	think
obra:	work
traídas:	betrayed
construcción:	construction
trabajosa:	laborious
Gruta:	Grotto
sexto:	sixth
dormidos.:	asleep
Bajo:	Low
brazo.:	arm.
manca:	lacks
índice:	index
guiado:	guided
verdín:	scum
destilaba:	distilled
pluma:	feather
mármol:	marble
cuartilla:	pastern
versificando:	versifying
Agricultura:	Agriculture
Himno:	Hymn
laureado:	laureate
autor:	author
preclaro:	clear
hijo:	son
Poeta:	Poet
estatua:	the state
blanqueaba:	whitened
cuarto:	room
claridad:	clarity
caída:	drop
Patinadores.:	Skaters.
cartón:	card
plegarse:	fold
duraba:	lasted
alturas—:	heights—
—
puesto:	—
position
ellas:	they
regresaban:	they returned
ascendían:	ascended
giratoria:	rotating
colgantes:	pendants
asientos:	seating
tiovivo:	that life
avestruces:	ostriches
leones:	lions
camellos:	camels
giraban:	they rotated
Audiencias.:	Hearings.
Reales:	Royals
Oidor:	Hearer
raído:	raido
diván:	divan
sentadas:	sitting
faroles:	lanterns
aguardaban:	they waited
Ninfa:	Nymph
mecía:	rocked
segundo:	second
soportal.:	support
barriles:	barrels
dormidos:	asleep
borrachos:	drunk
ejemplo:	example
envites:	you invite
berro:	I shout
aguardientes:	spirits
pulpería:	pulper
alumbraba:	illuminated
pródiga:	prodigal
recta:	straight
alegoría:	allegory
malos:	bad
Cumbre.:	Summit.
conducía:	drove
sinuoso:	sinuous
plena:	full
mostrando:	showing
teatros:	theaters
reflectores:	reflectors
retablos:	altarpieces
luminarias:	luminaries
aisladora:	insulator
función:	function
aleteados:	finned
aquellos:	those
alumbrado:	lighting
tinieblas:	darkness
sacadas:	balconies
infierno:	hell
edificación:	building
adosada:	semi-detached
fotografiadas.:	photographed.
manoseadas:	groped
poblaciones-museos:	museum-populations
encanto:	charm
esquina:	corner
provincia:	province
rincón:	corner
viajeros.:	travelers.
guías:	guides
alababa:	praised
tarjeta:	card
insigne;:	distinguished;
ofrecía:	offered
paseos.:	walks.
indiscretamente:	indiscreetly
asomándome:	peeking out
conjunto:	set
puentecillo:	little bridge
tercera:	third
agradaba:	liked
diversiones:	amusements
ferrocarril:	railway
estrecha:	narrow
carrilera:	lane
tren:	train
mediodía:	average
Habíamos:	we had
(Sábado:	(Saturday
vestidos:	dresses
camión:	truck
bajados:	lowered
fúnebres:	funeral
pompas:	pomp
candelabros:	chandeliers
granito:	granite
acera:	pavement
Abajo:	Below
vestida:	dressed
dormir:	sleep
caer:	fall
grandes:	big
llevándome:	taking me
volviendo:	returning
galgo:	greyhound
asno:	ASS
círculo:	circle
encontraban:	they found
llevar:	carry
puso:	heart
cabeza:	head
paraguas:	umbrella
hato:	there
hielo:	ice
separaba:	separated
Un:	And
picos:	peaks
nuestras:	our
caras:	guys
prestigio:	prestige
ascensión:	rise
alturas:	heights
desfiladeros:	gorges
parados:	stopped
filos:	edges
negras:	black
hachas:	axes
crecían.:	they grew
pequeña:	small
subía:	went up
pintado:	painted
pobre:	poor
costado:	side
esfuerzo:	effort
imágenes:	images
marcado:	marked
encuentros:	meetings
instante:	instant
Hasta:	Until
envuelta:	wrapped
resuelto:	resolved
suma:	addition
limpio:	clean
nuestra:	our
hule:	cave
oreja:	ear
dieron:	they gave
jamás:	never
increíble:	incredible
empaque:	packing
época:	era
verdadero:	TRUE
caminos:	roads
modos:	modes
órgano:	organ
diseño:	design
escalas:	scales
Había:	There was
llenó:	full
cambio:	change
tocar:	tap
Venía:	Permission
instrumento:	instrument
acercó:	approached
arpista:	harpist
hablaban:	they spoke
aguardiente:	schnapps
tomar:	take
regresar:	go back
notas:	notes
presencia:	presence
joven:	young
volver:	return
ganas:	desire
ejes:	axles
resultaban:	they turned out
muerte:	death
cerca:	fence
sorbiendo:	sorbido
cuánto:	how much
nombres:	names
lentamente:	slowly
realidad:	reality
mano:	thousand
seres:	beings
dios:	God
espanto:	astonishment
Dyonisos:	Dionysus
dibujo:	drawing
círculos:	circles
mente:	mind
Según:	According to
rumbo:	course
palabra:	word
dejar:	leave
entonces:	so
tradiciones:	traditions
historia:	history
esos:	those
miradas:	looks
otros:	others
cansaban:	they tired
cómo:	as
Magos:	Mages
pensar:	think
pintor:	painter
obligaba:	forced
momento:	moment
anhelo:	longing
temor:	fear
pesar:	weigh
forma:	shape
súbito:	sudden
presente:	gift
preguntas:	questions
oculto:	hidden
raro:	down
salido:	left
revolución:	revolution
patas:	paws
apoderado:	proxy
otras:	others
sospechas.:	suspicions.
despertar:	wake up
hubieran:	they would have
llegaban:	they arrived
lujo:	luxury
Cada:	Each
esto:	this
literatura:	literature
libro:	book
puesta:	putting
preguntarme:	ask me
empezaba:	started
hubiese:	would have
caso:	case
encontrar:	find
vacilante:	hesitant
infancia:	childhood
reencuentro:	reunion
altitud:	altitude
cambios:	changes
habíamos:	we had
cierto:	TRUE
deseo:	desire
montaña:	mountain
brumas:	mists
subir:	rise
quería:	wanted to
salir:	go out
tenaz:	stubborn
palabras:	words
lentitud:	slowness
pareciera:	it seems
Mouche.:	Fly.
causa:	cause
esta:	this
atención:	attention
decir:	say
tortuosas:	tortuous
uno:	a
tejados:	roofs
Todo:	All
guijarros:	shingle
gesto:	gesture
Más:	Further
indios:	indians
Después:	After
solía:	used to
claro:	Of course
caballo:	horse
otro.:	other.
juventud:	youth
llena:	full
capitel:	capital
escribir:	write
varios:	several
hamaca:	hammock
correspondía:	corresponded
mujeres:	women
voz:	voice
cuyas:	whose
estar:	be
espesos:	thick
trepaba:	climbed
cemento:	cement
seguía:	continued
tercer:	third
terciopelo:	velvet
arrieros:	muleteers
Calvario:	Calvary
focos:	foci
aleluya:	alleluia
encontraba:	found
Nada:	Nothing
anteriores:	previous
palmo:	palm
recorrido:	route
contemplar:	contemplate
acodado:	accommodated
parecido:	similar
llegaba:	arrived
pasar:	market
páramo:	paramo
cimas:	tops
aquella:	that
Porque:	Why
montañas:	mountains
hizo:	those
rostro:	face
ciertas:	certain
evocaba:	evoked
buen:	good
también:	also
árboles:	trees
quebrada:	ravine
Una:	A
tarea:	task
luego:	then
puesto:	position
cierta:	true
mismos:	themselves
músico:	musician
estas:	is
hombros:	shoulders
espaldas:	backs
juego:	game
frase:	phrase
gente:	people
pareció:	it seemed
queda:	is left over
tránsito:	transit
todavía:	still
esas:	those
conocido:	acquaintance
poeta:	poet
canadiense:	Canadian
pintora:	painter
veía:	saw
algún:	some
ritmo:	rhythm
acerca:	about
país:	country
observar:	notice
nuestro:	our
hiciera:	did
hablar:	talk
querido:	darling
visto:	view
regreso:	return
cuanto:	how much
Estaba:	Was
reacciones:	reactions
aunque:	although
daba:	after
cualquier:	any
convivencia:	coexistence
días:	days
regresaba:	was returning
haciendo:	doing
apenas:	just
menores:	minors
parecía:	it seemed
pero:	but
según:	according to
alcanzaba:	reached
ámbito:	scope
estaciones:	stations
tenían:	they had
insectos:	insects
estampas:	prints
demasiado:	too much
perdido:	lost
vivir:	live
modo:	way
respondía:	responded
ni:	in
tarde:	afternoon
pequeño:	little
suelo:	floor
ojos:	eyes
niebla:	fog
bien:	GOOD
empezó:	started
dentro:	within
sentía:	felt
varias:	several
suerte:	luck
jóvenes:	youths
primera:	first
ciertos:	some
cuyo:	whose
veces:	times
tenía:	had
cosas:	things
día:	day
casi:	almost
Por:	By
viaje:	journey
otra:	other
antes:	before
hacer:	do
hora:	time
cumbres:	summits
tres:	three
lado:	side
hecho:	made
años:	years
lejos:	far
cosa:	What
quien:	who
toda:	all
abajo:	below
Como:	As
pasado:	past
nada:	nothing
mirada:	look
torrente:	torrent
después:	after
llegado:	arrived
hombres:	men
razas:	breeds
frente:	forehead
autobús:	bus
medio:	half
tal:	of
De:	Of
alguna:	some
Cuando:	When
durante:	during
nosotros:	us
mucho:	a lot
dejado:	left
afirmando:	stating
fondo:	bottom
arriba:	above
estaban:	were
Luego:	Then
aquel:	that
sombras:	shadows
En:	In
vida:	life
siempre:	always
aún:	still
lugar:	place
sólo:	only
La:	The
allá:	there
Ahora:	Now
mujer:	women
mismo:	same
menos:	less
ese:	that
calles:	streets
iba:	others
mundo:	world
cuya:	whose
estado:	state
entre:	between
podía:	could
estaba:	was
nubes:	clouds
dos:	of the
fuera:	out
otro:	other
ya:	of
poco:	bit
aquí:	here
le:	the
tiempo:	time
desde:	from
hacia:	toward
hacía:	toward
noche:	evening
tanto:	both
les:	THE
sido:	been
Pero:	But
mí:	my
hasta:	until
todo:	all
este:	it is
si:	and
bajo:	low
foco:	focus
cada:	each
eran:	were
algo:	something
Mouche:	Fly
hubiera:	had
donde:	where
vez:	time
habían:	had
cuando:	when
ahora:	now
muy:	very
El:	He
había:	there was
sobre:	on
para:	to
como:	as
su:	are
sus:	their
más:	further
del:	of the
por:	by
una:	a
se:	with
un:	and
el:	he
en:	in
que:	what
la:	the
de:	of
