51
:	51
ascensión:	rise
culminación:	culmination
laceraban:	lacerated
estrofas:	stanzas
vuelo:	flight
cierne:	hovers
hermanos:	siblings
serán:	will be
Todos:	All
santuario...:	sanctuary...
penetramos:	we penetrate
Ebrios:	drunk
Elíseo.:	Elysium.
hija:	is
divino:	divine
fulgor:	glow
¡Alegría:	Happiness
situado.:	situated.
viaje:	journey
causa:	cause
alcanzado:	reached
Heiligtum.:	Sanctuary.
dein:	your
Himmlische:	Celestial
feuertrunken:	fire drunk
betreten:	enter
Wir:	We
aus:	out of
Tochter:	Daughter
Götterfunken:	Sparks of the gods
schöner:	more beautiful
Freunde:	Friends
cantaban:	they sang
lejano:	far
levantados:	raised
oía:	heard
les:	THE
sueño:	dream
sacado:	taken
camastro:	bunk bed
Sentado:	Sitting
después:	after
dieron:	they gave
presos:	arrested
hule:	cave
forrados:	lined
cuadernos:	notebooks
tomaban:	they took
cubos:	cubes
ensangrentados:	bloody
algodones:	cottons
guardianes:	guardians
victimarios:	victimizers
barbarie:	barbarism
fría:	cold
peor:	worse
orillas:	shores
paridas:	farrows
recién:	newly
rebozo:	shawl
monturas:	mounts
sudado:	sweaty
cuero:	leather
limpias:	clean
alardes:	boasting
viriles:	virile
cabalgatas:	horseback riding
llenas:	full
novela:	novel
estampas:	prints
alegres:	happy
balaceras:	shootings
cactos:	cacti
descarrilados:	derailed
trenes:	trains
porfía:	obstinacy
tomadas:	sockets
Charros:	charros
disparos:	shots
tantas:	so many
organizado:	organized
creado:	created
imaginado:	imagined
haberme:	have me
Continente-de-poca-Historia...:	Continent-of-little-History...
reducto:	redoubt
librada:	delivered
Mont-
Segur.:	Mont-
for sure
cavernas:	caves
cátaros:	cathars
emparedara:	will wall
cruzado:	crossed
prisioneros:	prisoners
cegando:	blinding
asirio:	assyrian
príncipe:	prince
remozaba:	renovated
ejecuciones:	executions
paredón:	wall
enemigos:	enemies
arrimar:	support
personificado:	personified
laboratorios.:	laboratories.
cátedras:	chairs
ignorantes:	ignorant
vivían:	they lived
crueldad:	cruelty
propiciadora:	propitiator
animalidad:	animality
tinieblas:	darkness
imprenta:	printing
veía:	saw
Maniqueísta:	Manichaean
Libros.:	Books.
iniquidad:	iniquity
ocaso:	sunset
caballería:	chivalry
lema:	motto
prensa:	press
difundía:	spread
fusilamientos:	executions
fotos:	photos
solía:	used to
obliga»:	"obliges"
«Cultura:	"Culture
velluda:	go
memoria:	memory
cometidas:	committed
atrocidades:	atrocities
corrían:	they ran
historias:	stories
aterrorizado:	terrified
espanto.:	amazement.
residuos:	waste
estampado:	patterned
Occidente:	West
hombre:	man
absoluta:	absolute
quiebra:	bankruptcy
imaginar:	imagine
podido:	could
Jamás:	Never
yeso.:	and so.
tragado:	swallowed
sensación:	sensation
posibilidad:	possibility
cerciorarme:	make sure
visitar:	visit
esforzara:	will strive
iniquidades:	inequities
derrumbó:	collapsed
Algo:	Something
inédito.:	unprecedented.
pavorosamente:	frightfully
siniestramente:	ominously
niños.:	children.
Sirenita:	little mermaid
leyendo:	reading
nocturnas:	nocturnal
tocando:	playing
glorias:	glories
estudiando:	studying
sellos:	stamps
coleccionando:	collecting
seguía:	continued
aulladas:	howled
plegarias:	prayers
brotado:	sprouted
chimeneas:	chimneys
ciertas:	certain
abyecto:	abject
humo:	in it
caso:	case
cultivada:	cultivated
humanidad:	humanity
pasos:	steps
operaciones.:	operations.
cámaras:	cameras
luminosa:	bright
50
:	50
neta:	net
aséptica:	aseptic
blancura:	whiteness
caucho:	rubber
enguantadas:	gloved
frío:	cold
logradas:	achieved
peores:	worst
paletadas:	paddles
humanas:	human
dentaduras:	dentures
huesos:	bones
montones:	lots
excrementos:	excrement
salpicadas:	splashed
cremaciones:	cremations
torturas:	torture
testimonio:	testimony
avance::	advance:
nuestro:	our
vedado:	prohibited
coto:	stump
cancillería:	chancellery
antro:	the second
inédito:	unpublished
aguafuerte.:	etching.
tintas:	paints
sombreados:	shaded
burilados:	twisted
suyos:	his
horrores:	horrors
ambrosiano.:	ambrosian.
máximo:	maximum
archivo:	archive
desembocar:	lead
obuses:	howitzers
intemperie:	bad weather
dejada:	left
doblaban:	they doubled
decapitados:	decapitated
ángeles:	angels
jalonaban:	jalonando
abadías:	abbeys
atravesaban:	they crossed
estatuas:	statues
pedazos:	pieces
rellenados:	filled
hoyos:	holes
desconocido;:	a stranger;
alfabeto:	alphabet
caracteres:	characters
rotas:	routes
trazados:	traces
Apocalipsis:	Apocalypse
militar:	military
intérprete:	interpreter
recorrer:	resort
realizado:	carried out
documental:	documentary
deformación—:	deformation-
profesional:	professional
—pienso:	-I think
acompañamiento:	accompaniment
dramático:	dramatic
atraviesa:	goes through
ruinas:	ruins
fueron.:	were.
volver:	return
afirmarse:	assert
alzarse:	rise
pretenden:	intend
futuro:	future
gestación:	gestation
caos:	chaos
jirones:	tatters
hechos:	facts
lacerados:	lacerated
rotos:	broken
aparecen:	appear
escuchados.:	heard.
recapitulación:	recapitulation
encuadra:	frame
desata:	untie
bronces:	bronzes
tempestad:	storm
advenimiento:	advent
golpe:	blow
entra:	enter
enérgico:	energetic
Adivino:	Soothsayer
aproxima.:	approaches.
conmueve:	moves
transmisión:	transmission
estremecimiento:	shudder
arpegiado:	arpeggio
primero:	first
acordes:	chords
cuatro:	four
concluye:	concludes
noche;:	evening;
encontrar:	find
vuelvo:	I'm back
Ese:	That
estremecido.:	shuddered
realidad:	reality
regresa:	come back
persigue:	chase
Vuelvo:	I'm back
estudiar.:	study.
hora:	time
quejarme:	complain
Acabo:	Just
juegos.:	games.
estoy:	I'm
grita:	scream
arroja:	throws
saca:	take out
enoja:	angry
sorprende:	surprise
comprendo:	understand
malestar:	discomfort
latidos:	beats
lleno:	full
Respiro:	Breath
barcos.:	boats.
sirenas:	mermaids
ruido:	noise
aparte:	apart
imitando:	imitating
aprieto:	fix
Pregunto:	Asked
frente.:	forehead.
atreví:	I dared
dijeron:	they said
pequeños.:	small.
burlarse:	mock
inventadas:	invented
porquerías:	crap
sabiendo:	knowing
indignación:	indignation
rechazado:	refused
hembras.:	females.
varones:	men
posibilidades:	possibilities
sucias:	dirty
hablado:	spoken
han:	he
naves.:	ships.
amarran:	they tie up
agarradera:	lug
colores:	colors
hojalata:	tin
cubierta:	deck
redonda:	round
baúl:	trunk
será:	it will be
muelle;:	dock;
falta:	lack
estamos:	we are
diciéndole:	telling him
aquieto:	quiet
moverse:	move
estar:	be
aburre:	boring
indefinidamente.:	indefinitely.
alargar:	lengthen
quisiera:	I'd like
gozosa:	joyful
pereza:	laziness
infunde:	infuses
calor:	heat
brazos.:	arms.
estrechar:	narrow
canso:	tired
Baudilio.:	Baudil's.
llaman:	they call
habas:	wanton
platos:	dishes
enormes:	huge
devora:	devours
sudoroso:	sweaty
semana:	week
traída:	betrayed
heno:	tonight
envuelve:	wraps
viajes.:	trips.
forma:	shape
lavandería:	laundry
acuesta:	lie down
cardón:	cardon
boquete:	blowjob
cuela:	sneak
jardinero.:	gardener.
49
:	49
traspatio:	backyard
girasoles:	sunflowers
calas:	coves
claveles:	carnations
semilleros:	seedbeds
cazuela:	casserole
tiestos:	pots
juega:	play
Llamo:	Called
calabaza.:	pumpkin.
tallo:	three
trepa:	climb
reja:	NEW
habitación:	room
costumbre:	habit
sostenido:	sustained
tecla:	key
pegado:	glued
tiempos:	time
habla:	speaks
canta:	sing
ollas:	pans
hollín:	soot
memoria.:	memory.
regresó:	return
ejemplo:	example
repasar.:	repaste.
tengo:	I have
abro:	I open
mecedora:	rocking chair
sillón:	armchair
tiesas:	courts
piernas:	legs
siento:	I feel
vidrio.:	glass.
abanico:	fan
recibidor:	receiver
cierran:	they close
blancas:	white
azules:	blue
lucetas:	lights
bajado:	lowered
rayo:	ray
recibir:	receive
arcoiris:	rainbow
pequeños:	small
llena:	full
biselados:	beveled
cristales:	crystals
araña:	spider
profundos:	deep
armarios:	wardrobes
oscura:	dark
muebles:	furniture
señora;:	lady;
antaño:	yesteryear
barandales.:	railings.
plantados:	planted
tejados:	roofs
Jesús:	Jesus
asciende:	rises
calzada:	footwear
inclinado:	inclined
atravesados:	crossed
todos:	all
uno:	a
vecinos:	neighbors
soportales:	arcade
escalera:	ladder
peldaño:	step
situado:	situated
encaladas:	whitewashed
columnas:	columns
soportal:	support
tiene:	has
Nuestra:	Our
aceras.:	sidewalks.
cubren:	cover
álamos:	poplars
frutas:	fruits
resbalar:	slip
correr:	run
acabo:	just
maderas:	woods
plácidamente:	placidly
compás:	compass
sexto:	sixth
tienda.:	store.
gaveta:	drawer
transcripción:	transcription
pausado:	slow
tocar:	tap
lograba:	achieved
ópera—:	opera-
selecciones:	selections
acostumbraba:	used to
—más:	-further
pasaje:	passage
único:	single
lirismo.:	lyricism.
pudor:	modesty
clarinete:	clarinet
fagote:	bassoon
invitación:	invitation
queda:	is left over
nacía:	birth
oído.:	ear.
contaba:	counted
bemol:	flat
esperando:	waiting
regresaba:	was returning
Alejado:	Away
bruma.:	mist
perro:	dog
pinos:	pins
arriba:	above
ladera:	hillside
rescoldos.:	embers.
noticia:	news
ediciones:	editions
sorprendieron:	surprised
contundencia:	forcefulness
fatídica:	fateful
cobraban:	they charged
presente.:	present.
situándolo:	placing it
vigencia:	validity
daban:	different
lluvias:	rains
engrisada:	grayed
talladas:	carved
Antón:	Anton
cerdo:	pig
gruñendo:	growling
cochinos:	pigs
fábricas:	factories
granjas:	farms
cercanía:	closeness
turbio:	cloudy
revuelto:	scrambled
proximidad:	proximity
Ejemplo:	Example
eterno:	eternal
rodeaba:	surrounded
establo:	barn
pobreza:	poverty
huesos.:	bones.
xilofonante:	shout out
medio:	half
tibias:	pipes
atronado:	thunderous
prelado:	prelate
casulla:	chasuble
costillar:	rib
lujuriante:	lustful
hallado:	found
esqueleto:	skeleton
pompas:	pomp
vanidad:	vanity
inagotable:	inexhaustible
conjugaba:	conjugated
pilares:	pillars
cuyos:	whose
encima:	on
tristeza:	sadness
invadido:	invaded
granja:	farm
Sinforiano:	Symphorian
motivos:	reasons
desarrollaba:	developed
macabra:	macabre
olvidada:	forgotten
partida:	match
inverso.:	reverse.
sentido:	sense
ánimo:	cheer up
Atlántico:	Atlantic
nuevamente:	again
acerqué:	I approached
desierta:	deserted
cátedra:	chair
expurgado:	expunged
fundido:	cast
común:	common
lugar:	place
Hastiado:	Jaded
consignas:	slogans
mitos;:	myth;
sustituido:	replaced
discursos:	speeches
puestos:	positions
problemas:	problems
tres:	three
torno:	lathe
pugnas:	you fight
centrado:	centered
existencias:	stock
48
:	48
casi:	almost
sincronización:	synchronization
domada:	tamed
naturaleza:	nature
escondrijos:	hiding places
imaginario:	imaginary
posible:	possible
fuga:	leak
pensar:	think
cansando.:	tiring.
pesebre.:	manger.
iluminaba:	illuminated
cabalmente:	completely
suma:	addition
adoraban:	they adored
Nacimientos:	Births
presente:	gift
banderías:	flags
previstas:	planned
ahí:	there
oírse:	hear
sonriente:	smiling
gárgola:	gargoyle
ilustre:	illustrious
tímpano:	eardrum
contemplarse:	contemplate
género.:	gender.
ordalía:	word list
político:	political
proceso:	process
Oficio:	Job
algún:	some
topaba:	bumped
apolínea:	apolline
anhelo:	longing
fáustico:	Faustian
humanístico:	humanistic
Método:	Method
Discurso:	Speech
Erasmo:	Erasmus
sonrisa:	smile
buscaba:	I was looking for
Donde:	Where
conocer.:	know.
añorado:	longed for
existía:	existed
diferencia:	difference
herido:	wounded
—despechado:	—despite
asombraba:	astonished
ametrallados:	machine gunned
campesinos:	peasants
defenestraciones:	defenestrations
acosos:	harassment
inexplicados:	unexplained
secuestros:	kidnappings
confinados:	confined
sabios:	wise
abiertas:	open
poblaciones:	populations
bombardeos:	bombings
niños:	children
fotografías:	photographs
darse:	give
hogueras.:	bonfires.
libros:	books
quemaban:	they burned
Facultades:	Faculties
alumnos:	students
verbo.:	verb.
quebrantamiento:	brokenness
ritos:	rites
dispersión:	dispersion
asistía:	attended
oratorios.:	oratorios
escondían:	they hid
rabinos:	rabbis
voz.:	voice.
alzaban:	raised
obispos:	bishops
pulpitos:	pulpits
temblaban:	they trembled
creyentes:	believers
degüello.:	disgorgement
invitaban:	they invited
periódicos:	newspapers
peor.:	worse.
tiempo.:	time.
viajes:	trips
largos:	long
emprendiendo:	undertaking
museos:	museums
consoladora:	comforter
sagrado:	sacred
acoge:	welcomes
refugié:	refugee
nuevos:	new
éxodos:	exodus
próximos:	nearby
terrores:	terrors
recogidos:	collected
cadáveres:	corpses
Intermezzo:	Interlude
recitar:	recite
Cansado:	Tired
olas:	eggs
clamado:	cried
Augsburgo:	Augsburg
Confesión:	Confession
tumba:	grave
profanación:	desecration
castigo:	punishment
resurrección:	Resurrection
juicio:	judgment
citación:	citation
impresionado:	impressed
sentido.:	sense.
desprovistos:	deprived
votivos:	votives
fuegos:	fires
encender:	light
Brujas:	Witches
solsticios:	solstices
ascender:	ascend
parejas:	couples
intelectual.:	intellectual.
calificarse:	qualify
escarnio:	mockery
hacían:	they did
votar:	vote
cadera:	hip
tranco:	stride
sacándose:	taking off
filósofos:	philosophers
jóvenes:	youths
parada:	stop
haciendo:	doing
metafísico:	metaphysical
futuro.:	future.
adivinado:	guessed
delito:	crime
juzgar:	judge
Dios:	God
derecha:	right
sentaban:	they sat
investido:	invested
tremendamente:	tremendously
fuera.:	out.
pensaba:	thought
altavoces:	speakers
amplificadas:	amplified
palabras:	words
desconfiado.:	suspicious.
cartón:	card
emblemas:	emblems
tablas:	tables
despilfarros:	waste
gigantescos:	gigantic
antiguas:	old
mármol:	marble
transformación:	transformation
solares.:	solar.
símbolos:	symbols
totémicos:	totemics
mástiles:	masts
carpintería:	carpentry
triunfo:	triumph
desfiles:	parades
marcar:	to mark
ávidas:	greedy
inteligencias:	intelligences
Lejos:	Far
enseñanzas:	teachings
singularmente:	singularly
contrariaban:	they contradicted
realidades:	realities
fachadas:	facades
adoración:	worship
broma:	joke
calificado:	qualified
aprendizaje:	learning
regresar.:	go back.
convencimiento:	conviction
buen:	good
Océano:	Ocean
Atravesé:	I went through
raíces.:	roots.
empeño:	endeavor
partitas:	parts
subasta:	auction
fruto:	fruit
herencia:	inheritance
magra:	thin
dinero:	money
escaso:	scarce
consagré:	consecrated
morir:	to die
sortilegio:	spell
47
:	47
ascendía:	ascended
envolvente:	immersive
trío:	trio
escuchando:	listening
soplo:	breath
vidos:	will see
conmo:	condyle
pana:	till
pantalón:	pants
blusa:	blouse
vestidos:	dresses
adolescencia:	adolescence
escuchar:	listen
familias:	families
supersticiones—:	superstitions—
sustituyendo:	substituting
ciencia:	science
culto:	cult
—pues:	-well
misas:	masses
embrutecerse:	get dirty
domingos:	Sundays
bibliotecas:	libraries
ocios:	idleness
siglo:	century
catedral:	cathedral
ilustrados:	illustrated
llegándose:	arriving
colectiva:	collective
cultura:	culture
socialización:	socialization
irrefrenable:	irrepressible
progreso:	progress
consideraciones:	considerations
mismas:	themselves
desembocaban:	flowed
capitulación:	capitulation
hijas:	daughters
campañas:	campaigns
Acuso:	I accuse
evocaciones:	evocations
importunarlos.:	bother them.
atreviera:	dared
nadie:	nobody
descacho:	scrap
calma:	calm
monarquía:	monarchy
temblar:	tremble
hicieron:	they did
escritores:	writers
hablaba:	spoke
vida:	life
respeto:	I respect
hincapié:	emphasis
civilización:	civilization
constituía:	constituted
principios:	beginning
ciertos:	some
afirmación:	affirmation
cisne:	swan
vellón:	fleece
ocre:	ocher
espejismos:	mirages
promovía:	promoted
gráfica:	graphic
aprendiendo:	learning
minnesangers:	memory songs
concursos:	contests
pizarras:	blackboards
angélico:	angelic
venerables.:	venerable
imaginarme:	imagine
maravillados:	amazed
edificando:	building
devoción:	devotion
patrias:	homelands
evocaba:	evoked
contraste:	contrast
repertorio—
.:	repertoire-
.
—
detalle:	—
detail
pífano:	whistling
marchas:	marches
despedidas:	goodbyes
Orleáns:	Orleans
embarcadas:	shipped
rameras:	harlots
clásicas:	classic
olvidar:	forget
europeas:	Europeans
naciones:	nations
desechos:	waste
poblado:	populated
indios:	indians
mediterráneas:	Mediterranean
tradiciones:	traditions
hemisferio:	hemisphere
vuelto:	turned
Mundo:	World
llamaban:	they called
festivales.:	festivals.
alturas:	heights
cimas:	tops
contemplada:	contemplated
saudade:	longing
fracaso:	failure
hablarme:	talk to me
comenzó:	began
Fue:	Was
añoranzas.:	longings
inesperadas:	unexpected
asociaban:	they associated
Salmos:	Psalms
Eclesiastés:	Ecclesiastes
meditación:	meditation
iniciar:	start
América:	America
marchando:	marching
bulliciosa:	bustling
atara:	to the door
roto:	inside
remedios:	remedies
amargado:	embittered
viudez:	widowhood
Ensombrecido:	Overshadowed
armario.:	cupboard.
años:	years
oculta:	hidden
tuviera:	had
catolicismo:	Catholicism
luterana:	Lutheran
Biblia:	The Bible
consagraban:	they consecrated
veladas:	evenings
duques:	dukes
Cuatro:	Four
muerte:	death
llanto:	crying
cantado:	sung
terciopelo:	velvet
costurero:	sewing box
nosotros:	us
estuviera:	was
sentarme:	sit
escritura:	writing
enmendar:	amend
partitura:	score
impuesto:	tax
«doblado»:	"bent"
pintaban:	they painted
arabesco:	arabesque
endiablado:	devilish
envolver:	involve
llevar:	carry
dejaba:	left
inicial:	initial
sobresalto:	shock
impaciente:	impatient
esperaba:	I expected
brasas.:	embers.
crepitar:	it rattles
alborozo:	joy
reconquistado:	reconquered
silencio:	silence
silencio.:	silence.
46
:	46
puñetazos.:	punching.
orquesta:	orchestra
arrancado:	torn off
exordio:	beginning
unísono:	unison
desembocaron:	they ended
escalas:	scales
rápidas:	quick
Dos:	Of the
registro:	record
cromático:	chromatic
temblor:	shaking
triunfal:	triumphal
fúnebre:	funeral
lamentoso:	plaintive
ascendente:	ascending
movimiento:	motion
frasear:	phrase
Precisamente:	Precisely
estrafalario.:	bizarre.
parecer:	opinion
jugaba:	played
ni:	in
bebía:	drank
esposo:	husband
hispánica:	hispanic
mansedumbre:	meekness
creyeran:	they would believe
ventanas:	windows
apresuradamente:	hurriedly
cerraba:	closed
metales.:	metals.
bajos:	bass
percusión:	percussion
onomatopeyas:	onomatopoeia
tremebundas:	trembling
entera:	whole
cantando:	singing
imaginarias:	imaginary
orquestas:	orchestras
dirigir:	lead
dábase:	was given
oartitura:	score
abría:	opened
vitrina:	showcase
batuta:	combined
sinfónicos:	symphonic
conjuntos:	sets
agarrado:	grabbed
música.:	music.
pequeño:	little
abrir:	open
llevó:	he took
invierno:	winter
nortes:	norths
soplaban:	they blew
temporadas:	seasons
empleaba:	employed
demanda:	demand
prolongación:	extension
sobrina:	niece
montesa:	mountain
casado:	married
preguntan:	they ask
sentada:	sitting
cuento:	tale
cantaba:	sang
cocinera:	cook
atareada:	such
tamarindo:	tamarind
sombreado:	shading
aventuras:	adventures
primeras:	first
gateara:	crawl
resultaba:	it turned out
elaboración:	elaboration
matrimonio:	marriage
Antillas.:	Antilles.
llevaba:	wore
gira:	tour
primera:	first
atril:	lectern
renegado:	renegade
franceses:	French
alemanes:	germans
socialistas:	socialists
bélico:	warlike
arresto:	arrest
inesperado:	unexpected
encolerizado:	incensed
Teatro:	Theater
wagneriana:	Wagnerian
temporada:	season
mejor:	better
atentado:	attack
sorprendido:	surprised
Océano.:	Ocean.
escena:	scene
cierto:	TRUE
Juicio:	Judgment
heraldo:	herald
ímpetu:	momentum
medianeras:	party walls
Sigfrido:	Siegfried
lanzaba:	threw
pabellón:	pavilion
volteaba:	turned
demostrarlo:	prove it
Para:	To
maderas.:	woods.
femeninas:	feminine
másculo:	masculine
asimilaba:	assimilated
París:	Paris
enseñada:	cove
técnica:	technique
estimaba:	estimated
francés:	French
llamaba:	called
peyorativo:	pejorative
tono:	application
oponiéndolo:	opposing
Negras:	Black
Selvas:	Jungles
todas:	all
resonado:	resonated
hijo:	son
metálico:	metallic
bien:	GOOD
superioridad:	superiority
proclamaba:	proclaimed
alemana:	german
Suiza:	Swiss
conservatorios:	conservatories
Formado:	Graduated
peso:	weight
erre:	to this
rodada:	round
pronunciado:	pronounced
llamado:	called
pudieron:	they could
Jericó:	Jericho
Según:	According to
Barbarroja.:	Barbarossa.
sarracenos:	Saracens
romanos:	Romans
buxines:	If you don’t believe it, starve to death
Bizancio:	Byzantium
olifantes:	elephants
instrumento::	instrument:
antecesores:	predecessors
representados:	represented
grabados:	engravings
mostraba:	showed
sentándome:	sitting
nasalmente:	nasally
vibraba:	vibrated
cobriza:	coppery
terminado:	finished
mofletudos:	mofletudas
jocundos:	jocunds
oboístas:	oboists
enjutos:	lean
flacos:	skinny
suele:	usually
mimetismo:	mimicry
corintio:	Corinthian
capitel:	capital
empaque:	packing
da:	and
voluta:	desired
embocadura:	mouthpiece
adhieren:	adhere
labios:	lips
ignorar:	ignore
parece:	it seems
cornista:	horn player
actitud:	attitude
abierta:	open
leer:	file
perfil:	profile
adelantando:	advancing
puntiaguda:	pointed
acorde:	chord
apoyaba:	supported
metálica:	metallic
inseguro:	insecure
aún:	still
vacilante:	hesitant
apartar:	set aside
trataba:	tried
vano:	vain
recuerdos:	memories
devuelta:	returned
45
:	45
existencia:	existence
querer:	to want
gestación.:	gestation.
desasosiego:	unrest
devolvió:	returned
edificado:	built
mágico:	magical
derrumbe:	collapse
cuerdas:	ropes
apagarse:	go out
rápido:	fast
afirmada:	asserted
tonalidad:	tonality
alivio:	relief
respirar:	breathe
Creí:	I believed
tormentosas:	stormy
sombras:	shadows
desgarre:	tear
desatada.:	unleashed
súbito:	sudden
fuerza:	force
huida:	flight
apremio:	pressure
angustia:	distress
desgano:	reluctance
primeros:	first
caídas:	falls
descenso:	descent
pintáronse:	they were tormented
aleteada:	fin
escuché.:	listen.
Acercando:	Zooming in
mismo.:	same.
hallados:	found
ecos:	echoes
sonoridades:	sounds
dónde:	where
venía:	permission
cumbres:	summits
montañas:	mountains
estas:	is
escrito.:	written.
abstractos:	abstract
expositores:	exhibitors
invisibles:	invisible
desconocidos:	unknown
rostros:	faces
ejecutantes:	performers
prestigio.:	prestige.
ejecución:	execution
remota:	remote
pardas:	brown
sonando:	ringing
pavesas:	burden
rompían:	they broke
días.:	days.
huir:	flee
conocida.:	known.
harto:	fed up
maltrecha:	battered
caja:	box
sonó:	rang
apagarlo:	turn it off
cohombros:	cucumbers
mazorcas:	cobs
estampa:	print
viejísima:	very old
aparato:	device
prendido:	on
Alguien:	Someone
oí:	I heard
quedar:	meet
tarde):	late)
(Más:	(Further
contemplaba:	contemplated
Hacía:	Toward
quedé:	I stayed
alejándose:	moving away
buenas:	hello good
bruscamente:	abruptly
trivialidad:	triviality
elogiosa:	complimentary
alguna:	some
sombras.:	shadows.
poderoso:	powerful
acusados:	accused
fueron:	were
rasgos:	traits
olorosas:	smelly
acremente:	add
gramas:	grams
puñado:	handful
chimenea:	chimney
arrojó:	daring
pareció:	it seemed
sabría:	would know
frondas.:	fronds.
cortezas:	crusts
vigilaban:	they watched
millones:	million
salir:	go out
deferentemente:	deferentially
volverse:	become
permiso.:	permission.
pidiendo:	asking
anciano:	old man
tronco:	stem
raíces:	roots
monedas:	coins
depositar:	deposit
curaban:	cured
hongo:	fungus
retoño:	shoot
buscar:	look for
espesura:	thickness
entrar:	to enter
pago.:	pay.
creciera:	would grow
brincaba:	joke
genio:	genius
dueño:	owner
poderes.:	powers.
propios:	own
pregonaban:	they proclaimed
ponían:	they put
plantas:	plants
dignatarios.:	dignitaries.
inquietantes:	disturbing
guardado:	saved
cercano:	nearby
reino:	kingdom
despiertos:	awake
seres:	beings
tratara:	will try
refería:	referred
recuerdo.:	memory.
Rusia:	Russia
Angelón:	Angelon
Oso:	Very
conjurar:	conjure
Albahaca:	Basil
Bretónica:	Bretonnica
pelo;:	for the;
ensortijar:	Ensortizer
Bejuco:	Liana
pecho:	chest
opresiones:	oppressions
aliviar:	relieve
Serenada:	Serenade
Sábila:	Aloe Vera
identificándolas:	identifying them
propiedades:	properties
alabar:	praise
empezó:	started
mano:	thousand
estrujarlas:	squeeze them
retamas:	brooms
musgos:	mosses
secas:	dried
hojas:	leaves
sacando:	taking out
acercó:	approached
joven:	young
plantas.:	plants.
ostentaban:	they flaunted
gavetas:	drawers
maceraciones:	macerations
frascos:	jars
Junto:	Together
curiosidad.:	curiosity.
desprendía:	gave off
comedor:	dining room
quedado:	left
habíamos:	we had
iluminados.:	illuminated.
cantar:	sing
también:	also
músicas:	songs
muertes:	deaths
Calofrío:	Chill
Mansión:	Mansion
moderno:	modern
durante:	during
parecían:	they seemed
manera:	manner
Eran:	Were
tocara:	will touch
caminos:	roads
temas:	themes
masa:	time
sí:	Yeah
responde:	respond
fibra:	fiber
agora...:	now...
dolor:	pain
¡ay:	yes
Estos:	These
Gramática:	Grammar
Epítome:	Epitome
gente:	people
colegio:	school
llegar:	arrive
Este:	It is
entrada:	Prohibited
asociaba:	associated
timbales:	timpani
ceniza:	ash
osario:	ossuary
antes:	before
espíritu:	spirit
plazas:	places
De:	Of
arrojados:	thrown
pastores:	shepherds
cosas:	things
salí:	I went out
través:	through
oír:	hear
rematado:	finished
marchaban:	they marched
ciertamente:	certainly
pasado:	past
hombres:	men
muchos:	many
demasiado:	too much
viejos:	old
mirar:	look
encuentro:	meeting
asombro:	astonishment
conocer:	know
visión:	vision
mismo:	same
públicas:	public
pasaban:	they passed
acerca:	about
hombre.:	man.
—como:	-as
ciudades:	cities
insignes:	badges
concierto:	concert
imaginación:	imagination
recuerdo:	memory
debido:	due
parecía:	it seemed
Esto:	This
apoteosis:	apotheosis
traduciendo:	translating
iba:	others
Su:	They are
escuchaban:	they listened
cálida:	warm
hallar:	cases
fondo:	bottom
lectura:	reading
calles:	streets
días:	days
volvió:	came back
ajeno:	unaffiliated
pudiera:	could
sacaba:	took out
tocado:	touched
comercio:	trade
ópera:	opera
escasa:	scarce
quiere:	wants
mientras:	while
Un:	And
aceptando:	accepting
podrido:	rotten
sido:	been
nacimiento:	birth
le:	the
caza:	hunting
trompa:	trunk
nombre:	name
murallas:	walls
mimbre:	wicker
tener:	have
toda:	all
cobre:	copper
creía:	believed
corno:	horn
iniciaba:	started
pero:	but
hizo:	those
arcos:	bows
violines:	violins
segundos:	seconds
caído:	fallen
texto:	text
cobraba:	charged
vigas:	beams
leños:	logs
cerca:	fence
tantos:	so many
conciertos:	concerts
hiciera:	did
aquella:	that
dejado:	left
voces:	you
frente:	forehead
mucho:	a lot
contemplando:	contemplating
noches:	nights
qué:	that
gestos:	gestures
nuestros:	our
pues:	well
saludar:	greet
tomarse:	take
árboles:	trees
misterioso:	mysterious
siempre:	always
nombres:	names
rincón:	corner
presencia:	presence
silvestres:	wild
grato:	grateful
especie:	species
Como:	As
gesto:	gesture
cesta:	way
En:	In
polvo:	dust
habían:	had
época:	era
mundo:	world
otro:	other
sinfonía:	symphony
cual:	which
quienes:	who
estaban:	were
día:	day
esos:	those
estaba:	was
podía:	could
cada:	each
obreros:	workers
mente:	mind
llevaban:	they carried
historia:	history
fuera:	out
cuanto:	how much
veces:	times
ser:	to be
instrumento:	instrument
bronce:	bronze
cuyo:	whose
sólo:	only
él:	he
hacer:	do
Cada:	Each
frase:	phrase
Sinfonía.:	Symphony.
Ya:	Of
mí:	my
notas:	notes
sabía:	knew
luego:	then
techo:	ceiling
grillos:	irons
hacía:	toward
misma:	same
trompas:	deceives
dentro:	within
pequeñas:	small
tiempo:	time
Iba:	Different
desde:	from
debía:	should
Por:	By
aunque:	although
mujer:	women
suerte:	luck
armario:	cupboard
hacia:	toward
olor:	smell
aquí:	here
tal:	of
visto:	view
así:	So
último:	last
entonces:	so
junto:	together
obra:	work
Sinfonía:	Symphony
continente:	continent
lado:	side
ese:	that
música:	music
sonoridad:	sonority
tanto:	both
tema:	him
noche:	evening
esta:	this
algo:	something
decir:	say
ojos:	eyes
nada:	nothing
hablar:	talk
si:	and
tenía:	had
yerbas:	herbs
bajo:	low
tarde:	afternoon
allá:	there
quien:	who
grandes:	big
donde:	where
todo:	all
voz:	voice
dos:	of the
poco:	bit
muy:	very
siglos:	ages
aquel:	that
hubiera:	had
este:	it is
eran:	were
El:	He
fue:	was
vez:	time
ahora:	now
cuya:	whose
ya:	of
La:	The
sobre:	on
más:	further
Pero:	But
cuando:	when
entre:	between
sus:	their
como:	as
había:	there was
su:	are
para:	to
se:	with
una:	a
por:	by
un:	and
del:	of the
el:	he
en:	in
que:	what
la:	the
de:	of
