61
:	61
seculares.:	secular.
oficios:	crafts
escala:	scale
enorme:	huge
cabalmente:	completely
desempeñando:	performing
seguía:	continued
Mundo:	World
sólo:	only
pues:	well
historia:	history
América:	America
alargaba:	lengthened
triunfo:	triumph
arcos:	bows
metopas:	Metopus
próceres:	heroes
mensajero:	messenger
vehículo:	vehicle
máquina:	machine
máxima:	maximum
sido:	been
observar:	notice
interesante:	interesting
resultaba:	it turned out
quedo:	stay
entrar:	to enter
espuelas:	spurs
quitado:	taken
debía:	should
malezas:	weeds
oculto:	hidden
pero:	but
soportales;:	arcade;
cabeceando:	nodding
caballos:	horses
muchos:	many
reunión:	meeting
municipales.:	municipal.
parques:	parks
cita:	dream
daban:	different
enamorados:	lovers
dando:	giving
montado:	mounted
Héroe:	Hero
buen:	good
mármol:	marble
tallar:	to cut
bronce:	bronze
fundir:	meetings
modelar:	model
tenían:	they had
ecuestres:	equestrian
estatuas:	statues
escultores:	sculptors
coraje:	courage
símbolo:	symbol
ningún:	none
hondamente:	deeply
penetraba:	penetrated
colgados:	hung
bien:	GOOD
testículos:	testicles
establecía:	established
solidaridad:	solidarity
misteriosa:	mysterious
Una:	A
polvo.:	dust.
arrogancia:	arrogance
rodar:	rotate
haciendo:	doing
bestia:	beast
toro:	visiting
derribar:	bring down
garañón:	stallion
amansar:	tame
machos:	males
juegos:	games
Renacían:	They were reborn
brazos.:	arms.
hacer:	do
piernas:	legs
apretar:	squeeze
admiradas:	admired
alardear:	boast
físicas:	physics
destrezas:	skills
desarrollando:	developing
doma:	at home
enseñaban:	they taught
pellejo:	skin
directo:	straight
ponían:	they put
milenarias:	millennial
técnicas:	techniques
dueño:	owner
ser:	to be
Volvía:	I was coming back
hombre.:	man.
Caballo:	Horse
frontolera.:	to the front
domingos:	Sundays
cabezadas:	nods
guadamecí:	guadame
arciones:	artions
vaqueros:	jeans
estribos:	stirrups
cinchas:	webbing
colgaduras:	hangings
atareados:	busy
operarios:	workers
cueros:	leathers
perfumada:	perfumed
talabartería:	saddlery
reaparecido:	reappeared
pelo.:	for the.
cinta:	Love
luciendo:	showing off
asomada:	leaning out
joven:	young
brida:	flange
logrados:	achieved
encabritamientos:	rearing
resbalar:	slip
temeroso:	fearful
zapatos:	shoes
nervioso:	highly strung
clavos:	nails
hincada:	kneeling
canción:	song
en.:	in.
apagada:	turned off
herradura:	horseshoe
bullir:	to boil
fragua.:	forge.
cuero:	leather
mandil:	chuck
pintado:	painted
fuelles:	bellows
yunques:	anvils
atareado:	busy
anunció:	advertisement
sonido:	sound
martilleo:	hammering
relincho.:	Rancho.
cultura:	culture
pregonando:	preaching
anduvo:	walked
sudor:	sweat
circo:	circus
pista:	track
Caballo.:	Horse.
llegado:	arrived
habíamos:	we had
advertí:	I warned
manganas:	manganese
hablaba:	spoke
penetrar:	penetrate
plantados:	planted
pilones:	pylons
muelle:	dock
junto:	together
atracamos:	we dock
puesta:	putting
eróticos.:	erotic.
sueños:	dreams
absurdo:	absurd
exasperante:	infuriating
caer:	fall
cierro:	I close
latidos:	beats
sexo:	sex
sienes:	temples
emborracha.:	drunk
marineros;:	sailors;
enardecer:	inflame
retar:	teasing
cantan:	they sing
vano.:	vain.
esperar:	wait
habré:	there will be
precisamente:	precisely
espero.:	expect
trepo:	climb
cita.:	dream.
fijan:	fix
resulta:	result
sentido:	sense
cuyo:	whose
ademán:	gesture
mirada:	look
llego:	arrive
azares:	chance
conmigo:	with me
comparte:	share
vigilar:	watch
deber:	duty
imagino:	I imagine
porque:	why
coloquios:	colloquies
importan:	matter
finjo:	I pretend
celarla:	guard her
parezco:	I look like
ignora:	ignore
saben.:	per.
puesto:	position
saben»:	per"
temor:	fear
continuamente:	continuously
desasosiega:	restlessness
hembras.:	females.
propias:	own
eran:	were
prendas:	garments
afirmando:	stating
echó:	threw
famosas:	famous
60
:	60
tiendas:	stores
comprado:	purchased
factura:	bill
camisa:	shirt
ignoro.:	I ignore
hablar:	talk
manera:	manner
señas:	address
reglas:	rules
gente:	people
agradarles.:	please them
desenfadada:	carefree
irónica:	ironic
rudeza:	the relative
suerte:	luck
tratan:	they try
obstante:	however
atrevo.:	I dare
invitarme:	invite me
parte;:	part;
acometida:	affected
exige:	demands
vernos:	see each other
nadie:	nobody
bestias:	beasts
estrechos:	narrow
aislamiento:	isolation
rato:	mouse
pienso:	I think
viriles.:	virile.
pocos:	few
tontas:	stupid
parecerle:	seem
puedan:	can
atenciones:	attentions
objeto:	object
hacerla:	do it
familiaridad:	familiarity
llegar:	arrive
molestarla:	bother her
ofenderla:	offend her
temo:	theme
conocer.:	know.
dado:	given
sí:	Yeah
semejantes:	similar
bastante:	quite
aguzados:	sharpened
indagación:	inquiry
medios:	media
escapa:	escape
profunda:	deep
entidad:	entity
libremente:	freely
acercarme:	get closer
historias.:	stories.
haciéndoles:	making them
resueltas:	resolved
sólidas:	solid
estrechamente:	tightly
convivir:	live together
finos;:	thin;
paladares:	palates
creen:	believe
matalotaje:	slaughterhouse
comiendo:	eating
tripulación:	crew
mejor:	better
mezclarme:	mix
traído:	brought
vez:	time
inundaciones.:	floods.
crecientes:	growing
meses:	months
hambrunas:	famines
conocen:	they know
todavía:	still
próximo:	next
«comprometida»—:	«committed»—
probar:	prove
luto:	cooked
vestida:	dressed
Otra:	Other
inexplorado.:	unexplored.
afluente:	tributary
cabeceras:	headers
buscador:	seeker
amante:	lover
reunirse:	meet up
adolescente:	adolescent
cuerpo:	body
mulata:	mulatto
floreado:	flowered
camisón:	nightgown
derramados:	spilled
baldes:	buckets
bañando:	bathing
aquí.:	here.
cosa:	What
sólido:	solid
Este:	It is
empresa.:	enterprise.
riesgosa:	risky
consideran:	consider
trabajo:	job
quienes:	who
directores:	directors
viaje:	journey
miedos:	fears
vacilaciones:	hesitations
realiza:	perform
mujer:	women
asombra:	amazes
fruta.:	fruit.
mordiendo:	biting
sonríe:	smile
distancia:	distance
alguna:	some
acuesta:	lie down
cortado.:	cut.
recién:	newly
poniendo:	putting
trasuda:	exudes
chubasco:	shower
algún:	some
molesta:	bothers
montón:	lot
trepa:	climb
escondrijo.:	cache.
desván:	loft
minero:	miner
colgada:	hung
hamaca:	hammock
doloroso.:	painful.
desasosiego:	unrest
rostro:	face
hundo:	a dog
olía:	oil
cesta:	way
aquella:	that
—¡sobre:	-on
lejos.:	far.
pastaban:	note
reses:	recess
majaba:	funny
sudorosa:	sweaty
infancia::	childhood:
traspatio:	backyard
ahora—:	now-
—reparo:	-repair
esto:	this
Algo:	Something
estiércol.:	manure.
huele:	smells
husmear:	sniff
emoción:	emotion
llorar:	cry
echa:	cast
años:	years
algunos:	some
después:	after
paterna:	paternal
granja:	farm
regresa:	come back
campesino:	peasant
parecido:	similar
ocurre:	occurs
organismo.:	body.
necesidad:	need
oculta:	hidden
verdad:	TRUE
tonifica:	tones
agradable.:	pleasant.
calificarse:	qualify
pueda:	can
ebrio.:	drunk.
majan:	the lodge
sudorosas:	sudoros
otro.:	other.
cocineras:	cooks
lado:	side
toldo:	awning
forraje:	forage
acostarme:	go to bed
Vuelvo:	I'm back
partes.:	parties.
todas:	all
graznidos:	squawks
levantando:	lifting
salomas:	Salom
gritos:	shouting
reclama:	complain
Manatí:	Manatee
patrón:	pattern
alrededor::	around:
codornices:	quail
revuelo:	stir
estruendosamente:	thunderously
cuerda:	rope
reloj:	clock
descubrimiento:	discovery
sueño.:	dream.
apetito:	appetite
relacionando:	relating
oficio:	job
cronógrafo:	chronograph
vocación:	vocation
metrónomo:	metronome
atento:	attentive
medidor:	meter
maniático:	maniac
Lluvias.:	Rains.
Código:	Code
rigen:	govern
Aquí:	Here
59
:	59
inmutables.:	immutable.
tiempos:	time
ajustarse:	conform
casos:	cases
ambos:	both
navega:	navigate
atrás.:	back.
carretera:	road
particulares.:	individuals.
prisas:	rush
cuenta:	account
toman:	take
humanas:	human
agitaciones:	agitations
valen:	worth
manantial:	spring
granero:	barn
Océano.:	Ocean.
cien:	hundred
incontables:	uncountable
islas:	islands
proliferación:	proliferation
comienza:	starts
vertiente:	slope
derramarse:	spill
albas:	ALBA
abriendo:	opening
entró:	entered
paisaje:	landscape
niebla:	fog
opuesta:	opposite
esfumar:	smoke
ensancha:	widens
ponientes;:	sunsets;
hecha:	made
desgarradura:	tear
tajo:	block
especie:	species
abarcan:	encompass
espacio:	space
entra:	enter
rayos.:	good heavens.
fulminados:	struck down
habitados:	inhabited
mismo:	same
nacidos:	born
aquéllos:	those
hijos:	children
gigantes:	giants
gigantescos:	gigantic
asombraba:	astonished
cronista:	chronicler
derecha.:	right.
derecha:	right
señalaba:	pointed out
autor:	author
válida.:	valid.
sigue:	go on
prosa:	prose
añeja:	old
siglos.:	ages.
tres:	three
sandalias:	sandals
trajo:	brought
Servando:	Serving
relación:	relationship
apartar:	set aside
riberas:	banks
mirando:	looking
horas:	hours
largas:	long
pasado:	past
Embarcamos:	We board
inventado.:	invented.
fuese:	was
antes:	before
paroxismos:	paroxysm
descansos:	breaks
lluvias:	rains
estíos:	you are
pulso:	pulse
unidad:	unit
funden:	melt
agitan:	they shake
torbellinos:	whirlwinds
raudales:	rapids
Su:	They are
vuelvo:	I'm back
dejándome:	leaving me
prisa:	hurry
medidos:	measured
pasos:	steps
aleja:	move away
sentirme:	feel
himno:	hymn
blasón:	blazon
clavada:	nailed
cornamenta:	antlers
hará:	will do
fundador:	founder
nacer;:	be born;
mítico:	mythical
antepasado:	ancestor
emblema:	emblem
monumento:	monument
planicie:	plain
inmóvil:	still
cabeza:	head
detiene:	stops
junqueras:	reeds
venado:	deer
asoma:	appears
Muy:	Very
contemplado.:	contemplated.
centro:	center
estará:	will be
andar:	to walk
inútil:	useless
cuán:	how
sabiendo:	knowing
moverme:	move
Llevo:	He took
sonido.:	sound.
calma:	calm
estar:	be
vuelve:	comes back
Luego:	Then
estruendo.:	noise.
adquiere:	acquire
zumbido:	tinnitus
telaraña:	web
vuelo:	flight
Cuando:	When
vibra.:	vibrates.
topa:	to find
heráldica.:	heraldry.
pesados:	heavy
impasibles:	impassible
gavilanes:	hawks
descansan:	they rest
candelabro:	chandelier
cacto:	cactus
acompañado:	accompanied
solitario:	lonely
árbol:	tree
párpados.:	eyelids.
mano:	thousand
están:	are
detenidos:	detained
inmóviles:	motionless
cirros:	cirrhosis
aquellos:	those
nube::	cloud:
hallar:	cases
alzar:	raise
tengo:	I have
planeta:	planet
entera:	whole
parte:	part
circunferencia:	circumference
totalidad:	whole
abarco:	embrace
guijarro:	pebble
punto:	point
Desde:	From
oscurecimiento:	darkening
leve:	live
disuelven:	dissolve
límites:	boundaries
inmensa:	immense
contemplo:	I contemplate
alcanzan.:	they reach.
voces:	you
Sus:	Their
nosotros.:	us.
viajaban:	they were traveling
cortando:	cutting
abajo:	below
marineros:	sailors
mismo.:	same.
asustaría:	would scare
hago:	do
hablara:	will speak
dijera:	say
Si:	And
creación:	creation
fragor:	roar
cobraría:	would charge
silencios:	silences
tantos:	so many
espeso:	thick
venido:	come
sentado:	sitting
encuadra.:	frame.
mide:	stomach
especularse:	speculate
Sé:	See
oficios.:	offices.
usado:	used
música:	music
trabajado:	worked
Habiendo:	Having
vocabulario.:	vocabulary.
Silencio:	Silence
58
:	58
(Miércoles:	(Wednesday
lastres.:	ballasts
cargaría:	would load
jornada:	day
fardo:	burden
pesar:	weigh
comenzó:	began
momento:	moment
ése:	that
fue:	was
Creo:	Believe
emocionarla.:	excite her.
constelaciones::	constellations:
encuentra:	finds
inolvidables:	unforgettable
escenografías:	scenery
componían:	they composed
elementos:	elements
estábamos:	we were
parecer:	opinion
advertir:	warn
agudo:	sharp
diapasón:	diapason
risas:	laughter
respuestas:	answers
celebraba:	celebrated
interrogaba:	interrogated
nimiedades:	trifles
contaba:	counted
hablarle.:	talk to him
atreví:	I dared
sueño:	dream
sabedor:	knowing
íntimo:	intimate
gesto:	gesture
lentamente:	slowly
peinarlo:	comb it
empezó:	started
pelo:	for the
soltó:	he blurted out
orilla.:	bank.
grava:	important
recostarnos:	lie down
acabamos:	we're done
marcha:	march
tornadiza:	twisty
llamarada:	flare
súbito:	sudden
enrojecida:	flushed
nosotros:	us
detuvimos:	we stopped
Cerca:	Fence
movimiento:	motion
escobenes:	brooms
alargados:	elongated
velos:	fleeces
surgían:	arose
desnudos:	nudes
senos:	old
tallada:	cut off
Anfitrite:	Amphitrite
proa:	bow
estampa:	print
velero:	sailboat
antiguo:	ancient
encallado:	aground
ranas.:	frogs.
sollados:	solted
dejados:	left
timones:	rudders
viejos:	old
cementerio:	cemetery
bien—:	GOOD-
remanso:	backwater
—un:	— and
Andando:	Going
adelante:	forward
cubriera:	would cover
tuviera:	had
empujaba:	pushed
oscuridad:	darkness
manantiales.:	springs.
cataratas:	cataracts
peso:	weight
venidos:	come
ríos:	rivers
reuniones:	meetings
arriba:	above
iniciado:	started
genésico:	genetic
ritmo:	rhythm
sostenido:	sustained
empuje:	push
riberas::	banks:
otras:	others
oído:	ear
tantas:	so many
cauce:	channel
ondas:	waves
placidez:	placidity
torrentes:	torrents
delgadas:	thin
corrientes:	currents
escurrirse:	drain
agitado:	hectic
tierras.:	land.
dividiendo:	dividing
masa:	time
profundo:	deep
continuando:	continuing
corría:	ran
fuegos:	fires
alejándose:	moving away
perdía:	lost
recta:	straight
llevó:	he took
aliviado:	relieved
cerveza:	beer
botellas:	bottles
compró:	bought
salir:	go out
propuesta:	proposal
frase.:	phrase.
cerrar:	close
lograba:	achieved
nunca:	never
palabras:	words
francés:	French
escucharlo:	listen to it
aunque:	although
andanzas:	wanderings
deferencia:	deference
insinuante:	insinuating
cohibido:	restrained
estaba:	was
Diamantes:	Diamonds
Buscador:	Seeker
anduviéramos:	we would walk
propuse:	propitious
torno:	lathe
desasosegados:	restless
falsa:	false
situación:	situation
acabar:	end
tratos.:	deals.
primeros:	first
dinero:	money
guardándose:	guarding
cuartos:	quarters
regresaban:	they returned
turno.:	shift.
mineros:	miners
invadida:	invaded
taberna:	bar
poesía...:	poetry...
cierta:	true
exentas:	exempt
estaban:	were
únicamente:	only
Escrituras:	Scriptures
familia:	family
Biblias:	Bibles
conservaran:	they will keep
barón:	baron
mío:	mine
tatarabuelo:	great-great-grandfather
Enciclopedia:	Encyclopedia
pasados:	past
Edicto:	Edict
revocación:	revocation
expulsados:	expelled
hugonotes:	Huguenots
tiempo::	time:
paternos:	paternal
antepasados:	forefathers
desertado:	deserted
habían:	had
común:	common
tener:	have
podíamos:	we could
entendimiento:	understanding
terreno:	land
único:	single
observé:	observed
cuello:	neck
colgaba:	hung
pequeña:	small
bosques.:	forests.
unípedo:	unipedo
espíritu:	spirit
creencias:	beliefs
recordar:	remember
pensaba:	thought
Eso:	That
mapa.:	map.
países:	countries
disposición:	provision
haberse:	have
aguardaba:	I was waiting
sabía:	knew
corcel:	steed
luego:	then
Tierras:	Land
claro:	Of course
ridículo:	ridiculous
mundo:	world
fuera:	out
trato:	deal
tosco:	Tuscan
demasiado:	too much
querido:	darling
viaje.:	journey.
prostituta:	prostitute
hembras:	females
este:	it is
cuya:	whose
allí:	over there
ello:	it
pasar:	market
respondiera:	would respond
celo:	even
cantando:	singing
ajíes:	chili peppers
lona:	his
bajo:	low
bordo:	edge
reír:	laugh
días:	days
dejado:	left
Observo:	Noticed
viajes:	trips
corriente:	current
Junto:	Together
frente:	forehead
visto:	view
perfil:	profile
Donde:	Where
resabios:	aftertaste
también:	also
hora:	time
confín:	confine
Nada:	Nothing
pájaros:	birds
cual:	which
lejanía:	remoteness
De:	Of
da:	and
altura:	height
allá:	there
parecen:	they seem
llanura:	plain
ellos:	they
sementales:	stallions
pasto:	meal
quedado:	left
han:	he
menudo:	slight
silencio;:	silence;
puede:	can
cómo:	as
nuevos:	new
presencia:	presence
esas:	those
cambio:	change
proximidad:	proximity
perenne:	perennial
frescor:	freshness
cuando:	when
figura:	figure
mascarón:	mask
medio:	half
llenos:	full
abandonados:	abandoned
barcos:	boats
silencio:	silence
mundo.:	world.
otra:	other
leguas:	leagues
centenares:	hundreds
descenso:	descent
poco:	bit
fresca:	fresh
vasto:	vast
llegamos:	we arrived
fría:	cold
pocas:	few
contar:	count
hacia:	toward
tenía:	had
Por:	By
otro:	other
La:	The
aquello:	that
ya:	of
creer:	believe
hacía:	toward
caballo:	horse
tanto:	both
quien:	who
parece:	it seems
ese:	that
negras:	black
está:	this
tiempo:	time
árboles:	trees
mismos:	themselves
brisa:	breeze
erguida:	erected
aquí:	here
ojos:	eyes
pensar:	think
él:	he
palabra:	word
cada:	each
lugar:	place
griego:	Greek
cuyos:	whose
otros:	others
hubiera:	had
ruido:	noise
mucho:	a lot
olor:	smell
tiene:	has
hace:	does
si:	and
algo:	something
esta:	this
ahora:	now
Pero:	But
hombres:	men
mí:	my
casi:	almost
muy:	very
hasta:	until
siempre:	always
parecía:	it seemed
aún:	still
lejos:	far
veces:	times
noche:	evening
entre:	between
nada:	nothing
En:	In
Mouche:	Fly
El:	He
mujeres:	women
desde:	from
le:	the
hombre:	man
orilla:	bank
ni:	in
había:	there was
todo:	all
donde:	where
para:	to
sobre:	on
como:	as
más:	further
sus:	their
su:	are
por:	by
se:	with
una:	a
del:	of the
un:	and
la:	the
el:	he
en:	in
que:	what
de:	of
